Rk,Player,Nation,Pos1,Pos2,Squad,Comp,Age,Born,90s,Tkl,TklW,Def 3rd,Mid 3rd,Att 3rd,Tkl Att,Tkl%,Lost,Blocks,Sh,Pass,Int,Tkl+Int,Clr,Err,Matches
1,Brenden Aaronson,us,MF,FW,Leeds United,Premier League,21,2000,26.4,45,18,16,22,7,15,46,32.6,31,43,3,40,5,50,6,Matches
2,Paxten Aaronson,us,MF,DF,Eint Frankfurt,Bundesliga,18,2003,1.9,6,5,2,2,2,2,3,66.7,1,2,1,1,0,6,2,Matches
3,James Abankwah,ie,DF,,Udinese,it Serie A,18,2004,0.7,1,1,0,1,0,0,0,,0,4,2,2,0,1,5,Matches
4,George Abbott,eng,MF,,Tottenham,Premier League,16,2005,0.0,0,0,0,0,0,0,0,,0,0,0,0,1,1,0,Matches
5,Yunis Abdelhamid,ma,DF,,Reims,Ligue 1,34,1987,37.0,82,50,47,33,2,39,52,75.0,13,65,27,38,64,146,116,Matches
6,Himad Abdelli,dz,MF,FW,Angers,Ligue 1,22,1999,23.7,64,38,22,32,10,31,67,46.3,36,30,1,29,28,92,15,Matches
7,Salis Abdul Samed,gh,MF,,Lens,Ligue 1,22,2000,32.2,46,26,18,23,5,29,52,55.8,23,38,9,29,36,82,26,Matches
8,Laurent Abergel,fr,MF,,Lorient,Ligue 1,29,1993,26.0,92,52,59,30,3,39,92,42.4,53,47,8,39,34,126,39,Matches
9,Oliver Abildgaard,dk,MF,,Hellas Verona,it Serie A,26,1996,6.6,10,6,6,3,1,7,16,43.8,9,7,1,6,5,15,17,Matches
10,Matthis Abline,fr,FW,MF,Auxerre,Ligue 1,19,2003,9.0,4,2,0,3,1,0,5,0.0,5,6,1,5,1,5,1,Matches
11,Matthis Abline,fr,FW,MF,Rennes,Ligue 1,19,2003,1.2,1,1,0,0,1,1,1,100.0,0,1,0,1,2,3,1,Matches
12,Abner,br,DF,,Betis,La Liga,22,2000,6.7,12,9,9,2,1,7,16,43.8,9,8,2,6,8,20,24,Matches
13,Zakaria Aboukhlal,ma,FW,MF,Toulouse,Ligue 1,22,2000,27.5,33,23,13,9,11,14,45,31.1,31,18,1,17,22,55,23,Matches
14,Tammy Abraham,eng,FW,,Roma,it Serie A,24,1997,24.3,17,10,4,8,5,3,16,18.8,13,10,4,6,3,20,14,Matches
15,Christian Acella,it,MF,,Cremonese,it Serie A,20,2002,0.2,1,0,1,0,0,0,2,0.0,2,0,0,0,0,1,0,Matches
16,Francesco Acerbi,it,DF,,Inter,it Serie A,34,1988,26.9,33,19,22,7,4,20,27,74.1,7,25,18,7,41,74,85,Matches
17,Álvaro Aceves,es,GK,,Valladolid,La Liga,19,2003,0.1,0,0,0,0,0,0,0,,0,0,0,0,0,0,0,Matches
18,Mohamed Achi,fr,FW,,Nantes,Ligue 1,20,2002,0.4,1,1,1,0,0,1,1,100.0,0,0,0,0,0,1,0,Matches
19,Marcos Acuña,ar,DF,,Sevilla,La Liga,30,1991,21.2,57,36,34,17,6,30,42,71.4,12,16,5,11,23,80,36,Matches
20,Che Adams,sct,FW,,Southampton,Premier League,26,1996,22.1,17,13,7,8,2,7,12,58.3,5,13,4,9,4,21,22,Matches
21,Tyler Adams,us,MF,,Leeds United,Premier League,23,1999,24.0,89,46,44,35,10,50,77,64.9,27,48,8,40,35,124,29,Matches
22,Sargis Adamyan,am,FW,MF,Köln,Bundesliga,29,1993,7.2,14,7,5,3,6,7,17,41.2,10,12,0,12,4,18,5,Matches
23,Tosin Adarabioyo,eng,DF,,Fulham,Premier League,24,1997,23.2,30,13,22,6,2,16,23,69.6,7,20,15,5,26,56,140,Matches
24,Martin Adeline,fr,MF,FW,Reims,Ligue 1,18,2003,1.2,3,3,2,1,0,3,4,75.0,1,3,1,2,3,6,3,Matches
25,Karim Adeyemi,de,FW,MF,Dortmund,Bundesliga,20,2002,15.4,16,11,6,6,4,8,30,26.7,22,18,1,17,7,23,3,Matches
26,Amine Adli,ma,FW,MF,Leverkusen,Bundesliga,22,2000,15.9,18,10,4,6,8,5,17,29.4,12,28,2,26,6,24,7,Matches
27,Yacine Adli,fr,MF,FW,Milan,it Serie A,22,2000,1.6,6,3,2,4,0,2,2,100.0,0,2,0,2,1,7,1,Matches
28,Michel Aebischer,ch,FW,MF,Bologna,it Serie A,25,1997,17.1,12,6,3,6,3,2,18,11.1,16,14,2,12,7,19,9,Matches
29,Felix Afena-Gyan,gh,FW,MF,Cremonese,it Serie A,19,2003,9.1,7,3,4,1,2,2,10,20.0,8,5,1,4,1,8,6,Matches
30,Emmanuel Agbadou,ci,DF,,Reims,Ligue 1,25,1997,26.5,71,49,53,16,2,42,65,64.6,23,30,14,16,32,103,107,Matches
31,Julen Agirrezabala,es,GK,,Athletic Club,La Liga,21,2000,7.5,0,0,0,0,0,0,0,,0,0,0,0,0,0,2,Matches
32,Lucien Agoume,fr,MF,,Troyes,Ligue 1,20,2002,12.2,42,25,18,15,9,17,33,51.5,16,14,5,9,27,69,24,Matches
33,Felix Agu,de,DF,FW,Werder Bremen,Bundesliga,22,1999,0.5,1,0,0,1,0,0,0,,0,1,1,0,0,1,0,Matches
34,Álvaro Aguado,es,MF,,Valladolid,La Liga,26,1996,21.0,27,15,13,11,3,15,25,60.0,10,16,4,12,13,40,15,Matches
35,Kevin Agudelo,co,MF,FW,Spezia,it Serie A,23,1998,23.7,71,38,22,30,19,25,59,42.4,34,39,5,34,10,81,6,Matches
36,Nayef Aguerd,ma,DF,,West Ham,Premier League,26,1996,17.7,27,18,18,8,1,13,20,65.0,7,26,24,2,18,45,79,Matches
37,Ruben Aguilar,fr,DF,,Monaco,Ligue 1,29,1993,13.0,19,9,7,7,5,8,22,36.4,14,13,1,12,18,37,28,Matches
38,Naouirou Ahamada,fr,MF,FW,Crystal Palace,Premier League,20,2002,1.0,3,2,3,0,0,1,3,33.3,2,2,0,2,0,3,0,Matches
39,Naouirou Ahamada,fr,MF,,Stuttgart,Bundesliga,20,2002,15.5,17,11,7,7,3,8,20,40.0,12,16,5,11,8,25,7,Matches
40,Amar Ahmed,se,FW,,Troyes,Ligue 1,18,2004,0.2,1,1,0,1,0,0,1,0.0,1,0,0,0,1,2,0,Matches
41,Jean-Eudes Aholou,ci,MF,,Strasbourg,Ligue 1,28,1994,14.4,34,20,10,20,4,12,31,38.7,19,25,0,25,24,58,15,Matches
42,Joseph Aidoo,gh,DF,,Celta Vigo,La Liga,26,1995,34.7,51,36,33,17,1,16,28,57.1,12,26,14,12,31,82,150,Matches
43,Ola Aina,ng,DF,,Torino,it Serie A,25,1996,9.7,17,13,5,8,4,9,15,60.0,6,12,2,10,11,28,26,Matches
44,Rayan Aït-Nouri,dz,DF,,Wolves,Premier League,21,2001,12.0,33,20,25,7,1,9,16,56.3,7,3,0,3,9,42,28,Matches
45,Emanuel Aiwum,at,DF,,Cremonese,it Serie A,21,2000,18.4,55,34,36,17,2,33,47,70.2,14,28,16,12,25,80,52,Matches
46,Kristoffer Ajer,no,DF,,Brentford,Premier League,24,1998,8.5,11,8,5,4,2,9,16,56.3,7,6,5,1,7,18,22,Matches
47,Ludovic Ajorque,fr,FW,,Strasbourg,Ligue 1,28,1994,8.6,5,4,1,4,0,3,9,33.3,6,3,1,2,2,7,7,Matches
48,Ludovic Ajorque,fr,FW,MF,Mainz 05,Bundesliga,28,1994,13.5,6,5,1,4,1,1,9,11.1,8,8,2,6,1,7,8,Matches
49,Manuel Akanji,ch,DF,,Manchester City,Premier League,27,1995,25.4,36,25,15,18,3,23,36,63.9,13,27,9,18,16,52,33,Matches
50,Nathan Aké,nl,DF,,Manchester City,Premier League,27,1995,20.8,26,12,15,9,2,11,15,73.3,4,20,10,10,20,46,48,Matches
51,Sergio Akieme,es,DF,,Almería,La Liga,24,1997,25.5,27,16,19,6,2,12,22,54.5,10,22,6,16,14,41,41,Matches
52,Babatunde Akinsola,ng,FW,,Valladolid,La Liga,19,2003,0.1,1,1,0,0,1,0,0,,0,0,0,0,0,1,0,Matches
53,Maghnes Akliouche,fr,MF,FW,Monaco,Ligue 1,20,2002,4.5,7,4,4,3,0,2,8,25.0,6,2,0,2,3,10,2,Matches
54,Paul Akouokou,ci,MF,DF,Betis,La Liga,24,1997,5.0,16,9,13,3,0,13,20,65.0,7,2,2,0,12,28,17,Matches
55,Jean-Daniel Akpa-Akpro,ci,MF,FW,Empoli,it Serie A,29,1992,15.1,53,37,25,19,9,23,42,54.8,19,35,4,31,13,66,27,Matches
56,Kevin Akpoguma,ng,DF,,Hoffenheim,Bundesliga,27,1995,21.7,75,44,45,27,3,32,45,71.1,13,45,16,29,24,99,70,Matches
57,David Alaba,at,DF,,Real Madrid,La Liga,30,1992,20.4,15,11,8,4,3,9,15,60.0,6,18,9,9,14,29,37,Matches
58,Ángel Alarcón,es,FW,MF,Barcelona,La Liga,18,2004,0.3,0,0,0,0,0,0,2,0.0,2,0,0,0,0,0,0,Matches
59,Tomás Alarcón,cl,MF,,Cádiz,La Liga,23,1999,2.5,3,2,0,2,1,1,2,50.0,1,1,0,1,2,5,2,Matches
60,Lucas Alario,ar,FW,MF,Eint Frankfurt,Bundesliga,29,1992,3.7,3,2,1,0,2,0,1,0.0,1,0,0,0,2,5,13,Matches
61,Jordi Alba,es,DF,,Barcelona,La Liga,33,1989,15.8,25,18,13,11,1,12,28,42.9,16,12,5,7,11,36,23,Matches
62,Luis Alberto,es,MF,,Lazio,it Serie A,29,1992,27.1,49,29,18,20,11,23,72,31.9,49,35,6,29,9,58,4,Matches
63,Raúl Albiol,es,DF,,Villarreal,La Liga,36,1985,23.5,25,17,17,6,2,14,18,77.8,4,17,13,4,14,39,111,Matches
64,Marc Albrighton,eng,FW,MF,Leicester City,Premier League,32,1989,2.6,4,1,0,2,2,1,8,12.5,7,6,2,4,1,5,5,Matches
65,Thiago Alcántara,es,MF,,Liverpool,Premier League,31,1991,13.9,43,24,20,21,2,14,23,60.9,9,15,3,12,21,64,13,Matches
66,Carlos Alcaraz,ar,MF,FW,Southampton,Premier League,19,2002,11.4,10,5,2,7,1,6,22,27.3,16,14,5,9,1,11,11,Matches
67,Rubén Alcaraz,es,MF,,Cádiz,La Liga,31,1991,22.7,43,31,24,18,1,19,54,35.2,35,23,8,15,19,62,37,Matches
68,Omar Alderete,py,DF,,Getafe,La Liga,25,1996,22.7,35,20,21,14,0,28,40,70.0,12,23,16,7,26,61,85,Matches
69,Iván Alejo,es,MF,FW,Cádiz,La Liga,27,1995,14.6,32,21,19,9,4,17,37,45.9,20,18,3,15,5,37,12,Matches
70,Doğan Alemdar,tr,GK,,Rennes,Ligue 1,19,2002,4.5,0,0,0,0,0,0,0,,0,0,0,0,0,0,1,Matches
71,Carles Aleñá,es,MF,FW,Getafe,La Liga,24,1998,23.5,18,10,7,5,6,5,34,14.7,29,19,1,18,4,22,18,Matches
72,Trent Alexander-Arnold,eng,DF,,Liverpool,Premier League,23,1998,32.5,57,40,32,16,9,42,80,52.5,38,25,7,18,43,100,41,Matches
73,Alejandro Alfaro,es,MF,,Elche,La Liga,20,2002,0.2,0,0,0,0,0,0,0,,0,0,0,0,0,0,0,Matches
74,Ángel Algobia,es,MF,,Getafe,La Liga,23,1999,12.6,27,13,14,13,0,22,48,45.8,26,15,5,10,3,30,11,Matches
75,Mohamed Ali Cho,fr,FW,MF,Real Sociedad,La Liga,18,2004,6.5,13,10,6,5,2,4,10,40.0,6,9,0,9,2,15,2,Matches
76,Faride Alidou,de,DF,MF,Eint Frankfurt,Bundesliga,21,2001,2.0,8,5,3,4,1,3,9,33.3,6,3,0,3,1,9,3,Matches
77,Alisson,br,GK,,Liverpool,Premier League,29,1992,37.0,0,0,0,0,0,0,3,0.0,3,3,0,3,0,0,20,Matches
78,Jim Allevinah,ga,DF,FW,Clermont Foot,Ligue 1,27,1995,24.9,39,24,24,11,4,19,62,30.6,43,24,2,22,24,63,26,Matches
79,Dele Alli,eng,MF,,Everton,Premier League,26,1996,0.4,0,0,0,0,0,0,0,,0,0,0,0,0,0,0,Matches
80,Domingos André Ribeiro Almeida,pt,MF,,Valencia,La Liga,22,2000,28.2,66,42,23,32,11,26,57,45.6,31,26,0,26,20,86,16,Matches
81,Miguel Almirón,py,FW,,Newcastle Utd,Premier League,28,1994,27.7,46,30,16,19,11,18,42,42.9,24,25,2,23,10,56,17,Matches
82,Marcos Alonso,es,DF,,Barcelona,La Liga,31,1990,13.0,15,10,10,5,0,9,12,75.0,3,14,10,4,11,26,32,Matches
83,Mickaël Alphonse,gp,DF,,Ajaccio,Ligue 1,33,1989,15.1,35,23,20,11,4,20,33,60.6,13,17,5,12,35,70,44,Matches
84,Éder Álvarez Balanta,co,MF,FW,Schalke 04,Bundesliga,29,1993,2.6,5,4,2,3,0,2,6,33.3,4,0,0,0,3,8,4,Matches
85,Carlos Álvarez,es,MF,,Sevilla,La Liga,18,2003,0.1,1,1,0,1,0,0,0,,0,0,0,0,0,1,0,Matches
86,Gastón Álvarez,uy,DF,,Getafe,La Liga,22,2000,16.7,38,30,24,9,5,23,42,54.8,19,15,5,10,15,53,35,Matches
87,Julián Álvarez,ar,FW,MF,Manchester City,Premier League,22,2000,16.3,26,16,3,13,10,9,30,30.0,21,13,0,13,2,28,6,Matches
88,Agustín Álvarez Martínez,uy,FW,MF,Sassuolo,it Serie A,21,2001,4.1,6,3,0,5,1,1,4,25.0,3,5,1,4,3,9,3,Matches
89,Yeray Álvarez,es,DF,,Athletic Club,La Liga,27,1995,25.9,34,23,26,7,1,24,31,77.4,7,23,13,10,48,82,101,Matches
90,Ibrahim Amadou,fr,DF,MF,Angers,Ligue 1,29,1993,4.7,10,7,6,3,1,7,11,63.6,4,7,3,4,10,20,20,Matches
91,Selim Amallah,ma,MF,FW,Valladolid,La Liga,25,1996,3.0,15,9,7,8,0,5,8,62.5,3,2,0,2,5,20,2,Matches
92,Daniel Amartey,gh,DF,,Leicester City,Premier League,27,1994,17.9,19,8,13,5,1,12,14,85.7,2,24,17,7,8,27,71,Matches
93,Amath,sn,MF,FW,Mallorca,La Liga,26,1996,13.6,29,19,14,8,7,14,22,63.6,8,13,1,12,5,34,5,Matches
94,Jordan Amavi,fr,DF,,Getafe,La Liga,28,1994,2.2,3,2,3,0,0,1,3,33.3,2,3,0,3,4,7,7,Matches
95,Lukáš Ambros,cz,MF,,Wolfsburg,Bundesliga,18,2004,0.2,1,0,1,0,0,1,4,25.0,3,1,0,1,0,1,2,Matches
96,Kelvin Amian,fr,DF,,Spezia,it Serie A,24,1998,26.4,54,32,33,12,9,24,31,77.4,7,34,12,22,22,76,87,Matches
97,Bruno Amione,ar,DF,,Hellas Verona,it Serie A,20,2002,0.6,1,1,1,0,0,1,2,50.0,1,1,0,1,0,1,4,Matches
98,Bruno Amione,ar,DF,,Sampdoria,it Serie A,20,2002,23.2,50,33,36,14,0,19,43,44.2,24,26,11,15,25,75,62,Matches
99,Nadiem Amiri,de,MF,FW,Leverkusen,Bundesliga,25,1996,10.9,15,6,5,8,2,9,20,45.0,11,12,1,11,6,21,10,Matches
100,Samuel Amo-Ameyaw,eng,MF,,Southampton,Premier League,16,2006,0.0,0,0,0,0,0,0,1,0.0,1,0,0,0,0,0,0,Matches
101,Ethan Ampadu,wls,DF,MF,Spezia,it Serie A,21,2000,29.3,66,37,33,28,5,17,41,41.5,24,48,23,25,36,102,98,Matches
102,Sofyan Amrabat,ma,MF,,Fiorentina,it Serie A,25,1996,22.2,39,24,15,17,7,16,29,55.2,13,23,5,18,21,60,18,Matches
103,Ayoub Amraoui,ma,DF,FW,Nice,Ligue 1,18,2004,3.3,6,5,3,3,0,2,5,40.0,3,1,0,1,4,10,4,Matches
104,Joachim Andersen,dk,DF,,Crystal Palace,Premier League,26,1996,30.9,42,22,30,12,0,16,32,50.0,16,28,13,15,24,66,188,Matches
105,Elliot Anderson,eng,MF,FW,Newcastle Utd,Premier League,19,2002,4.6,11,5,5,3,3,6,12,50.0,6,11,2,9,6,17,2,Matches
106,Felipe Anderson,br,FW,,Lazio,it Serie A,29,1993,32.9,80,50,31,41,8,31,88,35.2,57,58,6,52,31,111,27,Matches
107,Benjamin André,fr,MF,,Lille,Ligue 1,31,1990,32.4,128,74,51,60,17,65,121,53.7,56,50,8,42,47,175,60,Matches
108,Marcos André,br,FW,MF,Valencia,La Liga,25,1996,5.0,4,1,1,1,2,1,2,50.0,1,4,1,3,0,4,0,Matches
109,Komnen Andrić,rs,FW,,Clermont Foot,Ligue 1,27,1995,16.1,13,5,2,7,4,2,15,13.3,13,8,1,7,8,21,13,Matches
110,Robert Andrich,de,MF,,Leverkusen,Bundesliga,27,1994,26.7,61,38,30,27,4,26,45,57.8,19,27,9,18,42,103,55,Matches
111,Angeliño,es,DF,,Hoffenheim,Bundesliga,25,1997,29.1,40,24,19,18,3,23,37,62.2,14,32,6,26,25,65,67,Matches
112,Fabrizio Angileri,ar,DF,,Getafe,La Liga,28,1994,6.5,12,9,8,3,1,10,17,58.8,7,8,3,5,7,19,10,Matches
113,Jaidon Anthony,eng,MF,FW,Bournemouth,Premier League,22,1999,14.0,30,17,15,9,6,8,24,33.3,16,30,3,27,10,40,19,Matches
114,Janis Antiste,fr,FW,,Sassuolo,it Serie A,19,2002,0.6,1,0,1,0,0,1,1,100.0,0,0,0,0,0,1,0,Matches
115,Waldemar Anton,de,DF,,Stuttgart,Bundesliga,26,1996,32.6,49,27,27,19,3,27,51,52.9,24,44,16,28,38,87,123,Matches
116,Josep Antoni Gayá,es,DF,MF,Mallorca,La Liga,22,2000,1.1,0,0,0,0,0,0,0,,0,4,2,2,1,1,6,Matches
117,José Antonio,es,MF,DF,Cádiz,La Liga,18,2004,0.5,2,1,0,0,2,0,0,,0,0,0,0,0,2,0,Matches
118,Marcos Antônio,br,MF,,Lazio,it Serie A,22,2000,6.6,9,6,4,5,0,9,20,45.0,11,7,2,5,11,20,18,Matches
119,Michail Antonio,jm,FW,,West Ham,Premier League,32,1990,20.3,14,7,1,8,5,3,12,25.0,9,13,5,8,5,19,9,Matches
120,Antony,br,FW,,Manchester Utd,Premier League,22,2000,20.0,22,9,9,9,4,8,28,28.6,20,18,0,18,11,33,6,Matches
121,Valentin Antov,bg,DF,,Monza,it Serie A,21,2000,3.4,6,5,3,3,0,1,5,20.0,4,5,4,1,4,10,14,Matches
122,Christopher Antwi-Adjei,gh,FW,MF,Bochum,Bundesliga,28,1994,22.0,23,15,7,8,8,10,29,34.5,19,17,0,17,5,28,16,Matches
123,Anuar,ma,MF,FW,Valladolid,La Liga,27,1995,2.3,4,4,0,1,3,0,0,,0,5,2,3,3,7,3,Matches
124,Houssem Aouar,dz,MF,,Lyon,Ligue 1,24,1998,5.8,12,5,5,5,2,3,9,33.3,6,12,2,10,8,20,3,Matches
125,Adil Aouchiche,fr,MF,,Lorient,Ligue 1,20,2002,2.8,5,2,3,1,1,1,9,11.1,8,1,0,1,4,9,1,Matches
126,Dennis Appiah,fr,DF,MF,Nantes,Ligue 1,30,1992,8.8,21,11,14,7,0,10,27,37.0,17,13,5,8,10,31,16,Matches
127,Stredair Appuah,fr,DF,MF,Nantes,Ligue 1,18,2004,0.7,2,1,0,2,0,0,0,,0,2,0,2,1,3,0,Matches
128,Mauro Arambarri,uy,MF,,Getafe,La Liga,26,1995,11.0,14,6,9,4,1,3,17,17.6,14,17,5,12,14,28,19,Matches
129,Charles Aránguiz,cl,MF,,Leverkusen,Bundesliga,33,1989,5.5,17,7,7,10,0,12,20,60.0,8,4,0,4,7,24,4,Matches
130,Ronald Araújo,uy,DF,,Barcelona,La Liga,23,1999,20.0,26,18,12,13,1,6,9,66.7,3,15,7,8,12,38,41,Matches
131,Cameron Archer,eng,FW,MF,Aston Villa,Premier League,21,2001,0.5,0,0,0,0,0,0,0,,0,0,0,0,0,0,0,Matches
132,Taïryk Arconte,fr,FW,,Brest,Ligue 1,18,2003,1.4,1,1,0,0,1,0,3,0.0,3,1,0,1,0,1,2,Matches
133,Alphonse Areola,fr,GK,,West Ham,Premier League,29,1993,3.4,0,0,0,0,0,0,0,,0,0,0,0,0,0,0,Matches
134,Adu Ares,es,FW,MF,Athletic Club,La Liga,20,2001,0.9,4,2,2,1,1,4,4,100.0,0,1,0,1,2,6,1,Matches
135,Joe Aribo,ng,MF,FW,Southampton,Premier League,26,1996,13.6,31,20,15,12,4,11,20,55.0,9,14,1,13,10,41,11,Matches
136,Adam Armstrong,eng,FW,MF,Southampton,Premier League,25,1997,14.8,14,9,6,5,3,3,10,30.0,7,15,3,12,5,19,6,Matches
137,Stuart Armstrong,sct,MF,FW,Southampton,Premier League,30,1992,15.6,32,21,15,13,4,14,39,35.9,25,18,0,18,10,42,9,Matches
138,Marko Arnautović,at,FW,,Bologna,it Serie A,33,1989,17.0,9,6,2,5,2,1,6,16.7,5,11,1,10,2,11,10,Matches
139,Maximilian Arnold,de,MF,,Wolfsburg,Bundesliga,28,1994,30.7,62,31,25,28,9,28,54,51.9,26,34,11,23,26,88,65,Matches
140,Mohamed El Arouch,fr,MF,,Lyon,Ligue 1,18,2004,0.0,1,1,1,0,0,0,0,,0,0,0,0,0,1,0,Matches
141,Sergio Arribas,es,MF,FW,Real Madrid,La Liga,20,2001,0.2,0,0,0,0,0,0,0,,0,1,0,1,0,0,0,Matches
142,Kepa Arrizabalaga,es,GK,,Chelsea,Premier League,27,1994,28.5,2,2,2,0,0,2,3,66.7,1,0,0,0,1,3,16,Matches
143,Roberto Arroyo,es,MF,,Valladolid,La Liga,18,2003,0.2,1,1,0,1,0,1,1,100.0,0,0,0,0,0,1,0,Matches
144,Tolgay Arslan,de,MF,,Udinese,it Serie A,31,1990,13.5,29,18,13,15,1,14,39,35.9,25,19,0,19,12,41,9,Matches
145,Ricard Artero,es,MF,FW,Girona,La Liga,19,2003,1.5,3,3,2,1,0,1,1,100.0,0,2,0,2,1,4,3,Matches
146,Santiago Arzamendia,py,DF,MF,Cádiz,La Liga,24,1998,5.4,9,8,7,1,1,6,21,28.6,15,11,1,10,2,11,15,Matches
147,Takuma Asano,jp,FW,MF,Bochum,Bundesliga,27,1994,19.0,14,9,4,4,6,7,16,43.8,9,17,1,16,8,22,8,Matches
148,Santiago Ascacíbar,ar,MF,,Cremonese,it Serie A,25,1997,8.1,29,14,17,10,2,14,35,40.0,21,14,2,12,13,42,11,Matches
149,Sergio Asenjo,es,GK,,Valladolid,La Liga,33,1989,10.0,0,0,0,0,0,0,0,,0,0,0,0,0,0,10,Matches
150,Marco Asensio,es,FW,MF,Real Madrid,La Liga,26,1996,16.0,16,10,8,6,2,8,19,42.1,11,8,3,5,5,21,4,Matches
151,Kristoffer Askildsen,no,MF,,Lecce,it Serie A,21,2001,8.1,7,3,2,3,2,4,10,40.0,6,15,4,11,11,18,6,Matches
152,Fisnik Asllani,xk,FW,,Hoffenheim,Bundesliga,19,2002,1.9,0,0,0,0,0,0,4,0.0,4,2,0,2,3,3,3,Matches
153,Kristjan Asllani,al,MF,,Inter,it Serie A,20,2002,6.6,11,5,1,8,2,7,10,70.0,3,3,1,2,6,17,4,Matches
154,Iago Aspas,es,FW,,Celta Vigo,La Liga,34,1987,31.9,8,4,0,4,4,3,22,13.6,19,10,1,9,7,15,23,Matches
155,Lorenz Assignon,tg,DF,,Rennes,Ligue 1,22,2000,2.9,6,2,4,2,0,2,4,50.0,2,6,0,6,2,8,9,Matches
156,Youcef Atal,dz,DF,MF,Nice,Ligue 1,26,1996,8.7,38,22,18,15,5,23,32,71.9,9,9,0,9,14,52,13,Matches
157,Valentin Atangana Edoa,fr,MF,,Reims,Ligue 1,16,2005,1.9,8,3,4,2,2,3,6,50.0,3,2,1,1,0,8,1,Matches
158,Pierre-Emerick Aubameyang,ga,FW,,Chelsea,Premier League,33,1989,6.2,1,0,1,0,0,0,1,0.0,1,2,0,2,2,3,4,Matches
159,Pierre-Emerick Aubameyang,ga,FW,,Barcelona,La Liga,33,1989,0.1,0,0,0,0,0,0,0,,0,0,0,0,0,0,0,Matches
160,Emil Audero,it,GK,,Sampdoria,it Serie A,25,1997,25.0,0,0,0,0,0,0,2,0.0,2,0,0,0,0,0,7,Matches
161,Tommaso Augello,it,DF,,Sampdoria,it Serie A,27,1994,34.0,17,14,13,2,2,9,20,45.0,11,23,7,16,17,34,61,Matches
162,Ludwig Augustinsson,se,DF,,Aston Villa,Premier League,28,1994,0.9,1,1,1,0,0,0,0,,0,0,0,0,0,1,1,Matches
163,Ludwig Augustinsson,se,DF,,Mallorca,La Liga,28,1994,1.5,2,1,2,0,0,1,3,33.3,2,1,0,1,1,3,3,Matches
164,Carlos Augusto,br,DF,,Monza,it Serie A,23,1999,34.3,73,38,42,23,8,33,54,61.1,21,24,6,18,24,97,85,Matches
165,Serge Aurier,ci,DF,,Nott'ham Forest,Premier League,29,1992,21.6,64,41,41,18,5,23,33,69.7,10,34,11,23,29,93,75,Matches
166,Mathias Autret,fr,MF,FW,Auxerre,Ligue 1,31,1991,14.3,22,10,10,10,2,7,16,43.8,9,14,2,12,12,34,13,Matches
167,Ezequiel Ávila,ar,FW,MF,Osasuna,La Liga,28,1994,19.0,8,5,2,4,2,6,23,26.1,17,12,1,11,8,16,16,Matches
168,Cédric Avinel,gp,DF,,Ajaccio,Ligue 1,35,1986,19.9,13,7,8,5,0,8,12,66.7,4,20,13,7,15,28,91,Matches
169,Taiwo Awoniyi,ng,FW,,Nott'ham Forest,Premier League,24,1997,15.6,17,10,2,10,5,6,12,50.0,6,18,4,14,4,21,20,Matches
170,Yasin Ayari,se,MF,,Brighton,Premier League,18,2003,0.7,2,2,1,1,0,0,4,0.0,4,1,0,1,0,2,0,Matches
171,Mehmet Aydin,de,DF,FW,Schalke 04,Bundesliga,20,2002,6.3,25,18,14,9,2,11,24,45.8,13,11,0,11,10,35,15,Matches
172,André Ayew,gh,FW,MF,Nott'ham Forest,Premier League,32,1989,3.5,5,3,0,4,1,2,4,50.0,2,6,1,5,0,5,7,Matches
173,Jordan Ayew,gh,FW,MF,Crystal Palace,Premier League,30,1991,30.2,66,41,23,20,23,21,53,39.6,32,35,4,31,15,81,31,Matches
174,Kaan Ayhan,tr,DF,,Sassuolo,it Serie A,27,1994,6.1,10,4,6,4,0,7,7,100.0,0,5,4,1,5,15,26,Matches
175,Luke Ayling,eng,DF,,Leeds United,Premier League,30,1991,22.8,66,37,42,15,9,42,85,49.4,43,34,11,23,26,92,52,Matches
176,Ayman Azhil,ma,MF,,Leverkusen,Bundesliga,21,2001,0.0,0,0,0,0,0,0,0,,0,0,0,0,0,0,0,Matches
177,Sardar Azmoun,ir,FW,MF,Leverkusen,Bundesliga,27,1995,10.3,6,3,1,4,1,1,7,14.3,6,4,0,4,2,8,14,Matches
178,César Azpilicueta,es,DF,,Chelsea,Premier League,32,1989,17.0,43,25,23,15,5,22,37,59.5,15,26,5,21,19,62,54,Matches
179,Sanoussy Ba,de,DF,,RB Leipzig,Bundesliga,18,2004,0.0,0,0,0,0,0,0,0,,0,0,0,0,0,0,0,Matches
180,Iddrisu Baba,gh,MF,DF,Mallorca,La Liga,26,1996,18.9,31,17,15,16,0,15,32,46.9,17,18,8,10,11,42,39,Matches
181,Srđan Babić,rs,DF,,Almería,La Liga,26,1996,33.3,28,18,20,8,0,15,32,46.9,17,34,22,12,29,57,124,Matches
182,Loïc Bade,fr,DF,,Sevilla,La Liga,22,2000,16.1,27,20,23,3,1,17,30,56.7,13,21,13,8,23,50,77,Matches
183,Loïc Bade,fr,DF,,Rennes,Ligue 1,22,2000,1.0,1,1,1,0,0,0,0,,0,0,0,0,1,2,3,Matches
184,Édgar Badía,es,GK,,Elche,La Liga,30,1992,36.0,1,0,1,0,0,1,2,50.0,1,0,0,0,0,1,19,Matches
185,Benoît Badiashile,fr,DF,,Chelsea,Premier League,21,2001,10.1,14,8,10,4,0,9,14,64.3,5,5,2,3,16,30,34,Matches
186,Benoît Badiashile,fr,DF,,Monaco,Ligue 1,21,2001,9.3,10,8,6,4,0,5,10,50.0,5,9,6,3,17,27,40,Matches
187,Alex Baena,es,MF,FW,Villarreal,La Liga,21,2001,21.6,30,17,9,15,6,15,45,33.3,30,15,3,12,7,37,16,Matches
188,Jaime Báez,uy,DF,,Cremonese,it Serie A,27,1995,1.1,4,2,3,0,1,3,6,50.0,3,0,0,0,0,4,2,Matches
189,Leon Bailey,jm,FW,MF,Aston Villa,Premier League,24,1997,21.9,14,6,6,7,1,5,20,25.0,15,13,0,13,6,20,12,Matches
190,Eric Bailly,ci,DF,,Marseille,Ligue 1,28,1994,6.0,13,10,6,6,1,7,7,100.0,0,15,12,3,12,25,18,Matches
191,Dénys Bain,fr,DF,,Auxerre,Ligue 1,29,1993,1.4,4,3,3,1,0,1,2,50.0,1,2,1,1,2,6,4,Matches
192,Brandon Baiye,be,MF,,Clermont Foot,Ligue 1,21,2000,0.6,3,2,2,1,0,2,3,66.7,1,1,0,1,1,4,3,Matches
193,Stefan Bajcetic,es,MF,,Liverpool,Premier League,17,2004,5.8,9,6,5,3,1,8,27,29.6,19,7,0,7,9,18,4,Matches
194,Nedim Bajrami,al,MF,FW,Empoli,it Serie A,23,1999,10.4,8,4,3,3,2,4,6,66.7,2,5,0,5,7,15,4,Matches
195,Nedim Bajrami,al,FW,MF,Sassuolo,it Serie A,23,1999,9.1,12,7,6,2,4,5,11,45.5,6,9,1,8,7,19,6,Matches
196,Cédric Bakambu,cd,MF,,Marseille,Ligue 1,31,1991,0.7,2,1,2,0,0,2,2,100.0,0,0,0,0,0,2,0,Matches
197,Tiemoué Bakayoko,fr,MF,,Milan,it Serie A,27,1994,0.5,5,5,4,1,0,3,3,100.0,0,0,0,0,0,5,0,Matches
198,Mitchel Bakker,nl,DF,MF,Leverkusen,Bundesliga,22,2000,18.4,16,8,9,7,0,6,15,40.0,9,20,2,18,15,31,20,Matches
199,Ridle Baku,de,DF,FW,Wolfsburg,Bundesliga,24,1998,28.7,50,26,29,17,4,32,58,55.2,26,44,6,38,21,71,59,Matches
200,Tommaso Baldanzi,it,MF,,Empoli,it Serie A,19,2003,19.7,25,12,9,13,3,7,32,21.9,25,21,1,20,2,27,5,Matches
201,Alejandro Balde,es,DF,,Barcelona,La Liga,18,2003,27.5,42,30,22,16,4,24,41,58.5,17,25,3,22,12,54,17,Matches
202,Thierno Balde,fr,DF,MF,Troyes,Ligue 1,20,2002,23.9,27,14,19,4,4,18,30,60.0,12,15,3,12,23,50,39,Matches
203,Carlos Baleba,cm,MF,,Lille,Ligue 1,18,2004,5.3,13,11,2,9,2,9,14,64.3,5,13,3,10,1,14,3,Matches
204,Mikel Balenziaga,es,DF,,Athletic Club,La Liga,34,1988,1.3,4,4,1,2,1,4,4,100.0,0,0,0,0,1,5,2,Matches
205,Leonardo Balerdi,ar,DF,,Marseille,Ligue 1,23,1999,29.3,57,37,43,12,2,32,45,71.1,13,48,29,19,63,120,91,Matches
206,Dominic Ballard,eng,FW,MF,Southampton,Premier League,17,2005,0.3,0,0,0,0,0,0,0,,0,0,0,0,1,1,0,Matches
207,Iván Balliu,al,DF,,Rayo Vallecano,La Liga,30,1992,35.9,52,29,26,20,6,18,30,60.0,12,26,3,23,25,77,72,Matches
208,Fodé Ballo-Touré,sn,DF,,Milan,it Serie A,25,1997,5.8,14,9,7,6,1,7,10,70.0,3,11,3,8,2,16,3,Matches
209,Folarin Balogun,us,FW,,Reims,Ligue 1,21,2001,33.3,9,5,1,5,3,2,20,10.0,18,20,1,19,3,12,15,Matches
210,Abdoulaye Bamba,ci,DF,,Angers,Ligue 1,32,1990,15.2,22,12,15,5,2,16,19,84.2,3,7,3,4,18,40,38,Matches
211,Jonathan Bamba,ci,FW,,Lille,Ligue 1,26,1996,30.9,37,17,12,14,11,14,45,31.1,31,36,1,35,22,59,14,Matches
212,Patrick Bamford,eng,FW,,Leeds United,Premier League,28,1993,16.8,9,6,0,6,3,4,20,20.0,16,12,5,7,5,14,13,Matches
213,Lameck Banda,zm,FW,MF,Lecce,it Serie A,21,2001,18.2,30,20,13,14,3,15,41,36.6,26,24,2,22,8,38,5,Matches
214,Filippo Bandinelli,it,MF,,Empoli,it Serie A,27,1995,25.1,55,34,19,26,10,17,45,37.8,28,20,7,13,18,73,40,Matches
215,Léo Baptistão,br,FW,MF,Almería,La Liga,29,1992,19.2,32,20,13,16,3,13,33,39.4,20,17,2,15,19,51,12,Matches
216,Shandon Baptiste,gd,MF,,Brentford,Premier League,24,1998,6.9,15,9,6,6,3,7,17,41.2,10,10,2,8,7,22,10,Matches
217,Antonín Barák,cz,MF,,Hellas Verona,it Serie A,27,1994,0.3,0,0,0,0,0,0,0,,0,0,0,0,0,0,0,Matches
218,Antonín Barák,cz,MF,,Fiorentina,it Serie A,27,1994,20.0,21,9,5,7,9,6,16,37.5,10,16,2,14,3,24,13,Matches
219,Andrea Barberis,it,MF,,Monza,it Serie A,28,1993,3.8,7,2,4,3,0,5,11,45.5,6,0,0,0,8,15,1,Matches
220,Tommaso Barbieri,it,DF,,Juventus,it Serie A,19,2002,1.2,3,3,3,0,0,3,8,37.5,5,3,0,3,0,3,2,Matches
221,Bradley Barcola,fr,FW,MF,Lyon,Ligue 1,19,2002,16.0,25,16,8,10,7,8,39,20.5,31,29,0,29,19,44,10,Matches
222,Melvin Bard,fr,DF,,Nice,Ligue 1,21,2000,27.3,96,60,61,29,6,59,89,66.3,30,35,4,31,64,160,40,Matches
223,Francesco Bardi,it,GK,,Bologna,it Serie A,30,1992,1.0,0,0,0,0,0,0,0,,0,0,0,0,0,0,0,Matches
224,Keidi Bare,al,MF,,Espanyol,La Liga,24,1997,5.6,15,8,7,5,3,7,13,53.8,6,8,2,6,11,26,8,Matches
225,Nicolò Barella,it,MF,,Inter,it Serie A,25,1997,29.0,49,25,17,26,6,28,53,52.8,25,29,5,24,12,61,12,Matches
226,Kike Barja,es,FW,MF,Osasuna,La Liga,25,1997,14.6,15,9,6,5,4,8,24,33.3,16,7,0,7,4,19,3,Matches
227,Ross Barkley,eng,MF,FW,Nice,Ligue 1,28,1993,10.7,16,9,7,4,5,7,13,53.8,6,7,2,5,8,24,6,Matches
228,Aymen Barkok,ma,MF,,Mainz 05,Bundesliga,24,1998,6.5,18,8,10,5,3,5,10,50.0,5,7,0,7,3,21,9,Matches
229,Harvey Barnes,eng,FW,MF,Leicester City,Premier League,24,1997,30.1,26,14,8,14,4,14,42,33.3,28,32,1,31,8,34,12,Matches
230,Leandro Barreiro Martins,lu,MF,,Mainz 05,Bundesliga,22,2000,23.8,60,38,19,28,13,22,49,44.9,27,38,13,25,41,101,39,Matches
231,Enzo Barrenechea,ar,MF,,Juventus,it Serie A,21,2001,1.8,8,3,3,4,1,3,5,60.0,2,3,0,3,2,10,3,Matches
232,Ander Barrenetxea,es,FW,DF,Real Sociedad,La Liga,20,2001,9.8,21,15,15,6,0,12,28,42.9,16,15,1,14,5,26,7,Matches
233,Mickaël Barreto,fr,MF,,Ajaccio,Ligue 1,31,1991,14.7,32,20,12,17,3,8,45,17.8,37,17,0,17,18,50,11,Matches
234,Pablo Barrios,es,MF,,Atlético Madrid,La Liga,19,2003,8.0,19,10,3,10,6,8,15,53.3,7,12,2,10,9,28,6,Matches
235,Musa Barrow,gm,FW,MF,Bologna,it Serie A,23,1998,21.8,21,4,10,6,5,8,14,57.1,6,25,1,24,1,22,7,Matches
236,Federico Baschirotto,it,DF,,Lecce,it Serie A,25,1996,37.0,40,30,35,5,0,22,36,61.1,14,45,29,16,36,76,192,Matches
237,Toma Bašić,hr,MF,,Lazio,it Serie A,25,1996,5.7,6,4,4,1,1,3,8,37.5,5,9,0,9,7,13,8,Matches
238,Alberto Basso,it,MF,,Cremonese,it Serie A,18,2004,0.2,0,0,0,0,0,0,0,,0,0,0,0,0,0,0,Matches
239,Gil Bastião Dias,pt,FW,,Stuttgart,Bundesliga,25,1996,4.4,8,6,3,4,1,3,12,25.0,9,7,0,7,2,10,3,Matches
240,Alessandro Bastoni,it,DF,,Inter,it Serie A,23,1999,24.0,41,20,20,14,7,11,27,40.7,16,27,13,14,24,65,45,Matches
241,Simone Bastoni,it,MF,DF,Spezia,it Serie A,25,1996,13.2,47,24,23,19,5,15,33,45.5,18,20,5,15,8,55,14,Matches
242,Rodrigo Battaglia,ar,MF,,Mallorca,La Liga,31,1991,7.6,12,5,7,5,0,6,14,42.9,8,16,7,9,5,17,18,Matches
243,Maximilian Bauer,de,DF,,Augsburg,Bundesliga,22,2000,20.5,31,17,18,12,1,17,34,50.0,17,25,9,16,23,54,79,Matches
244,Oliver Baumann,de,GK,,Hoffenheim,Bundesliga,32,1990,34.0,0,0,0,0,0,0,0,,0,0,0,0,0,0,15,Matches
245,Timo Baumgartl,de,DF,,Union Berlin,Bundesliga,26,1996,6.2,11,6,5,4,2,5,18,27.8,13,12,4,8,2,13,14,Matches
246,Julian Baumgartlinger,at,MF,,Augsburg,Bundesliga,34,1988,6.2,15,4,5,6,4,6,19,31.6,13,4,2,2,4,19,15,Matches
247,Christoph Baumgartner,at,MF,FW,Hoffenheim,Bundesliga,22,1999,28.5,36,19,12,17,7,9,52,17.3,43,57,5,52,15,51,19,Matches
248,Cyrille Bayala,bf,MF,,Ajaccio,Ligue 1,26,1996,22.3,53,37,16,20,17,23,48,47.9,25,20,3,17,25,78,21,Matches
249,Brian Bayeye,cd,DF,,Torino,it Serie A,22,2000,0.7,3,0,3,0,0,1,1,100.0,0,1,1,0,1,4,2,Matches
250,Noah Joel Sarenren Bazee,ng,MF,FW,Augsburg,Bundesliga,25,1996,0.2,0,0,0,0,0,0,1,0.0,1,1,0,1,0,0,0,Matches
251,Gavin Bazunu,ie,GK,,Southampton,Premier League,20,2002,32.0,1,0,1,0,0,1,1,100.0,0,0,0,0,1,2,24,Matches
252,Bebé,cv,FW,,Rayo Vallecano,La Liga,32,1990,0.7,0,0,0,0,0,0,2,0.0,2,1,0,1,0,0,0,Matches
253,Ihlas Bebou,tg,FW,DF,Hoffenheim,Bundesliga,28,1994,15.7,19,16,8,7,4,11,17,64.7,6,9,2,7,7,26,15,Matches
254,Rodrigo Becão,br,DF,,Udinese,it Serie A,26,1996,27.6,70,36,50,17,3,40,53,75.5,13,44,24,20,26,96,68,Matches
255,Mads Bech Sørensen,dk,DF,MF,Brentford,Premier League,23,1999,0.2,0,0,0,0,0,0,0,,0,0,0,0,1,1,1,Matches
256,Julius Beck,dk,MF,,Spezia,it Serie A,17,2005,0.1,2,1,1,1,0,0,0,,0,0,0,0,0,2,0,Matches
257,Sheraldo Becker,sr,FW,,Union Berlin,Bundesliga,27,1995,28.4,15,5,1,7,7,2,11,18.2,9,13,1,12,3,18,7,Matches
258,Jan Bednarek,pl,DF,,Southampton,Premier League,26,1996,18.6,27,21,20,7,0,12,16,75.0,4,38,27,11,49,76,87,Matches
259,Jan Bednarek,pl,DF,,Aston Villa,Premier League,26,1996,1.1,3,3,0,3,0,1,1,100.0,0,3,1,2,2,5,5,Matches
260,Donny van de Beek,nl,MF,,Manchester Utd,Premier League,25,1997,1.9,0,0,0,0,0,0,1,0.0,1,2,1,1,1,1,1,Matches
261,Asmir Begović,ba,GK,,Everton,Premier League,35,1987,1.0,0,0,0,0,0,0,0,,0,0,0,0,0,0,1,Matches
262,Yanis Begraoui,ma,FW,MF,Toulouse,Ligue 1,21,2001,0.7,2,0,1,0,1,1,2,50.0,1,0,0,0,1,3,0,Matches
263,Kevin Behrens,de,FW,,Union Berlin,Bundesliga,31,1991,17.1,11,7,4,4,3,4,18,22.2,14,18,3,15,5,16,25,Matches
264,Alexis Beka Beka,fr,MF,DF,Nice,Ligue 1,21,2001,6.1,16,5,6,9,1,4,15,26.7,11,9,1,8,12,28,6,Matches
265,Jérémie Bela,ao,DF,MF,Clermont Foot,Ligue 1,29,1993,8.3,6,4,2,1,3,3,4,75.0,1,10,1,9,9,15,8,Matches
266,Reda Belahyane,ma,MF,,Nice,Ligue 1,18,2004,2.0,8,6,5,3,0,3,5,60.0,2,5,1,4,2,10,0,Matches
267,Youcef Belaïli,dz,MF,FW,Ajaccio,Ligue 1,30,1992,12.8,18,10,3,9,6,8,20,40.0,12,10,1,9,5,23,4,Matches
268,Youcef Belaïli,dz,FW,MF,Brest,Ligue 1,30,1992,4.0,5,2,3,2,0,2,7,28.6,5,2,0,2,1,6,1,Matches
269,Haris Belkebla,dz,MF,,Brest,Ligue 1,28,1994,29.5,80,48,35,40,5,44,85,51.8,41,32,6,26,52,132,21,Matches
270,Stefan Bell,de,DF,,Mainz 05,Bundesliga,30,1991,26.6,43,28,32,10,1,22,44,50.0,22,42,15,27,44,87,133,Matches
271,Armel Bella Kotchap,de,DF,,Southampton,Premier League,20,2001,20.9,37,17,28,9,0,15,20,75.0,5,29,12,17,44,81,110,Matches
272,Raoul Bellanova,it,DF,,Inter,it Serie A,22,2000,5.5,14,6,11,2,1,9,14,64.3,5,6,1,5,4,18,14,Matches
273,Karim Bellarabi,de,FW,MF,Leverkusen,Bundesliga,32,1990,0.9,2,0,1,1,0,2,3,66.7,1,0,0,0,0,2,0,Matches
274,Jean-Ricner Bellegarde,fr,MF,FW,Strasbourg,Ligue 1,24,1998,26.9,47,25,15,21,11,11,25,44.0,14,26,3,23,26,73,22,Matches
275,Héctor Bellerín,es,DF,,Barcelona,La Liga,27,1995,1.6,2,0,0,2,0,2,3,66.7,1,2,0,2,3,5,2,Matches
276,Jude Bellingham,eng,MF,,Dortmund,Bundesliga,19,2003,29.9,76,42,28,34,14,34,51,66.7,17,51,4,47,35,111,30,Matches
277,Jeanuël Belocian,fr,DF,,Rennes,Ligue 1,17,2005,5.6,10,7,3,5,2,5,9,55.6,4,6,3,3,6,16,11,Matches
278,Andrea Belotti,it,FW,,Roma,it Serie A,28,1993,12.7,12,5,3,5,4,5,11,45.5,6,11,1,10,3,15,5,Matches
279,Fran Beltrán,es,MF,,Celta Vigo,La Liga,23,1999,31.7,34,22,15,14,5,14,55,25.5,41,29,5,24,53,87,35,Matches
280,Eliesse Ben Seghir,ma,FW,MF,Monaco,Ligue 1,17,2005,11.7,18,10,4,12,2,4,12,33.3,8,18,1,17,4,22,1,Matches
281,Salim Ben Seghir,fr,MF,,Marseille,Ligue 1,19,2003,0.0,0,0,0,0,0,0,0,,0,1,0,1,0,0,0,Matches
282,Wissam Ben Yedder,fr,FW,,Monaco,Ligue 1,31,1990,23.5,16,9,2,5,9,4,13,30.8,9,15,0,15,4,20,0,Matches
283,Marco Benassi,it,DF,,Fiorentina,it Serie A,27,1994,1.0,3,3,2,0,1,3,4,75.0,1,0,0,0,1,4,1,Matches
284,Marco Benassi,it,MF,,Cremonese,it Serie A,27,1994,11.1,26,15,9,11,6,15,24,62.5,9,13,1,12,12,38,19,Matches
285,Iker Benito,es,FW,MF,Osasuna,La Liga,19,2002,2.0,4,3,0,3,1,2,4,50.0,2,0,0,0,2,6,4,Matches
286,Ismaël Bennacer,dz,MF,,Milan,it Serie A,24,1997,22.3,59,33,26,31,2,30,51,58.8,21,25,7,18,26,85,16,Matches
287,Saïd Benrahma,dz,FW,MF,West Ham,Premier League,26,1995,23.0,25,15,11,7,7,11,27,40.7,16,23,1,22,9,34,13,Matches
288,Ramy Bensebaini,dz,DF,,Gladbach,Bundesliga,27,1995,27.6,34,21,21,10,3,26,39,66.7,13,44,14,30,36,70,98,Matches
289,Nabil Bentaleb,dz,MF,,Angers,Ligue 1,27,1994,27.7,74,40,31,35,8,36,61,59.0,25,33,11,22,44,118,29,Matches
290,Rodrigo Bentancur,uy,MF,,Tottenham,Premier League,25,1997,16.7,45,28,15,21,9,16,28,57.1,12,28,15,13,20,65,22,Matches
291,Daniel Bentley,eng,GK,,Wolves,Premier League,29,1993,2.0,1,1,1,0,0,1,1,100.0,0,0,0,0,0,1,0,Matches
292,Karim Benzema,fr,FW,,Real Madrid,La Liga,34,1987,22.6,9,5,2,4,3,2,11,18.2,9,11,0,11,2,11,5,Matches
293,Domenico Berardi,it,FW,,Sassuolo,it Serie A,27,1994,20.7,23,14,8,10,5,9,40,22.5,31,13,0,13,19,42,18,Matches
294,Yuri Berchiche,es,DF,,Athletic Club,La Liga,32,1990,26.7,56,32,28,20,8,35,59,59.3,24,37,12,25,40,96,59,Matches
295,Álex Berenguer,es,FW,,Athletic Club,La Liga,27,1995,25.5,58,37,17,25,16,23,60,38.3,37,37,4,33,10,68,6,Matches
296,Bartosz Bereszyński,pl,DF,,Sampdoria,it Serie A,30,1992,13.3,28,18,15,11,2,17,26,65.4,9,18,4,14,21,49,25,Matches
297,Bartosz Bereszyński,pl,DF,,Napoli,it Serie A,30,1992,1.8,3,2,1,1,1,2,2,100.0,0,4,0,4,3,6,3,Matches
298,Patrick Berg,no,MF,FW,Lens,Ligue 1,24,1997,0.3,0,0,0,0,0,0,1,0.0,1,0,0,0,1,1,0,Matches
299,Mitchell van Bergen,nl,FW,DF,Reims,Ligue 1,22,1999,10.1,18,8,6,7,5,8,20,40.0,12,8,2,6,6,24,11,Matches
300,Mergim Berisha,de,FW,,Augsburg,Bundesliga,24,1998,18.7,11,6,4,3,4,4,14,28.6,10,16,1,15,0,11,19,Matches
301,Quentin Bernard,fr,DF,,Auxerre,Ligue 1,33,1989,7.0,9,7,4,2,3,7,15,46.7,8,9,1,8,15,24,17,Matches
302,Paul Bernardoni,fr,GK,,Angers,Ligue 1,25,1997,27.0,2,0,2,0,0,2,3,66.7,1,1,0,1,1,3,12,Matches
303,Juan Bernat,es,DF,MF,Paris S-G,Ligue 1,29,1993,18.3,32,16,18,9,5,21,39,53.8,18,11,2,9,9,41,22,Matches
304,Victor Bernth Kristiansen,dk,DF,,Leicester City,Premier League,19,2002,9.9,38,23,18,16,4,22,30,73.3,8,16,4,12,3,41,26,Matches
305,Jason Berthomier,fr,MF,,Clermont Foot,Ligue 1,32,1990,0.3,0,0,0,0,0,0,0,,0,0,0,0,0,0,0,Matches
306,Marco Bertini,it,MF,,Lazio,it Serie A,19,2002,0.0,0,0,0,0,0,0,0,,0,0,0,0,0,0,0,Matches
307,Beto,gw,FW,,Udinese,it Serie A,24,1998,23.7,16,9,0,9,7,4,17,23.5,13,18,3,15,6,22,30,Matches
308,Owen Bevan,wls,DF,,Bournemouth,Premier League,18,2003,0.1,0,0,0,0,0,0,0,,0,0,0,0,0,0,0,Matches
309,Matteo Bianchetti,it,DF,,Cremonese,it Serie A,29,1993,23.7,32,19,21,9,2,20,32,62.5,12,31,17,14,20,52,111,Matches
310,Alessandro Bianco,it,MF,,Fiorentina,it Serie A,19,2002,1.7,5,2,2,3,0,2,3,66.7,1,1,0,1,0,5,0,Matches
311,Giulian Biancone,fr,DF,,Nott'ham Forest,Premier League,22,2000,0.2,2,1,2,0,0,1,1,100.0,0,0,0,0,1,3,0,Matches
312,Ermin Bičakčić,ba,DF,,Hoffenheim,Bundesliga,32,1990,2.9,8,4,6,1,1,2,6,33.3,4,4,3,1,5,13,14,Matches
313,Pedro Bigas,es,DF,,Elche,La Liga,31,1990,22.4,37,20,30,7,0,18,29,62.1,11,25,14,11,33,70,95,Matches
314,Jaka Bijol,si,DF,,Udinese,it Serie A,23,1999,30.3,39,23,32,7,0,16,27,59.3,11,41,25,16,29,68,165,Matches
315,El Bilal Touré,ml,FW,,Almería,La Liga,20,2001,14.0,4,3,2,1,1,0,3,0.0,3,6,1,5,1,5,23,Matches
316,El Bilal Touré,ml,FW,,Reims,Ligue 1,20,2001,1.0,0,0,0,0,0,0,0,,0,2,0,2,0,0,1,Matches
317,Philip Billing,dk,MF,FW,Bournemouth,Premier League,26,1996,30.7,63,36,21,33,9,11,42,26.2,31,48,8,40,31,94,58,Matches
318,Jean-Claude Billong,cm,MF,,Clermont Foot,Ligue 1,28,1993,0.3,0,0,0,0,0,0,0,,0,1,1,0,1,1,0,Matches
319,Cristiano Biraghi,it,DF,,Fiorentina,it Serie A,29,1992,28.3,65,38,29,29,7,32,65,49.2,33,32,7,25,14,79,42,Matches
320,Samuele Birindelli,it,DF,,Monza,it Serie A,23,1999,15.6,35,19,21,10,4,18,29,62.1,11,28,8,20,16,51,30,Matches
321,Veljko Birmančević,rs,FW,MF,Toulouse,Ligue 1,24,1998,4.9,13,7,5,4,4,7,21,33.3,14,12,2,10,7,20,1,Matches
322,Tom Bischof,de,MF,FW,Hoffenheim,Bundesliga,17,2005,3.5,15,10,8,3,4,7,10,70.0,3,5,1,4,1,16,1,Matches
323,Yves Bissouma,ml,MF,,Tottenham,Premier League,25,1996,11.2,16,13,6,6,4,2,7,28.6,5,15,6,9,12,28,10,Matches
324,Kristijan Bistrović,hr,MF,,Lecce,it Serie A,24,1998,5.1,3,1,3,0,0,0,5,0.0,5,3,0,3,0,3,4,Matches
325,Leonardo Bittencourt,de,MF,DF,Werder Bremen,Bundesliga,28,1993,18.1,53,28,20,25,8,25,62,40.3,37,13,0,13,10,63,15,Matches
326,Marco Bizot,nl,GK,,Brest,Ligue 1,31,1991,37.0,0,0,0,0,0,0,1,0.0,1,1,0,1,0,0,24,Matches
327,Antonio Blanco,es,MF,,Cádiz,La Liga,22,2000,1.8,6,4,5,1,0,4,6,66.7,2,5,0,5,1,7,3,Matches
328,Lautaro Blanco,ar,DF,MF,Elche,La Liga,23,1999,9.7,16,9,10,4,2,9,26,34.6,17,8,1,7,2,18,10,Matches
329,Rubén Blanco,es,GK,,Marseille,Ligue 1,27,1995,5.5,0,0,0,0,0,0,0,,0,0,0,0,0,0,1,Matches
330,Ludovic Blas,fr,MF,FW,Nantes,Ligue 1,24,1997,31.3,47,30,17,19,11,17,49,34.7,32,26,1,25,19,66,8,Matches
331,Janis Blaswich,de,GK,,RB Leipzig,Bundesliga,31,1991,26.0,0,0,0,0,0,0,0,,0,0,0,0,0,0,10,Matches
332,Miha Blažič,si,DF,,Angers,Ligue 1,29,1993,22.0,8,6,8,0,0,7,15,46.7,8,25,19,6,22,30,80,Matches
333,Joaquín Blázquez,ar,GK,,Brest,Ligue 1,21,2001,1.0,0,0,0,0,0,0,0,,0,0,0,0,0,0,2,Matches
334,Alexis Blin,fr,MF,,Lecce,it Serie A,25,1996,26.4,69,39,27,33,9,38,73,52.1,35,55,15,40,34,103,74,Matches
335,Daley Blind,nl,DF,MF,Bayern Munich,Bundesliga,32,1990,1.5,2,0,2,0,0,0,1,0.0,1,4,2,2,2,4,6,Matches
336,Myron Boadu,nl,FW,,Monaco,Ligue 1,21,2001,3.3,3,3,0,2,1,1,7,14.3,6,1,0,1,0,3,1,Matches
337,Jérôme Boateng,de,DF,,Lyon,Ligue 1,33,1988,4.8,3,0,2,1,0,2,6,33.3,4,8,5,3,6,9,16,Matches
338,Kevin-Prince Boateng,gh,MF,,Hertha BSC,Bundesliga,35,1987,5.2,8,6,4,2,2,3,9,33.3,6,11,3,8,3,11,5,Matches
339,Antonin Bobichon,fr,MF,,Angers,Ligue 1,26,1995,0.2,0,0,0,0,0,0,0,,0,1,0,1,0,0,0,Matches
340,Jean-Paul Boëtius,nl,MF,,Hertha BSC,Bundesliga,28,1994,11.7,30,16,19,9,2,8,25,32.0,17,25,5,20,14,44,10,Matches
341,Jeremie Boga,ci,MF,FW,Atalanta,it Serie A,25,1997,8.7,9,5,3,2,4,2,5,40.0,3,6,0,6,1,10,1,Matches
342,Emil Bohinen,no,MF,,Salernitana,it Serie A,23,1999,9.2,25,13,15,8,2,12,23,52.2,11,25,7,18,17,42,21,Matches
343,Quentin Boisgard,fr,MF,,Lorient,Ligue 1,25,1997,2.0,6,2,1,4,1,3,4,75.0,1,3,1,2,4,10,2,Matches
344,Willy Boly,ci,DF,,Nott'ham Forest,Premier League,31,1991,7.6,13,6,8,3,2,8,13,61.5,5,13,4,9,12,25,45,Matches
345,Giacomo Bonaventura,it,MF,,Fiorentina,it Serie A,32,1989,21.2,35,23,14,15,6,24,37,64.9,13,14,0,14,16,51,5,Matches
346,Federico Bonazzoli,it,FW,MF,Salernitana,it Serie A,25,1997,12.4,5,3,0,3,2,0,9,0.0,9,9,1,8,3,8,0,Matches
347,Warren Bondo,fr,MF,,Monza,it Serie A,18,2003,0.7,1,0,1,0,0,0,0,,0,1,0,1,0,1,0,Matches
348,Theo Bongonda,cd,MF,FW,Cádiz,La Liga,26,1995,21.5,28,20,11,14,3,17,40,42.5,23,21,2,19,6,34,14,Matches
349,Kevin Bonifazi,it,DF,,Bologna,it Serie A,26,1996,10.0,13,8,7,6,0,6,12,50.0,6,11,8,3,12,25,39,Matches
350,Leonardo Bonucci,it,DF,,Juventus,it Serie A,35,1987,9.8,5,4,1,4,0,2,4,50.0,2,12,8,4,13,18,29,Matches
351,Neto Borges,br,DF,,Clermont Foot,Ligue 1,25,1996,31.5,75,45,45,20,10,46,75,61.3,29,45,11,34,41,116,62,Matches
352,Yvandro Borges Sanches,lu,FW,MF,Gladbach,Bundesliga,18,2004,0.3,2,2,0,2,0,2,2,100.0,0,0,0,0,0,2,0,Matches
353,Sebastiaan Bornauw,be,DF,,Wolfsburg,Bundesliga,23,1999,21.4,29,17,17,10,2,16,22,72.7,6,27,12,15,31,60,83,Matches
354,Rafael Borré,co,MF,FW,Eint Frankfurt,Bundesliga,26,1995,12.0,25,15,4,13,8,4,17,23.5,13,10,2,8,2,27,9,Matches
355,Erik Botheim,no,MF,FW,Salernitana,it Serie A,22,2000,9.6,11,7,3,4,4,6,13,46.2,7,3,0,3,0,11,4,Matches
356,Sven Botman,nl,DF,,Newcastle Utd,Premier League,22,2000,34.7,38,24,31,7,0,22,28,78.6,6,44,24,20,34,72,126,Matches
357,Kenji-Van Boto,mg,DF,,Auxerre,Ligue 1,26,1996,2.0,3,2,2,0,1,2,4,50.0,2,0,0,0,1,4,3,Matches
358,Kouamé Botué,bf,FW,MF,Ajaccio,Ligue 1,19,2002,2.5,4,2,2,1,1,0,2,0.0,2,1,0,1,0,4,1,Matches
359,Badredine Bouanani,dz,FW,MF,Nice,Ligue 1,17,2004,9.6,13,9,2,7,4,7,14,50.0,7,4,0,4,1,14,2,Matches
360,Hicham Boudaoui,dz,MF,,Nice,Ligue 1,22,1999,20.8,67,32,31,30,6,35,53,66.0,18,34,5,29,36,103,16,Matches
361,Franci Bouebari,fr,DF,,Strasbourg,Ligue 1,18,2003,0.8,3,0,1,2,0,3,5,60.0,2,0,0,0,2,5,2,Matches
362,Sofiane Boufal,ma,FW,MF,Angers,Ligue 1,28,1993,9.3,14,9,7,4,3,3,14,21.4,11,6,0,6,5,19,1,Matches
363,Yassine Bounou,ma,GK,,Sevilla,La Liga,31,1991,23.9,2,1,2,0,0,1,4,25.0,3,0,0,0,2,4,11,Matches
364,Ismaël Boura,km,DF,FW,Lens,Ligue 1,21,2000,1.0,6,4,4,2,0,5,6,83.3,1,2,1,1,2,8,3,Matches
365,Mehdi Bourabia,ma,MF,,Spezia,it Serie A,30,1991,30.8,41,20,13,22,6,19,41,46.3,22,39,12,27,32,73,57,Matches
366,Benjamin Bourigeaud,fr,MF,FW,Rennes,Ligue 1,28,1994,34.1,45,29,16,23,6,21,65,32.3,44,38,3,35,31,76,32,Matches
367,Edoardo Bove,it,MF,,Roma,it Serie A,20,2002,11.0,35,18,12,15,8,16,39,41.0,23,15,1,14,10,45,11,Matches
368,Jarrod Bowen,eng,FW,MF,West Ham,Premier League,25,1996,35.9,39,16,14,11,14,16,58,27.6,42,47,9,38,36,75,25,Matches
369,Lucas Boyé,ar,FW,,Elche,La Liga,26,1996,27.4,36,16,12,16,8,17,35,48.6,18,33,5,28,15,51,46,Matches
370,Jayden Braaf,nl,MF,FW,Hellas Verona,it Serie A,19,2002,3.2,5,3,2,3,0,0,0,,0,1,0,1,2,7,1,Matches
371,Domagoj Bradarić,hr,DF,,Salernitana,it Serie A,22,1999,25.0,26,19,14,8,4,7,16,43.8,9,20,5,15,21,47,44,Matches
372,Bilal Brahimi,dz,FW,MF,Nice,Ligue 1,22,2000,8.9,8,5,2,5,1,1,7,14.3,6,4,0,4,4,12,0,Matches
373,Martin Braithwaite,dk,FW,MF,Espanyol,La Liga,31,1991,27.3,12,2,2,4,6,5,14,35.7,9,10,0,10,5,17,11,Matches
374,Julian Brandt,de,MF,FW,Dortmund,Bundesliga,26,1996,26.6,29,20,6,14,9,12,43,27.9,31,23,0,23,15,44,9,Matches
375,Darko Brašanac,rs,MF,,Osasuna,La Liga,30,1992,11.6,29,20,12,10,7,12,23,52.2,11,14,2,12,12,41,9,Matches
376,Lilian Brassier,fr,DF,,Brest,Ligue 1,22,1999,34.4,42,30,31,8,3,23,32,71.9,9,42,19,23,53,95,132,Matches
377,Claudio Bravo,cl,GK,,Betis,La Liga,39,1983,12.0,0,0,0,0,0,0,0,,0,0,0,0,2,2,1,Matches
378,Fabian Bredlow,de,GK,,Stuttgart,Bundesliga,27,1995,15.0,1,1,1,0,0,1,1,100.0,0,0,0,0,0,1,4,Matches
379,James Bree,eng,DF,,Southampton,Premier League,24,1997,4.1,5,3,4,1,0,3,4,75.0,1,3,1,2,6,11,11,Matches
380,Josip Brekalo,hr,FW,MF,Fiorentina,it Serie A,24,1998,2.5,2,1,0,1,1,1,4,25.0,3,1,0,1,1,3,1,Matches
381,Josip Brekalo,hr,MF,FW,Wolfsburg,Bundesliga,24,1998,3.0,2,1,2,0,0,0,4,0.0,4,0,0,0,2,4,2,Matches
382,Gleison Bremer,br,DF,,Juventus,it Serie A,25,1997,29.3,29,20,23,5,1,19,26,73.1,7,44,22,22,42,71,120,Matches
383,Armando Broja,al,FW,,Chelsea,Premier League,20,2001,3.3,4,1,0,3,1,1,1,100.0,0,10,1,9,1,5,1,Matches
384,Dylan Bronn,tn,DF,,Salernitana,it Serie A,27,1995,18.7,34,18,17,16,1,20,30,66.7,10,32,20,12,20,54,58,Matches
385,David Brooks,wls,FW,MF,Bournemouth,Premier League,25,1997,1.9,1,0,1,0,0,0,1,0.0,1,2,0,2,2,3,5,Matches
386,John Brooks,us,DF,,Hoffenheim,Bundesliga,29,1993,15.0,18,12,10,8,0,13,18,72.2,5,17,12,5,10,28,105,Matches
387,Moritz Broschinski,de,FW,MF,Bochum,Bundesliga,21,2000,2.4,0,0,0,0,0,0,5,0.0,5,1,0,1,0,0,6,Matches
388,Marcelo Brozović,hr,MF,,Inter,it Serie A,29,1992,19.7,37,22,13,22,2,11,37,29.7,26,23,7,16,22,59,28,Matches
389,Cédric Brunner,ch,DF,,Schalke 04,Bundesliga,28,1994,25.7,39,27,26,11,2,30,45,66.7,15,24,7,17,43,82,79,Matches
390,Lewis Brunt,eng,DF,,Leicester City,Premier League,21,2000,0.3,0,0,0,0,0,0,0,,0,0,0,0,0,0,2,Matches
391,Jacob Bruun Larsen,dk,FW,,Hoffenheim,Bundesliga,23,1998,3.6,4,3,0,1,3,3,4,75.0,1,3,1,2,1,5,0,Matches
392,Andreas Bruus,dk,DF,FW,Troyes,Ligue 1,23,1999,18.1,12,6,9,3,0,8,20,40.0,12,13,2,11,17,29,24,Matches
393,Joe Bryan,eng,MF,DF,Nice,Ligue 1,28,1993,2.0,5,4,3,2,0,4,4,100.0,0,2,0,2,1,6,1,Matches
394,Lee Buchanan,eng,DF,FW,Werder Bremen,Bundesliga,21,2001,5.2,14,10,2,11,1,6,12,50.0,6,5,0,5,12,26,21,Matches
395,Ante Budimir,hr,FW,,Osasuna,La Liga,31,1991,20.0,19,9,0,12,7,2,10,20.0,8,10,0,10,5,24,19,Matches
396,Emi Buendía,ar,MF,FW,Aston Villa,Premier League,25,1996,26.8,52,23,20,20,12,21,74,28.4,53,20,2,18,20,72,17,Matches
397,Hugo Bueno,es,DF,,Wolves,Premier League,19,2002,14.6,33,16,23,6,4,17,33,51.5,16,14,1,13,10,43,36,Matches
398,Manu Bueno,es,MF,,Sevilla,La Liga,18,2004,1.7,7,4,3,3,1,5,8,62.5,3,0,0,0,0,7,2,Matches
399,Santiago Bueno,uy,DF,,Girona,La Liga,23,1998,33.4,63,38,43,19,1,24,36,66.7,12,34,22,12,31,94,105,Matches
400,Adam Buksa,pl,FW,MF,Lens,Ligue 1,26,1996,1.1,1,0,0,0,1,0,3,0.0,3,0,0,0,0,1,0,Matches
401,Marius Bülter,de,FW,MF,Schalke 04,Bundesliga,29,1993,28.9,22,11,8,7,7,12,32,37.5,20,34,1,33,10,32,20,Matches
402,Cristian Buonaiuto,it,MF,FW,Cremonese,it Serie A,29,1992,10.9,25,16,8,11,6,12,26,46.2,14,11,0,11,14,39,7,Matches
403,Facundo Buonanotte,ar,FW,MF,Brighton,Premier League,17,2004,6.3,2,1,1,1,0,1,22,4.5,21,5,2,3,4,6,3,Matches
404,Alessandro Buongiorno,it,DF,,Torino,it Serie A,23,1999,30.2,38,25,22,16,0,16,31,51.6,15,38,19,19,60,98,105,Matches
405,Delano Burgzorg,sr,FW,MF,Mainz 05,Bundesliga,23,1998,2.7,3,3,1,1,1,2,3,66.7,1,2,0,2,0,3,2,Matches
406,Jonathan Burkardt,de,MF,FW,Mainz 05,Bundesliga,22,2000,5.9,3,1,0,1,2,1,4,25.0,3,6,1,5,1,4,1,Matches
407,Oliver Burke,sct,FW,MF,Werder Bremen,Bundesliga,25,1997,3.0,1,0,0,0,1,0,0,,0,2,0,2,0,1,0,Matches
408,Dan Burn,eng,DF,,Newcastle Utd,Premier League,30,1992,34.6,60,38,29,23,8,34,67,50.7,33,42,16,26,32,92,120,Matches
409,Maxime Busi,be,DF,,Reims,Ligue 1,22,1999,11.6,21,16,9,11,1,13,29,44.8,16,14,6,8,14,35,24,Matches
410,Sergio Busquets,es,MF,,Barcelona,La Liga,34,1988,26.0,58,26,24,26,8,29,51,56.9,22,32,6,26,27,85,36,Matches
411,Aurélio Buta,pt,DF,,Eint Frankfurt,Bundesliga,25,1997,14.6,33,19,15,13,5,15,27,55.6,12,18,1,17,9,42,34,Matches
412,Leonardo Buta,pt,DF,,Udinese,it Serie A,20,2002,0.2,1,1,0,1,0,0,0,,0,0,0,0,0,1,0,Matches
413,Marcin Bułka,pl,GK,,Nice,Ligue 1,22,1999,2.0,0,0,0,0,0,0,1,0.0,1,0,0,0,1,1,0,Matches
414,Rémy Cabella,fr,MF,FW,Lille,Ligue 1,32,1990,28.1,64,37,21,28,15,29,64,45.3,35,41,5,36,17,81,7,Matches
415,Jimmy Cabot,fr,DF,MF,Lens,Ligue 1,28,1994,5.7,20,12,10,8,2,12,26,46.2,14,5,0,5,4,24,12,Matches
416,Arthur Cabral,br,FW,,Fiorentina,it Serie A,24,1998,15.9,9,2,1,4,4,4,8,50.0,4,10,1,9,1,10,12,Matches
417,Leandro Cabrera,uy,DF,,Espanyol,La Liga,31,1991,29.7,46,24,34,12,0,28,43,65.1,15,37,23,14,43,89,114,Matches
418,Liberato Cacace,nz,DF,,Empoli,it Serie A,21,2000,6.5,25,10,12,8,5,9,15,60.0,6,15,7,8,4,29,16,Matches
419,Anthony Caci,fr,DF,,Mainz 05,Bundesliga,25,1997,22.6,58,33,32,20,6,28,42,66.7,14,28,4,24,54,112,40,Matches
420,Cafú,pt,MF,,Nott'ham Forest,Premier League,29,1993,0.1,0,0,0,0,0,0,0,,0,0,0,0,0,0,1,Matches
421,Moisés Caicedo,ec,MF,,Brighton,Premier League,20,2001,34.9,100,50,41,47,12,40,68,58.8,28,43,7,36,56,156,31,Matches
422,Tom Cairney,sct,MF,,Fulham,Premier League,31,1991,11.0,17,6,4,8,5,7,10,70.0,3,18,3,15,5,22,3,Matches
423,Jens Cajuste,se,MF,,Reims,Ligue 1,22,1999,17.0,46,25,25,14,7,25,48,52.1,23,30,6,24,18,64,22,Matches
424,Cala,es,DF,,Cádiz,La Liga,32,1989,1.5,2,1,1,1,0,1,2,50.0,1,2,1,1,1,3,12,Matches
425,Davide Calabria,it,DF,,Milan,it Serie A,25,1996,18.8,71,44,31,32,8,38,61,62.3,23,22,7,15,25,96,34,Matches
426,Mattia Caldara,it,DF,,Spezia,it Serie A,28,1994,13.9,23,14,10,11,2,9,20,45.0,11,23,16,7,17,40,88,Matches
427,Luca Caldirola,it,DF,,Monza,it Serie A,31,1991,26.1,26,14,19,4,3,13,26,50.0,13,32,18,14,25,51,66,Matches
428,Fernando Calero,es,DF,MF,Espanyol,La Liga,26,1995,17.9,46,29,27,15,4,21,34,61.8,13,31,13,18,13,59,52,Matches
429,Duje Ćaleta-Car,hr,DF,,Southampton,Premier League,25,1996,10.5,14,10,9,4,1,6,9,66.7,3,15,11,4,15,29,65,Matches
430,Duje Ćaleta-Car,hr,DF,,Marseille,Ligue 1,25,1996,0.1,0,0,0,0,0,0,0,,0,0,0,0,0,0,1,Matches
431,Hakan Çalhanoğlu,tr,MF,,Inter,it Serie A,28,1994,26.3,48,27,17,26,5,16,43,37.2,27,30,5,25,25,73,13,Matches
432,Kerim Calhanoglu,de,DF,,Schalke 04,Bundesliga,19,2002,0.7,2,1,2,0,0,2,2,100.0,0,1,0,1,0,2,3,Matches
433,Daniel Caligiuri,it,DF,MF,Augsburg,Bundesliga,34,1988,3.2,8,5,5,3,0,4,5,80.0,1,3,2,1,3,11,2,Matches
434,Alexander Callens,pe,DF,,Girona,La Liga,30,1992,1.3,3,3,2,1,0,3,4,75.0,1,3,1,2,1,4,9,Matches
435,Dominic Calvert-Lewin,eng,FW,,Everton,Premier League,25,1997,12.9,4,2,1,0,3,1,5,20.0,4,5,1,4,3,7,18,Matches
436,Mahdi Camara,fr,MF,,Brest,Ligue 1,24,1998,20.2,63,36,18,38,7,25,43,58.1,18,35,4,31,40,103,16,Matches
437,Mohamed Camara,gn,MF,,Roma,it Serie A,25,1997,7.7,13,10,3,7,3,5,15,33.3,10,5,1,4,10,23,8,Matches
438,Mohamed Camara,ml,MF,,Monaco,Ligue 1,22,2000,24.4,83,45,38,39,6,48,92,52.2,44,45,6,39,27,110,14,Matches
439,Ousmane Camara,gn,FW,MF,Auxerre,Ligue 1,20,2001,0.3,1,1,0,0,1,0,0,,0,0,0,0,0,1,0,Matches
440,Ousmane Camara,fr,DF,,Angers,Ligue 1,19,2003,5.8,10,6,5,5,0,5,12,41.7,7,4,2,2,11,21,15,Matches
441,Eduardo Camavinga,fr,MF,DF,Real Madrid,La Liga,19,2002,22.3,68,48,32,21,15,24,64,37.5,40,24,5,19,17,85,25,Matches
442,Nicolò Cambiaghi,it,FW,MF,Empoli,it Serie A,21,2000,14.3,30,22,11,12,7,8,27,29.6,19,19,1,18,9,39,8,Matches
443,Andrea Cambiaso,it,DF,,Bologna,it Serie A,22,2000,24.1,57,34,34,20,3,28,65,43.1,37,26,2,24,26,83,33,Matches
444,Axel Camblan,fr,FW,MF,Brest,Ligue 1,18,2003,0.8,2,2,1,1,0,0,1,0.0,1,0,0,0,0,2,0,Matches
445,Sergio Camello,es,FW,,Rayo Vallecano,La Liga,21,2001,26.7,16,10,3,9,4,5,17,29.4,12,9,1,8,2,18,26,Matches
446,Chem Campbell,wls,FW,MF,Wolves,Premier League,19,2002,0.8,2,1,1,1,0,0,1,0.0,1,2,0,2,1,3,0,Matches
447,Emre Can,de,MF,,Dortmund,Bundesliga,28,1994,21.1,57,28,25,27,5,22,43,51.2,21,16,6,10,25,82,39,Matches
448,Sergio Canales,es,FW,MF,Betis,La Liga,31,1991,26.7,25,14,10,8,7,14,33,42.4,19,18,0,18,14,39,8,Matches
449,Matteo Cancellieri,it,FW,,Lazio,it Serie A,20,2002,2.8,10,4,5,3,2,5,9,55.6,4,4,0,4,1,11,2,Matches
450,João Cancelo,pt,DF,,Manchester City,Premier League,28,1994,14.2,29,21,16,9,4,17,24,70.8,7,7,1,6,19,48,9,Matches
451,João Cancelo,pt,DF,FW,Bayern Munich,Bundesliga,28,1994,11.2,23,14,9,10,4,10,23,43.5,13,14,2,12,15,38,22,Matches
452,Antonio Candreva,it,MF,DF,Salernitana,it Serie A,35,1987,30.3,17,7,13,2,2,11,38,28.9,27,7,3,4,17,34,32,Matches
453,Thomas Cannon,ie,FW,,Everton,Premier League,19,2002,0.3,0,0,0,0,0,0,0,,0,0,0,0,0,0,0,Matches
454,Sergi Canós,es,FW,DF,Brentford,Premier League,25,1997,0.9,0,0,0,0,0,0,2,0.0,2,3,1,2,0,0,1,Matches
455,Ander Capa,es,DF,,Athletic Club,La Liga,30,1992,1.2,1,1,1,0,0,1,5,20.0,4,5,0,5,0,1,2,Matches
456,Pierrick Capelle,fr,MF,DF,Angers,Ligue 1,35,1987,15.9,36,21,17,15,4,22,55,40.0,33,24,3,21,15,51,24,Matches
457,Étienne Capoue,fr,MF,,Villarreal,La Liga,34,1988,21.7,21,12,6,13,2,10,18,55.6,8,12,5,7,19,40,20,Matches
458,Gianluca Caprari,it,MF,FW,Monza,it Serie A,29,1993,27.1,16,6,3,11,2,8,26,30.8,18,22,1,21,8,24,3,Matches
459,Francesco Caputo,it,FW,,Sampdoria,it Serie A,34,1987,12.2,3,1,0,0,3,0,3,0.0,3,0,0,0,1,4,3,Matches
460,Francesco Caputo,it,FW,,Empoli,it Serie A,34,1987,19.0,2,2,0,1,1,0,1,0.0,1,7,2,5,2,4,8,Matches
461,Maxence Caqueret,fr,MF,,Lyon,Ligue 1,22,2000,30.7,87,54,27,38,22,43,109,39.4,66,45,3,42,39,126,27,Matches
462,Andrea Carboni,it,DF,,Monza,it Serie A,21,2001,1.9,3,2,2,0,1,2,5,40.0,3,3,2,1,3,6,2,Matches
463,Franco Carboni,it,DF,FW,Monza,it Serie A,19,2003,0.7,1,1,1,0,0,0,2,0.0,2,3,0,3,1,2,0,Matches
464,Valentin Carboni,ar,MF,DF,Inter,it Serie A,17,2005,0.3,1,1,0,1,0,1,3,33.3,2,1,0,1,0,1,0,Matches
465,Isaac Carcelen,es,DF,,Cádiz,La Liga,29,1993,24.4,69,51,41,22,6,41,63,65.1,22,35,11,24,19,88,80,Matches
466,Irvin Cardona,fr,FW,MF,Brest,Ligue 1,24,1997,2.6,2,0,1,1,0,0,3,0.0,3,3,0,3,2,4,2,Matches
467,Irvin Cardona,fr,MF,FW,Augsburg,Bundesliga,24,1997,3.5,1,1,1,0,0,1,5,20.0,4,3,0,3,4,5,8,Matches
468,Igor Carioca,br,DF,,Lorient,Ligue 1,25,1996,5.1,18,11,12,2,4,12,21,57.1,9,7,0,7,5,23,17,Matches
469,Diego Carlos,br,DF,,Aston Villa,Premier League,29,1993,2.3,1,0,0,1,0,0,1,0.0,1,2,2,0,1,2,2,Matches
470,Juan Carlos,es,GK,,Girona,La Liga,34,1988,10.0,0,0,0,0,0,0,0,,0,0,0,0,1,1,7,Matches
471,José Carlos Lazo,es,MF,FW,Almería,La Liga,26,1996,0.2,0,0,0,0,0,0,0,,0,0,0,0,0,0,0,Matches
472,José Carlos Lazo,es,MF,FW,Espanyol,La Liga,26,1996,1.8,5,3,2,2,1,3,3,100.0,0,2,0,2,3,8,5,Matches
473,Carmona,es,MF,DF,Elche,La Liga,20,2002,6.5,16,9,7,6,3,6,16,37.5,10,14,2,12,8,24,9,Matches
474,Carmona,es,DF,,Sevilla,La Liga,20,2002,5.9,13,11,5,3,5,9,16,56.3,7,10,6,4,7,20,17,Matches
475,Marco Carnesecchi,it,GK,,Cremonese,it Serie A,22,2000,27.0,1,1,1,0,0,1,2,50.0,1,0,0,0,0,1,11,Matches
476,Yannick Carrasco,be,DF,MF,Atlético Madrid,La Liga,28,1993,25.7,35,14,21,10,4,23,54,42.6,31,23,1,22,12,47,19,Matches
477,Dani Carvajal,es,DF,,Real Madrid,La Liga,30,1992,19.8,32,18,15,12,5,18,35,51.4,17,24,6,18,15,47,49,Matches
478,Fabio Carvalho,pt,MF,FW,Liverpool,Premier League,19,2002,3.9,8,8,3,3,2,3,6,50.0,3,6,0,6,6,14,0,Matches
479,Matis Carvalho,pt,GK,,Montpellier,Ligue 1,23,1999,1.5,0,0,0,0,0,0,0,,0,0,0,0,1,1,0,Matches
480,William Carvalho,pt,MF,,Betis,La Liga,30,1992,27.1,43,27,18,23,2,17,44,38.6,27,27,6,21,16,59,22,Matches
481,Nicolò Casale,it,DF,,Lazio,it Serie A,24,1998,27.1,42,20,28,14,0,22,34,64.7,12,25,17,8,17,59,73,Matches
482,Casemiro,br,MF,,Manchester Utd,Premier League,30,1992,23.6,88,46,43,35,10,47,92,51.1,45,49,11,38,34,122,64,Matches
483,Casemiro,br,MF,,Real Madrid,La Liga,30,1992,0.1,0,0,0,0,0,0,0,,0,0,0,0,0,0,1,Matches
484,Matty Cash,pl,DF,,Aston Villa,Premier League,24,1997,20.2,55,32,36,15,4,26,37,70.3,11,20,5,15,26,81,43,Matches
485,Tommaso Cassandro,it,DF,,Lecce,it Serie A,22,2000,0.1,1,1,0,1,0,0,0,,0,1,1,0,0,1,0,Matches
486,Timothy Castagne,be,DF,,Leicester City,Premier League,26,1995,36.2,87,44,53,27,7,41,84,48.8,43,50,13,37,43,130,110,Matches
487,Michele Castagnetti,it,MF,,Cremonese,it Serie A,32,1989,15.7,46,21,20,24,2,18,54,33.3,36,14,4,10,15,61,22,Matches
488,Koen Casteels,be,GK,,Wolfsburg,Bundesliga,30,1992,34.0,0,0,0,0,0,0,0,,0,0,0,0,1,1,10,Matches
489,Valentín Castellanos,ar,FW,,Girona,La Liga,23,1998,28.9,12,5,2,7,3,0,18,0.0,18,22,2,20,6,18,26,Matches
490,Jean-Charles Castelletto,cm,DF,,Nantes,Ligue 1,27,1995,28.5,43,26,29,12,2,22,36,61.1,14,35,22,13,58,101,90,Matches
491,Samu Castillejo,es,FW,MF,Valencia,La Liga,27,1995,15.1,21,12,8,9,4,8,40,20.0,32,21,2,19,9,30,2,Matches
492,Jonny Castro,es,DF,,Wolves,Premier League,28,1994,14.0,33,15,22,10,1,17,38,44.7,21,26,5,21,14,47,28,Matches
493,Gaetano Castrovilli,it,MF,,Fiorentina,it Serie A,25,1997,8.0,10,8,1,7,2,2,9,22.2,7,5,1,4,8,18,5,Matches
494,Danilo Cataldi,it,MF,,Lazio,it Serie A,27,1994,21.3,25,16,7,15,3,14,40,35.0,26,23,9,14,24,49,33,Matches
495,Catena,es,DF,,Rayo Vallecano,La Liga,27,1994,34.5,29,14,23,4,2,13,27,48.1,14,32,25,7,28,57,159,Matches
496,Yoann Cathline,fr,FW,MF,Lorient,Ligue 1,20,2002,12.1,19,12,7,6,6,5,12,41.7,7,10,1,9,8,27,16,Matches
497,Maximiliano Caufriez,be,DF,,Clermont Foot,Ligue 1,25,1997,24.7,40,24,31,8,1,20,28,71.4,8,33,18,15,34,74,70,Matches
498,Edinson Cavani,uy,FW,,Valencia,La Liga,35,1987,16.1,7,4,3,3,1,3,15,20.0,12,10,3,7,2,9,11,Matches
499,Dani Ceballos,es,MF,,Real Madrid,La Liga,25,1996,17.4,43,29,13,15,15,25,64,39.1,39,23,2,21,25,68,6,Matches
500,Pietro Ceccaroni,it,DF,,Lecce,it Serie A,26,1995,0.5,0,0,0,0,0,0,0,,0,1,1,0,3,3,2,Matches
501,Federico Ceccherini,it,DF,,Hellas Verona,it Serie A,30,1992,15.7,25,19,15,9,1,13,23,56.5,10,17,10,7,19,44,55,Matches
502,Assan Ceesay,gm,FW,,Lecce,it Serie A,28,1994,20.1,23,18,7,8,8,9,17,52.9,8,15,2,13,3,26,24,Matches
503,Emil Ceide,no,FW,,Sassuolo,it Serie A,20,2001,5.7,5,2,5,0,0,3,5,60.0,2,3,1,2,1,6,0,Matches
504,Zeki Çelik,tr,DF,,Roma,it Serie A,25,1997,16.7,42,21,19,21,2,24,41,58.5,17,33,6,27,14,56,36,Matches
505,Álex Centelles,es,DF,,Almería,La Liga,24,1997,12.5,22,14,16,3,3,16,22,72.7,6,13,2,11,11,33,40,Matches
506,Fabien Centonze,fr,DF,,Nantes,Ligue 1,26,1996,18.8,58,37,30,22,6,30,42,71.4,12,24,7,17,44,102,55,Matches
507,Michele Cerofolini,it,GK,,Fiorentina,it Serie A,23,1999,5.0,0,0,0,0,0,0,0,,0,0,0,0,1,1,2,Matches
508,Franco Cervi,ar,MF,DF,Celta Vigo,La Liga,28,1994,21.0,76,46,29,36,11,33,66,50.0,33,33,1,32,36,112,16,Matches
509,Julian Chabot,de,DF,,Köln,Bundesliga,24,1998,20.0,36,23,19,14,3,20,35,57.1,15,30,18,12,41,77,105,Matches
510,Florian Chabrolle,fr,MF,,Ajaccio,Ligue 1,24,1998,3.7,6,4,1,5,0,2,4,50.0,2,3,0,3,7,13,2,Matches
511,El Chadaille Bitshiabu,fr,DF,,Paris S-G,Ligue 1,17,2005,6.5,10,7,7,2,1,3,12,25.0,9,9,7,2,9,19,13,Matches
512,Fares Chaïbi,dz,FW,MF,Toulouse,Ligue 1,19,2002,26.0,31,18,8,15,8,17,50,34.0,33,38,5,33,19,50,36,Matches
513,Nathaniel Chalobah,eng,MF,,Fulham,Premier League,27,1994,0.1,1,1,1,0,0,1,1,100.0,0,0,0,0,0,1,2,Matches
514,Trevoh Chalobah,eng,DF,,Chelsea,Premier League,23,1999,17.9,31,20,22,6,3,24,35,68.6,11,17,7,10,24,55,56,Matches
515,Muhammed Cham,at,MF,,Clermont Foot,Ligue 1,21,2000,21.9,30,15,15,4,11,13,35,37.1,22,13,0,13,7,37,5,Matches
516,Calum Chambers,eng,DF,MF,Aston Villa,Premier League,27,1995,3.9,9,6,7,2,0,6,8,75.0,2,5,4,1,7,16,10,Matches
517,Timothy Chandler,us,DF,,Eint Frankfurt,Bundesliga,32,1990,1.0,2,2,2,0,0,2,2,100.0,0,1,0,1,0,2,3,Matches
518,Gaëtan Charbonnier,fr,FW,MF,Auxerre,Ligue 1,33,1988,2.8,2,1,0,2,0,0,4,0.0,4,2,0,2,0,2,5,Matches
519,Brendan Chardonnet,fr,DF,,Brest,Ligue 1,27,1994,27.7,45,27,27,18,0,20,38,52.6,18,40,19,21,63,108,86,Matches
520,Shea Charles,nir,DF,,Manchester City,Premier League,18,2003,0.3,4,0,4,0,0,1,1,100.0,0,0,0,0,1,5,2,Matches
521,Xavier Chavalerin,fr,MF,,Troyes,Ligue 1,31,1991,27.0,82,50,39,30,13,27,71,38.0,44,31,8,23,41,123,24,Matches
522,Pep Chavarría,es,FW,MF,Rayo Vallecano,La Liga,24,1998,4.1,6,4,2,1,3,1,5,20.0,4,8,0,8,2,8,8,Matches
523,Ivane Chegra,fr,MF,FW,Ajaccio,Ligue 1,18,2004,2.1,8,3,6,1,1,4,11,36.4,7,0,0,0,1,9,0,Matches
524,Pape Cheikh Diop,sn,MF,,Elche,La Liga,24,1997,0.4,0,0,0,0,0,0,1,0.0,1,0,0,0,0,0,0,Matches
525,Rayan Cherki,fr,MF,FW,Lyon,Ligue 1,18,2003,20.8,14,8,2,5,7,8,23,34.8,15,6,0,6,5,19,1,Matches
526,Ilyes Cheti,dz,DF,,Angers,Ligue 1,27,1995,2.3,6,4,4,0,2,5,8,62.5,3,5,1,4,4,10,7,Matches
527,Lucas Chevalier,fr,GK,,Lille,Ligue 1,20,2001,32.0,2,1,2,0,0,2,2,100.0,0,1,0,1,2,4,7,Matches
528,Fabio Chiarodia,it,DF,,Werder Bremen,Bundesliga,17,2005,0.7,0,0,0,0,0,0,0,,0,1,0,1,2,2,4,Matches
529,Federico Chiesa,it,DF,MF,Juventus,it Serie A,24,1997,9.5,22,11,6,6,10,5,14,35.7,9,13,1,12,0,22,1,Matches
530,Ben Chilwell,eng,DF,MF,Chelsea,Premier League,25,1996,15.6,21,17,12,8,1,13,25,52.0,12,21,2,19,18,39,26,Matches
531,Vlad Chiricheș,ro,DF,,Cremonese,it Serie A,32,1989,10.9,35,20,27,7,1,16,24,66.7,8,36,23,13,22,57,44,Matches
532,Pedro Chirivella,es,MF,,Nantes,Ligue 1,25,1997,22.5,33,22,12,15,6,17,44,38.6,27,24,1,23,20,53,7,Matches
533,Joris Chotard,fr,MF,,Montpellier,Ligue 1,20,2001,27.3,64,34,37,23,4,40,78,51.3,38,40,11,29,40,104,42,Matches
534,Andreas Christensen,dk,DF,,Barcelona,La Liga,26,1996,19.6,20,15,9,11,0,10,16,62.5,6,14,12,2,21,41,47,Matches
535,Oliver Christensen,dk,GK,,Hertha BSC,Bundesliga,23,1999,33.0,1,0,1,0,0,0,2,0.0,2,0,0,0,0,1,22,Matches
536,Ryan Christie,sct,MF,FW,Bournemouth,Premier League,27,1995,20.4,34,22,10,23,1,14,50,28.0,36,16,4,12,26,60,20,Matches
537,Carney Chukwuemeka,eng,MF,FW,Chelsea,Premier League,18,2003,3.9,13,7,7,6,0,3,5,60.0,2,7,0,7,6,19,1,Matches
538,Samuel Chukwueze,ng,FW,MF,Villarreal,La Liga,23,1999,26.0,14,7,7,2,5,7,23,30.4,16,13,0,13,12,26,16,Matches
539,Chumi,es,DF,,Almería,La Liga,23,1999,16.5,29,16,18,9,2,14,23,60.9,9,20,7,13,15,44,53,Matches
540,Darko Churlinov,mk,FW,,Stuttgart,Bundesliga,22,2000,0.3,3,2,2,1,0,2,3,66.7,1,1,0,1,0,3,0,Matches
541,Víctor Chust,es,DF,,Cádiz,La Liga,22,2000,10.7,9,6,7,2,0,4,7,57.1,3,8,3,5,10,19,53,Matches
542,Tolga Ciğerci,tr,MF,,Hertha BSC,Bundesliga,30,1992,7.5,16,13,6,9,1,10,16,62.5,6,6,2,4,8,24,5,Matches
543,Yanis Cimignani,fr,MF,DF,Ajaccio,Ligue 1,20,2002,3.1,11,5,3,7,1,4,5,80.0,1,5,1,4,2,13,2,Matches
544,Daniel Ciofani,it,FW,,Cremonese,it Serie A,37,1985,11.8,6,3,1,2,3,4,7,57.1,3,7,1,6,2,8,10,Matches
545,Tio Cipot,si,FW,MF,Spezia,it Serie A,19,2003,1.5,12,7,6,3,3,6,8,75.0,2,0,0,0,0,12,2,Matches
546,Pathé Ciss,sn,MF,DF,Rayo Vallecano,La Liga,28,1994,14.2,39,29,11,23,5,15,34,44.1,19,23,10,13,22,61,34,Matches
547,Souleymane Cissé,fr,DF,,Clermont Foot,Ligue 1,19,2002,0.4,1,1,1,0,0,1,1,100.0,0,1,1,0,1,2,2,Matches
548,Patrick Ciurria,it,DF,MF,Monza,it Serie A,27,1995,30.6,31,18,20,10,1,17,33,51.5,16,24,2,22,7,38,32,Matches
549,Bobby Clark,eng,MF,,Liverpool,Premier League,17,2005,0.1,0,0,0,0,0,0,0,,0,2,0,2,0,0,0,Matches
550,Alexis Claude-Maurice,fr,FW,,Nice,Ligue 1,24,1998,0.7,3,2,2,1,0,3,3,100.0,0,0,0,0,2,5,1,Matches
551,Alexis Claude-Maurice,fr,MF,FW,Lens,Ligue 1,24,1998,6.7,14,9,5,8,1,6,16,37.5,10,6,0,6,2,16,1,Matches
552,Jonathan Clauss,fr,DF,,Marseille,Ligue 1,29,1992,28.8,46,28,21,16,9,23,52,44.2,29,29,4,25,31,77,40,Matches
553,Carlos Clerc,es,DF,MF,Elche,La Liga,30,1992,29.3,75,51,55,16,4,31,50,62.0,19,29,7,22,28,103,94,Matches
554,Nathaniel Clyne,eng,DF,,Crystal Palace,Premier League,31,1991,18.2,27,16,13,9,5,14,23,60.9,9,22,4,18,19,46,34,Matches
555,Conor Coady,eng,DF,,Everton,Premier League,29,1993,23.3,14,9,8,6,0,7,15,46.7,8,21,17,4,14,28,88,Matches
556,Nicolò Cocetta,it,DF,,Udinese,it Serie A,18,2003,0.4,0,0,0,0,0,0,1,0.0,1,1,1,0,1,1,1,Matches
557,Marcus Coco,fr,FW,MF,Nantes,Ligue 1,26,1996,7.1,24,15,11,9,4,11,23,47.8,12,13,3,10,14,38,7,Matches
558,Alexandre Coeff,fr,DF,,Auxerre,Ligue 1,30,1992,6.5,10,5,6,4,0,4,9,44.4,5,9,4,5,8,18,35,Matches
559,Jack Colback,eng,MF,,Nott'ham Forest,Premier League,32,1989,5.5,18,13,12,6,0,5,8,62.5,3,3,0,3,3,21,9,Matches
560,Séamus Coleman,ie,DF,,Everton,Premier League,33,1988,18.4,35,26,21,10,4,19,29,65.5,10,14,7,7,22,57,58,Matches
561,David Čolina,hr,DF,FW,Augsburg,Bundesliga,22,2000,1.8,4,1,1,1,2,2,2,100.0,0,8,0,8,4,8,3,Matches
562,Álex Collado,es,MF,,Elche,La Liga,23,1999,8.0,26,14,13,11,2,8,13,61.5,5,12,1,11,2,28,4,Matches
563,Diego Collado,es,FW,,Villarreal,La Liga,21,2001,0.1,0,0,0,0,0,0,0,,0,0,0,0,0,0,0,Matches
564,Omar Colley,gm,DF,,Sampdoria,it Serie A,29,1992,15.4,17,10,10,7,0,9,12,75.0,3,9,5,4,22,39,69,Matches
565,Nathan Collins,ie,DF,,Wolves,Premier League,21,2001,20.2,27,15,19,8,0,15,24,62.5,9,35,28,7,21,48,84,Matches
566,Lorenzo Colombo,it,FW,,Lecce,it Serie A,20,2002,16.8,17,9,1,9,7,6,14,42.9,8,22,0,22,2,19,7,Matches
567,Andrea Colpani,it,MF,,Monza,it Serie A,23,1999,10.5,14,9,6,5,3,8,12,66.7,4,14,2,12,3,17,6,Matches
568,Levi Colwill,eng,DF,,Brighton,Premier League,19,2003,13.6,8,7,4,4,0,4,9,44.4,5,5,3,2,15,23,37,Matches
569,Kingsley Coman,fr,FW,MF,Bayern Munich,Bundesliga,26,1996,15.7,11,8,3,5,3,7,17,41.2,10,19,1,18,2,13,7,Matches
570,Eray Cömert,ch,DF,,Valencia,La Liga,24,1998,18.6,35,23,24,10,1,17,33,51.5,16,23,8,15,29,64,76,Matches
571,Santi Comesaña,es,MF,,Rayo Vallecano,La Liga,25,1996,27.2,71,44,24,41,6,38,82,46.3,44,39,3,36,32,103,17,Matches
572,Andrea Consigli,it,GK,,Sassuolo,it Serie A,35,1987,35.0,1,0,1,0,0,0,1,0.0,1,0,0,0,0,1,13,Matches
573,Abdu Conté,pt,DF,,Troyes,Ligue 1,24,1998,14.6,25,17,14,8,3,12,22,54.5,10,13,6,7,6,31,25,Matches
574,Andrea Conti,it,DF,,Sampdoria,it Serie A,28,1994,0.3,0,0,0,0,0,0,0,,0,0,0,0,0,0,0,Matches
575,Lewis Cook,eng,MF,,Bournemouth,Premier League,25,1997,19.1,37,22,10,22,5,18,44,40.9,26,29,10,19,23,60,31,Matches
576,Steve Cook,eng,DF,,Nott'ham Forest,Premier League,31,1991,10.6,8,4,4,4,0,5,7,71.4,2,16,11,5,12,20,51,Matches
577,Liam Cooper,sct,DF,,Leeds United,Premier League,30,1991,15.8,38,23,27,9,2,23,36,63.9,13,16,8,8,34,72,57,Matches
578,Copete,es,DF,,Mallorca,La Liga,22,1999,24.5,53,28,35,16,2,26,36,72.2,10,38,17,21,44,97,111,Matches
579,Diego Coppola,it,DF,,Hellas Verona,it Serie A,18,2003,13.1,25,17,15,10,0,11,24,45.8,13,20,6,14,14,39,38,Matches
580,Francis Coquelin,fr,MF,,Villarreal,La Liga,31,1991,8.3,18,13,7,9,2,7,7,100.0,0,8,2,6,9,27,7,Matches
581,Sébastien Corchia,fr,DF,,Nantes,Ligue 1,31,1990,8.7,16,6,10,2,4,11,22,50.0,11,9,3,6,14,30,21,Matches
582,Alex Cordaz,it,GK,,Inter,it Serie A,39,1983,0.3,0,0,0,0,0,0,0,,0,0,0,0,0,0,0,Matches
583,Maxwel Cornet,ci,FW,,West Ham,Premier League,25,1996,2.7,7,3,5,0,2,4,6,66.7,2,6,0,6,2,9,3,Matches
584,Jesús Corona,mx,FW,,Sevilla,La Liga,29,1993,1.2,1,0,1,0,0,0,1,0.0,1,0,0,0,1,2,1,Matches
585,Ángel Correa,ar,FW,MF,Atlético Madrid,La Liga,27,1995,16.2,12,6,6,3,3,5,16,31.3,11,17,0,17,10,22,6,Matches
586,Joaquín Correa,ar,FW,,Inter,it Serie A,27,1994,10.6,12,7,3,6,3,4,15,26.7,11,4,1,3,3,15,0,Matches
587,Thierry Correia,pt,DF,,Valencia,La Liga,23,1999,22.3,71,52,46,22,3,31,54,57.4,23,25,2,23,24,95,54,Matches
588,Alessandro Cortinovis,it,MF,,Hellas Verona,it Serie A,21,2001,0.1,1,0,1,0,0,0,0,,0,1,0,1,0,1,0,Matches
589,Danny da Costa,de,DF,,Mainz 05,Bundesliga,29,1993,13.7,20,16,7,8,5,12,20,60.0,8,22,3,19,9,29,26,Matches
590,David Costa,pt,MF,FW,Lens,Ligue 1,21,2001,15.6,13,7,1,10,2,7,19,36.8,12,19,1,18,11,24,6,Matches
591,Diego Costa,es,FW,,Wolves,Premier League,33,1988,13.8,3,1,3,0,0,2,9,22.2,7,6,1,5,2,5,17,Matches
592,Jaume Costa,es,DF,,Mallorca,La Liga,34,1988,28.9,50,34,26,17,7,29,51,56.9,22,13,5,8,22,72,44,Matches
593,Logan Costa,cv,DF,,Toulouse,Ligue 1,21,2001,4.6,9,4,7,1,1,6,9,66.7,3,6,3,3,4,13,12,Matches
594,Nuno da Costa,cv,FW,MF,Auxerre,Ligue 1,31,1991,22.3,45,23,14,23,8,11,46,23.9,35,21,1,20,20,65,15,Matches
595,Samu Costa,pt,MF,,Almería,La Liga,21,2000,22.1,61,31,35,20,6,29,61,47.5,32,29,7,22,37,98,64,Matches
596,Benoît Costil,fr,GK,,Auxerre,Ligue 1,35,1987,19.0,2,0,2,0,0,2,4,50.0,2,0,0,0,0,2,5,Matches
597,Vladimír Coufal,cz,DF,,West Ham,Premier League,29,1992,23.7,58,31,37,15,6,36,51,70.6,15,24,6,18,38,96,70,Matches
598,Lassana Coulibaly,ml,MF,,Salernitana,it Serie A,26,1996,32.1,84,50,42,35,7,30,73,41.1,43,35,7,28,25,109,33,Matches
599,Soumaïla Coulibaly,fr,DF,,Dortmund,Bundesliga,18,2003,0.5,0,0,0,0,0,0,0,,0,0,0,0,0,0,0,Matches
600,Tanguy Coulibaly,fr,FW,DF,Stuttgart,Bundesliga,21,2001,3.6,12,9,9,1,2,5,12,41.7,7,10,0,10,3,15,0,Matches
601,Thibaut Courtois,be,GK,,Real Madrid,La Liga,30,1992,31.0,1,0,1,0,0,1,1,100.0,0,0,0,0,3,4,7,Matches
602,Mathieu Coutadeur,fr,MF,,Ajaccio,Ligue 1,36,1986,21.6,23,13,13,10,0,8,28,28.6,20,19,3,16,19,42,21,Matches
603,Philippe Coutinho,br,MF,FW,Aston Villa,Premier League,30,1992,8.8,19,14,8,8,3,9,15,60.0,6,11,1,10,4,23,2,Matches
604,Yan Couto,br,DF,MF,Girona,La Liga,20,2002,12.9,25,18,11,11,3,12,20,60.0,8,7,2,5,5,30,10,Matches
605,Conor Coventry,ie,MF,FW,West Ham,Premier League,22,2000,0.0,0,0,0,0,0,0,0,,0,0,0,0,0,0,0,Matches
606,Nicolas Cozza,fr,DF,,Montpellier,Ligue 1,23,1999,14.2,38,21,27,9,2,26,38,68.4,12,11,5,6,21,59,35,Matches
607,Nicolas Cozza,fr,DF,,Wolfsburg,Bundesliga,23,1999,1.1,3,3,1,2,0,2,3,66.7,1,3,1,2,0,3,0,Matches
608,Alessio Cragno,it,GK,,Monza,it Serie A,28,1994,1.0,0,0,0,0,0,0,1,0.0,1,0,0,0,0,0,0,Matches
609,Matthew Craig,sct,MF,,Tottenham,Premier League,19,2003,0.2,4,1,2,2,0,0,0,,0,0,0,0,0,4,0,Matches
610,Aaron Cresswell,eng,DF,,West Ham,Premier League,32,1989,24.8,21,11,12,7,2,12,31,38.7,19,21,11,10,27,48,56,Matches
611,Bryan Cristante,it,MF,DF,Roma,it Serie A,27,1995,32.6,113,62,55,49,9,55,90,61.1,35,39,10,29,18,131,53,Matches
612,Domen Črnigoj,si,MF,,Salernitana,it Serie A,26,1995,3.3,8,3,0,7,1,1,2,50.0,1,9,1,8,9,17,6,Matches
613,Juan Cruz Armada,es,DF,,Osasuna,La Liga,30,1992,22.9,24,14,17,4,3,13,23,56.5,10,21,8,13,13,37,58,Matches
614,Juan Cruz,es,FW,,Betis,La Liga,22,2000,2.0,1,0,0,1,0,1,3,33.3,2,1,0,1,0,1,0,Matches
615,Juan Cuadrado,co,DF,FW,Juventus,it Serie A,34,1988,23.1,50,34,34,13,3,27,65,41.5,38,15,2,13,24,74,32,Matches
616,Marc Cucurella,es,DF,,Chelsea,Premier League,24,1998,18.6,66,33,40,15,11,30,60,50.0,30,28,8,20,16,82,48,Matches
617,Jorge Cuenca,es,DF,,Villarreal,La Liga,22,1999,5.6,9,7,7,2,0,4,7,57.1,3,10,8,2,6,15,44,Matches
618,Braian Cufré,ar,DF,,Mallorca,La Liga,25,1996,2.4,5,2,2,1,2,2,5,40.0,3,2,1,1,2,7,1,Matches
619,Mickaël Cuisance,fr,MF,,Sampdoria,it Serie A,22,1999,6.9,13,10,7,5,1,5,23,21.7,18,10,0,10,5,18,4,Matches
620,Matheus Cunha,br,FW,,Wolves,Premier League,23,1999,10.7,7,4,0,5,2,2,10,20.0,8,15,3,12,9,16,11,Matches
621,Matheus Cunha,br,FW,MF,Atlético Madrid,La Liga,23,1999,4.2,4,1,1,3,0,0,3,0.0,3,4,1,3,2,6,3,Matches
622,Curro,es,MF,,Almería,La Liga,26,1996,0.5,2,0,1,1,0,1,2,50.0,1,0,0,0,0,2,0,Matches
623,Marco D'Alessandro,it,DF,FW,Monza,it Serie A,31,1991,3.2,4,4,3,1,0,2,5,40.0,3,2,0,2,1,5,3,Matches
624,Danilo D'Ambrosio,it,DF,,Inter,it Serie A,33,1988,8.1,25,17,17,7,1,15,27,55.6,12,12,4,8,10,35,17,Matches
625,Luca D'Andrea,it,FW,,Sassuolo,it Serie A,17,2004,3.5,4,0,2,1,1,1,4,25.0,3,2,0,2,1,5,1,Matches
626,Damien Da Silva,fr,DF,,Lyon,Ligue 1,34,1988,3.8,8,7,5,3,0,3,3,100.0,0,4,3,1,5,13,12,Matches
627,Moanes Dabbur,il,FW,,Hoffenheim,Bundesliga,30,1992,10.4,11,8,4,5,2,3,9,33.3,6,8,0,8,5,16,0,Matches
628,Andréa Dacourt,fr,MF,,Nice,Ligue 1,17,2005,0.0,0,0,0,0,0,0,0,,0,0,0,0,0,0,0,Matches
629,Colin Dagba,fr,DF,MF,Strasbourg,Ligue 1,23,1998,10.6,32,20,17,10,5,19,26,73.1,7,18,2,16,17,49,19,Matches
630,Finn Dahmen,de,GK,,Mainz 05,Bundesliga,24,1998,8.0,0,0,0,0,0,0,0,,0,0,0,0,0,0,3,Matches
631,Mahmoud Dahoud,de,MF,,Dortmund,Bundesliga,26,1996,3.7,11,9,3,4,4,7,7,100.0,0,6,2,4,7,18,3,Matches
632,Patson Daka,zm,FW,,Leicester City,Premier League,23,1998,13.2,14,8,6,8,0,3,13,23.1,10,14,2,12,7,21,7,Matches
633,Thijs Dallinga,nl,FW,,Toulouse,Ligue 1,21,2000,26.1,8,6,2,2,4,1,13,7.7,12,17,3,14,3,11,20,Matches
634,Diogo Dalot,pt,DF,,Manchester Utd,Premier League,23,1999,23.9,54,41,40,13,1,33,45,73.3,12,25,7,18,37,91,55,Matches
635,Muhammed Damar,de,MF,,Hoffenheim,Bundesliga,18,2004,1.8,6,3,1,2,3,1,2,50.0,1,3,0,3,0,6,0,Matches
636,Mikkel Damsgaard,dk,MF,FW,Brentford,Premier League,22,2000,11.0,31,21,13,13,5,15,42,35.7,27,20,2,18,10,41,14,Matches
637,Flavius Daniliuc,at,DF,,Salernitana,it Serie A,21,2001,24.4,57,29,37,17,3,26,47,55.3,21,30,13,17,29,86,76,Matches
638,Flavius Daniliuc,at,DF,,Nice,Ligue 1,21,2001,1.0,2,0,2,0,0,1,1,100.0,0,4,1,3,0,2,1,Matches
639,Danilo,br,MF,,Nott'ham Forest,Premier League,21,2001,10.8,18,7,7,9,2,6,25,24.0,19,26,6,20,9,27,19,Matches
640,Danilo,br,DF,,Juventus,it Serie A,31,1991,35.4,92,62,61,23,8,52,73,71.2,21,39,20,19,47,139,114,Matches
641,Arnaut Danjuma,nl,FW,MF,Tottenham,Premier League,25,1997,1.9,2,0,1,1,0,0,0,,0,1,0,1,0,2,0,Matches
642,Arnaut Danjuma,nl,FW,,Villarreal,La Liga,25,1997,5.3,3,3,1,0,2,1,2,50.0,1,0,0,0,0,3,1,Matches
643,Kévin Danois,fr,MF,,Auxerre,Ligue 1,18,2004,0.0,1,1,0,1,0,0,0,,0,0,0,0,1,2,0,Matches
644,Kevin Danso,at,DF,,Lens,Ligue 1,23,1998,35.9,37,19,25,11,1,19,30,63.3,11,48,34,14,33,70,124,Matches
645,Dante,br,DF,,Nice,Ligue 1,38,1983,36.7,70,40,45,21,4,36,59,61.0,23,52,31,21,47,117,125,Matches
646,Márton Dárdai,hu,DF,MF,Hertha BSC,Bundesliga,20,2002,10.5,17,8,9,8,0,9,18,50.0,9,14,9,5,11,28,45,Matches
647,Sergi Darder,es,MF,,Espanyol,La Liga,28,1993,36.9,69,38,12,43,14,29,73,39.7,44,34,2,32,24,93,23,Matches
648,Achraf Dari,ma,DF,,Brest,Ligue 1,23,1999,14.6,21,14,15,5,1,14,20,70.0,6,16,10,6,19,40,65,Matches
649,Vladimír Darida,cz,MF,,Hertha BSC,Bundesliga,31,1990,0.3,1,1,0,1,0,0,0,,0,1,0,1,0,1,0,Matches
650,Matteo Darmian,it,DF,,Inter,it Serie A,32,1989,22.5,56,30,29,15,12,31,47,66.0,16,33,5,28,21,77,36,Matches
651,Josh Dasilva,eng,MF,,Brentford,Premier League,23,1998,15.4,18,9,6,6,6,6,15,40.0,9,22,6,16,5,23,7,Matches
652,David Datro Fofana,ci,FW,,Chelsea,Premier League,19,2002,0.8,3,1,1,1,1,1,1,100.0,0,1,0,1,0,3,0,Matches
653,Juan David Cabal,co,DF,,Hellas Verona,it Serie A,21,2001,4.9,10,6,7,3,0,7,12,58.3,5,8,5,3,13,23,12,Matches
654,Jonathan David,ca,FW,,Lille,Ligue 1,22,2000,35.2,24,17,6,11,7,10,27,37.0,17,20,2,18,8,32,13,Matches
655,Alphonso Davies,ca,DF,,Bayern Munich,Bundesliga,21,2000,22.7,45,28,25,13,7,18,39,46.2,21,28,4,24,24,69,24,Matches
656,Ben Davies,wls,DF,,Tottenham,Premier League,29,1993,25.4,28,11,13,13,2,14,26,53.8,12,17,8,9,18,46,72,Matches
657,Tom Davies,eng,MF,,Everton,Premier League,24,1998,6.0,15,9,5,9,1,7,14,50.0,7,10,1,9,4,19,7,Matches
658,Paweł Dawidowicz,pl,DF,,Hellas Verona,it Serie A,27,1995,18.1,48,31,28,17,3,22,31,71.0,9,14,9,5,23,71,71,Matches
659,Craig Dawson,eng,DF,,West Ham,Premier League,32,1990,8.0,11,7,9,2,0,5,7,71.4,2,9,6,3,6,17,26,Matches
660,Craig Dawson,eng,DF,,Wolves,Premier League,32,1990,15.7,9,6,6,3,0,4,7,57.1,3,31,23,8,12,21,74,Matches
661,Kevin De Bruyne,be,MF,,Manchester City,Premier League,31,1991,26.9,28,12,3,12,13,14,39,35.9,25,27,2,25,9,37,10,Matches
662,Charles De Ketelaere,be,MF,FW,Milan,it Serie A,21,2001,12.4,26,12,7,14,5,13,30,43.3,17,14,2,12,4,30,9,Matches
663,Manuel De Luca,it,FW,MF,Sampdoria,it Serie A,24,1998,0.5,0,0,0,0,0,0,0,,0,0,0,0,0,0,0,Matches
664,Tommaso De Nipoti,it,MF,,Atalanta,it Serie A,19,2003,0.0,1,0,0,1,0,0,0,,0,0,0,0,0,1,0,Matches
665,Rodrigo De Paul,ar,MF,,Atlético Madrid,La Liga,28,1994,21.4,35,21,11,18,6,18,35,51.4,17,20,3,17,8,43,7,Matches
666,Mattia De Sciglio,it,DF,,Juventus,it Serie A,29,1992,11.6,14,7,8,3,3,9,14,64.3,5,9,3,6,4,18,20,Matches
667,Lorenzo De Silvestri,it,DF,,Bologna,it Serie A,34,1988,7.5,3,2,2,0,1,3,7,42.9,4,6,5,1,3,6,20,Matches
668,Thibault De Smet,be,DF,,Reims,Ligue 1,24,1998,19.5,24,17,10,14,0,11,37,29.7,26,28,5,23,20,44,40,Matches
669,Koni De Winter,be,DF,,Empoli,it Serie A,20,2002,11.4,14,9,11,3,0,5,13,38.5,8,14,12,2,6,20,65,Matches
670,Grégoire Defrel,mq,FW,,Sassuolo,it Serie A,31,1991,13.0,9,7,5,2,2,4,13,30.8,9,11,0,11,2,11,5,Matches
671,Duccio Degl'Innocenti,it,MF,,Empoli,it Serie A,19,2003,0.0,0,0,0,0,0,0,0,,0,0,0,0,1,1,0,Matches
672,Brecht Dejaegere,be,MF,,Toulouse,Ligue 1,31,1991,20.1,40,23,10,20,10,15,51,29.4,36,25,5,20,14,54,11,Matches
673,Romain Del Castillo,fr,MF,FW,Brest,Ligue 1,26,1996,15.8,39,24,13,17,9,16,36,44.4,20,14,1,13,11,50,5,Matches
674,Alberto Del Moral,es,MF,,Villarreal,La Liga,22,2000,0.1,0,0,0,0,0,0,0,,0,0,0,0,0,0,0,Matches
675,Thomas Delaine,fr,DF,MF,Strasbourg,Ligue 1,30,1992,11.9,28,14,16,6,6,13,26,50.0,13,8,3,5,16,44,9,Matches
676,Thomas Delaney,dk,MF,,Sevilla,La Liga,30,1991,3.4,4,2,0,4,0,3,5,60.0,2,3,2,1,4,8,3,Matches
677,Thomas Delaney,dk,MF,,Hoffenheim,Bundesliga,30,1991,3.3,6,3,3,2,1,3,8,37.5,5,5,0,5,1,7,4,Matches
678,Sacha Delaye,fr,FW,MF,Montpellier,Ligue 1,20,2002,0.2,1,0,0,0,1,1,1,100.0,0,0,0,0,0,1,0,Matches
679,Fran Delgado,es,DF,,Betis,La Liga,21,2001,0.1,0,0,0,0,0,0,0,,0,0,0,0,0,0,0,Matches
680,Andy Delort,dz,FW,,Nice,Ligue 1,30,1991,8.7,2,0,1,1,0,1,2,50.0,1,0,0,0,1,3,7,Matches
681,Andy Delort,dz,FW,,Nantes,Ligue 1,30,1991,5.2,5,4,1,2,2,2,6,33.3,4,3,0,3,0,5,2,Matches
682,Karamoko Dembélé,eng,FW,MF,Brest,Ligue 1,19,2003,2.0,2,0,1,1,0,2,2,100.0,0,1,0,1,1,3,0,Matches
683,Moussa Dembélé,fr,FW,MF,Lyon,Ligue 1,26,1996,9.7,8,4,3,3,2,4,7,57.1,3,5,0,5,2,10,6,Matches
684,Ousmane Dembélé,fr,FW,,Barcelona,La Liga,25,1997,15.7,19,12,4,8,7,4,15,26.7,11,10,1,9,0,19,2,Matches
685,Siriki Dembélé,ci,FW,MF,Bournemouth,Premier League,25,1996,1.2,3,1,2,1,0,0,1,0.0,1,1,0,1,1,4,1,Matches
686,Siriki Dembélé,ci,MF,FW,Auxerre,Ligue 1,25,1996,4.1,10,6,4,3,3,4,12,33.3,8,2,0,2,1,11,2,Matches
687,Merih Demiral,tr,DF,,Atalanta,it Serie A,24,1998,17.1,41,29,30,11,0,26,36,72.2,10,24,7,17,24,65,57,Matches
688,Kerem Demirbay,de,MF,,Leverkusen,Bundesliga,29,1993,17.2,36,18,16,17,3,18,34,52.9,16,26,6,20,16,52,11,Matches
689,Ermedin Demirović,ba,FW,MF,Augsburg,Bundesliga,24,1998,26.3,31,14,9,12,10,9,22,40.9,13,31,4,27,14,45,37,Matches
690,Diego Demme,de,MF,,Napoli,it Serie A,30,1991,1.6,1,0,1,0,0,0,4,0.0,4,2,0,2,0,1,1,Matches
691,Sepp van den Berg,nl,DF,,Schalke 04,Bundesliga,20,2001,7.7,5,4,2,2,1,1,4,25.0,3,8,5,3,13,18,33,Matches
692,Branco van den Boomen,nl,MF,,Toulouse,Ligue 1,27,1995,32.1,71,36,26,32,13,36,89,40.4,53,27,4,23,10,81,27,Matches
693,Leander Dendoncker,be,MF,,Aston Villa,Premier League,27,1995,7.7,19,9,11,6,2,11,22,50.0,11,19,4,15,10,29,12,Matches
694,Leander Dendoncker,be,MF,,Wolves,Premier League,27,1995,2.4,4,2,0,3,1,2,3,66.7,1,2,0,2,9,13,4,Matches
695,Emmanuel Dennis,ng,FW,MF,Nott'ham Forest,Premier League,24,1997,8.0,17,11,5,5,7,8,18,44.4,10,13,1,12,2,19,6,Matches
696,Fabio Depaoli,it,DF,,Hellas Verona,it Serie A,25,1997,24.1,48,28,25,16,7,25,44,56.8,19,32,6,26,18,66,33,Matches
697,Fabio Depaoli,it,DF,MF,Sampdoria,it Serie A,25,1997,1.5,5,3,2,3,0,3,4,75.0,1,1,0,1,1,6,4,Matches
698,Kastriot Dermaku,al,DF,,Lecce,it Serie A,30,1992,0.4,0,0,0,0,0,0,0,,0,0,0,0,0,0,0,Matches
699,Halil Dervişoğlu,tr,MF,,Brentford,Premier League,22,1999,0.1,0,0,0,0,0,0,1,0.0,1,0,0,0,0,0,0,Matches
700,Rémy Descamps,fr,GK,,Nantes,Ligue 1,26,1996,1.0,0,0,0,0,0,0,0,,0,0,0,0,0,0,0,Matches
701,Mikkel Desler,dk,DF,,Toulouse,Ligue 1,27,1995,25.1,71,38,36,27,8,43,67,64.2,24,35,6,29,36,107,48,Matches
702,Cyriel Dessers,ng,FW,,Cremonese,it Serie A,27,1994,17.6,11,4,4,4,3,2,6,33.3,4,14,2,12,3,14,5,Matches
703,Sergiño Dest,us,DF,,Milan,it Serie A,21,2000,3.7,12,6,3,5,4,3,4,75.0,1,1,0,1,4,16,2,Matches
704,Mattia Destro,it,FW,MF,Empoli,it Serie A,31,1991,6.4,1,1,0,1,0,0,0,,0,2,0,2,1,2,5,Matches
705,Gerard Deulofeu,es,FW,,Udinese,it Serie A,28,1994,13.5,8,5,5,1,2,5,15,33.3,10,8,1,7,2,10,1,Matches
706,Kiernan Dewsbury-Hall,eng,MF,,Leicester City,Premier League,23,1998,25.6,53,29,14,34,5,19,47,40.4,28,55,13,42,28,81,21,Matches
707,Samuel Di Carmine,it,FW,MF,Cremonese,it Serie A,33,1988,0.3,0,0,0,0,0,0,0,,0,0,0,0,0,0,0,Matches
708,Federico Di Francesco,it,FW,MF,Lecce,it Serie A,28,1994,22.6,28,16,7,11,10,9,19,47.4,10,16,0,16,8,36,14,Matches
709,Michele Di Gregorio,it,GK,,Monza,it Serie A,25,1997,37.0,0,0,0,0,0,0,3,0.0,3,1,0,1,4,4,18,Matches
710,Giovanni Di Lorenzo,it,DF,,Napoli,it Serie A,28,1993,36.2,60,29,33,19,8,25,49,51.0,24,30,9,21,30,90,60,Matches
711,Ángel Di María,ar,FW,MF,Juventus,it Serie A,34,1988,15.1,10,5,3,5,2,3,19,15.8,16,15,0,15,7,17,0,Matches
712,Boulaye Dia,sn,FW,MF,Salernitana,it Serie A,25,1996,28.0,12,5,3,6,3,2,7,28.6,5,10,0,10,7,19,27,Matches
713,Moussa Diaby,fr,FW,MF,Leverkusen,Bundesliga,23,1999,30.0,14,8,4,8,2,7,14,50.0,7,8,0,8,5,19,3,Matches
714,Mouctar Diakhaby,gn,DF,,Valencia,La Liga,25,1996,27.2,30,16,19,11,0,13,20,65.0,7,30,17,13,20,50,111,Matches
715,Mamadou Diakhon,fr,FW,,Reims,Ligue 1,16,2005,0.2,2,0,2,0,0,0,1,0.0,1,1,0,1,1,3,0,Matches
716,Bafodé Diakité,fr,DF,,Lille,Ligue 1,21,2001,29.5,54,35,23,24,7,32,57,56.1,25,37,8,29,17,71,58,Matches
717,Ibrahim Diakité,gn,DF,,Reims,Ligue 1,18,2003,1.5,3,3,3,0,0,2,3,66.7,1,0,0,0,5,8,6,Matches
718,Abdou Diallo,sn,DF,MF,RB Leipzig,Bundesliga,26,1996,5.3,6,5,5,1,0,1,3,33.3,2,8,5,3,8,14,22,Matches
719,Baila Diallo,fr,DF,MF,Clermont Foot,Ligue 1,21,2001,1.0,1,0,1,0,0,0,0,,0,1,1,0,0,1,1,Matches
720,Habib Diallo,sn,FW,,Strasbourg,Ligue 1,27,1995,32.0,18,10,8,7,3,6,16,37.5,10,19,4,15,12,30,26,Matches
721,Ibrahima Diallo,fr,MF,,Southampton,Premier League,23,1999,9.1,25,15,14,10,1,8,14,57.1,6,11,1,10,6,31,11,Matches
722,Ismael Diallo,ci,DF,,Ajaccio,Ligue 1,25,1997,24.2,46,33,35,9,2,35,63,55.6,28,26,12,14,30,76,46,Matches
723,Habib Diarra,sn,MF,FW,Strasbourg,Ligue 1,18,2004,18.1,24,16,10,11,3,15,29,51.7,14,17,1,16,11,35,13,Matches
724,Mamady Diarra,ml,MF,DF,Cádiz,La Liga,22,2000,0.7,2,1,2,0,0,1,2,50.0,1,2,0,2,0,2,0,Matches
725,Moussa Diarra,ml,DF,,Toulouse,Ligue 1,21,2000,13.6,20,9,9,9,2,9,15,60.0,6,25,10,15,19,39,27,Matches
726,Stéphane Diarra,fr,FW,MF,Lorient,Ligue 1,23,1998,11.8,25,17,14,9,2,11,29,37.9,18,13,1,12,22,47,9,Matches
727,Youba Diarra,ml,MF,,Cádiz,La Liga,24,1998,1.1,3,0,2,1,0,1,5,20.0,4,7,1,6,2,5,3,Matches
728,Rúben Dias,pt,DF,,Manchester City,Premier League,25,1997,22.2,21,13,10,10,1,11,18,61.1,7,21,13,8,18,39,56,Matches
729,Krépin Diatta,sn,MF,FW,Monaco,Ligue 1,23,1999,23.0,30,21,4,17,9,13,32,40.6,19,29,1,28,17,47,12,Matches
730,Mory Diaw,sn,GK,,Clermont Foot,Ligue 1,29,1993,37.0,0,0,0,0,0,0,4,0.0,4,0,0,0,2,2,13,Matches
731,Brahim Díaz,ma,MF,FW,Milan,it Serie A,22,1999,21.4,32,15,5,22,5,5,15,33.3,10,11,0,11,7,39,6,Matches
732,Luis Díaz,co,FW,,Liverpool,Premier League,25,1997,11.1,17,11,4,8,5,8,15,53.3,7,8,0,8,6,23,2,Matches
733,Justin Diehl,de,MF,FW,Köln,Bundesliga,17,2004,0.2,0,0,0,0,0,0,0,,0,0,0,0,0,0,0,Matches
734,Bamba Dieng,sn,FW,MF,Marseille,Ligue 1,22,2000,2.2,4,4,2,1,1,3,4,75.0,1,5,1,4,0,4,0,Matches
735,Bamba Dieng,sn,FW,,Lorient,Ligue 1,22,2000,8.3,19,10,5,12,2,3,11,27.3,8,6,0,6,2,21,6,Matches
736,Eric Dier,eng,DF,,Tottenham,Premier League,28,1994,31.3,30,19,16,12,2,9,19,47.4,10,41,24,17,35,65,112,Matches
737,Florian Dietz,de,FW,,Köln,Bundesliga,23,1998,4.4,2,1,0,2,0,1,4,25.0,3,4,1,3,0,2,2,Matches
738,Lucas Digne,fr,DF,,Aston Villa,Premier League,29,1993,16.7,30,12,20,9,1,20,33,60.6,13,18,5,13,18,48,45,Matches
739,Federico Dimarco,it,DF,,Inter,it Serie A,24,1997,23.0,31,25,6,18,7,9,19,47.4,10,15,4,11,18,49,20,Matches
740,Stole Dimitrievski,mk,GK,,Rayo Vallecano,La Liga,28,1993,36.9,1,0,1,0,0,1,2,50.0,1,2,0,2,1,2,17,Matches
741,Junior Dina Ebimbe,fr,DF,MF,Eint Frankfurt,Bundesliga,21,2000,11.8,30,19,16,14,0,16,33,48.5,17,18,5,13,11,41,20,Matches
742,Tristan Dingomé,cm,MF,,Troyes,Ligue 1,31,1991,1.1,1,1,0,1,0,0,2,0.0,2,0,0,0,0,1,0,Matches
743,Eren Dinkçi,de,FW,MF,Werder Bremen,Bundesliga,20,2001,2.6,5,5,2,1,2,2,6,33.3,4,2,0,2,0,5,2,Matches
744,Sinaly Diomande,ci,DF,,Lyon,Ligue 1,21,2001,21.7,42,24,26,15,1,31,49,63.3,18,26,13,13,49,91,75,Matches
745,Lois Diony,fr,FW,,Angers,Ligue 1,29,1992,5.6,1,0,0,1,0,1,3,33.3,2,2,0,2,0,1,1,Matches
746,Edan Diop,fr,DF,FW,Monaco,Ligue 1,17,2004,2.5,13,8,3,3,7,7,15,46.7,8,7,1,6,4,17,1,Matches
747,Issa Diop,fr,DF,,Fulham,Premier League,25,1997,22.4,28,19,18,9,1,17,32,53.1,15,24,17,7,35,63,86,Matches
748,Sofiane Diop,fr,MF,FW,Nice,Ligue 1,22,2000,13.6,23,11,12,6,5,7,20,35.0,13,14,2,12,16,39,5,Matches
749,Sofiane Diop,fr,MF,,Monaco,Ligue 1,22,2000,0.7,0,0,0,0,0,0,0,,0,0,0,0,1,1,0,Matches
750,Yehvann Diouf,fr,GK,,Reims,Ligue 1,22,1999,31.0,2,0,2,0,0,1,3,33.3,2,0,0,0,1,3,13,Matches
751,Axel Disasi,fr,DF,,Monaco,Ligue 1,24,1998,37.0,30,20,13,13,4,13,27,48.1,14,51,31,20,56,86,112,Matches
752,Tiago Djaló,pt,DF,,Lille,Ligue 1,22,2000,22.4,31,21,23,7,1,13,20,65.0,7,17,11,6,23,54,60,Matches
753,Djené,tg,DF,,Getafe,La Liga,30,1991,31.6,41,28,23,17,1,22,38,57.9,16,25,10,15,42,83,81,Matches
754,Moussa Djenepo,ml,DF,FW,Southampton,Premier League,24,1998,7.9,19,11,13,5,1,11,27,40.7,16,19,2,17,11,30,7,Matches
755,Koffi Djidji,ci,DF,,Torino,it Serie A,29,1992,26.9,50,25,32,17,1,18,32,56.3,14,29,14,15,34,84,72,Matches
756,Alexander Djiku,gh,DF,,Strasbourg,Ligue 1,27,1994,29.7,53,36,37,16,0,26,46,56.5,20,45,19,26,66,119,151,Matches
757,Berat Djimsiti,al,DF,,Atalanta,it Serie A,29,1993,20.0,34,19,21,13,0,17,25,68.0,8,17,7,10,36,70,74,Matches
758,Moussa Djitte,sn,FW,,Ajaccio,Ligue 1,22,1999,1.5,1,0,0,0,1,1,2,50.0,1,0,0,0,0,1,1,Matches
759,Ouparine Djoco,gw,GK,,Clermont Foot,Ligue 1,24,1998,1.0,0,0,0,0,0,0,0,,0,0,0,0,0,0,1,Matches
760,Marko Dmitrović,rs,GK,,Sevilla,La Liga,30,1992,14.1,0,0,0,0,0,0,0,,0,0,0,0,0,0,6,Matches
761,Alan Do Marcolino,ga,FW,,Rennes,Ligue 1,20,2002,0.2,0,0,0,0,0,0,0,,0,0,0,0,0,0,1,Matches
762,Ben Doak,sct,FW,,Liverpool,Premier League,16,2005,0.3,3,2,1,2,0,1,1,100.0,0,1,0,1,0,3,0,Matches
763,Ritsu Doan,jp,MF,FW,Freiburg,Bundesliga,24,1998,26.9,61,29,19,29,13,25,55,45.5,30,40,1,39,14,75,12,Matches
764,Dodô,br,DF,,Fiorentina,it Serie A,23,1998,25.9,40,22,20,14,6,22,46,47.8,24,26,2,24,25,65,37,Matches
765,Danilho Doekhi,nl,DF,,Union Berlin,Bundesliga,24,1998,24.6,38,23,21,17,0,14,26,53.8,12,27,12,15,29,67,93,Matches
766,Matt Doherty,ie,DF,MF,Tottenham,Premier League,30,1992,7.4,16,10,12,3,1,8,10,80.0,2,11,6,5,8,24,14,Matches
767,Matt Doherty,ie,DF,,Atlético Madrid,La Liga,30,1992,0.2,0,0,0,0,0,0,0,,0,2,0,2,0,0,0,Matches
768,Josh Doig,sct,DF,,Hellas Verona,it Serie A,20,2002,15.0,19,8,6,7,6,6,16,37.5,10,25,6,19,11,30,13,Matches
769,Jeremy Doku,be,MF,FW,Rennes,Ligue 1,20,2002,14.3,25,16,6,13,6,12,24,50.0,12,10,0,10,5,30,2,Matches
770,Kasper Dolberg,dk,FW,,Sevilla,La Liga,24,1997,2.2,1,0,0,1,0,1,3,33.3,2,0,0,0,0,1,5,Matches
771,Kasper Dolberg,dk,FW,MF,Hoffenheim,Bundesliga,24,1997,4.5,7,5,1,4,2,4,6,66.7,2,6,2,4,0,7,5,Matches
772,Carlos Dominguez,es,DF,,Celta Vigo,La Liga,21,2001,1.2,1,1,0,1,0,1,2,50.0,1,1,1,0,0,1,7,Matches
773,Nicolás Domínguez,ar,MF,,Bologna,it Serie A,24,1998,25.6,79,49,34,33,12,39,76,51.3,37,29,3,26,21,100,29,Matches
774,John Donald,es,MF,DF,Elche,La Liga,21,2000,12.1,20,11,9,9,2,7,14,50.0,7,14,7,7,14,34,23,Matches
775,Giulio Donati,it,DF,,Monza,it Serie A,32,1990,4.7,4,1,1,1,2,3,6,50.0,3,3,1,2,4,8,11,Matches
776,Kyliane Dong,fr,MF,FW,Troyes,Ligue 1,17,2004,2.4,3,1,0,2,1,1,2,50.0,1,1,0,1,1,4,0,Matches
777,Jordan Dongmo,cm,MF,,Troyes,Ligue 1,21,2001,0.2,1,0,0,1,0,1,1,100.0,0,0,0,0,0,1,0,Matches
778,Gianluigi Donnarumma,it,GK,,Paris S-G,Ligue 1,23,1999,37.9,1,0,1,0,0,1,2,50.0,1,0,0,0,0,1,12,Matches
779,Niklas Dorsch,de,MF,,Augsburg,Bundesliga,24,1998,5.4,21,12,8,11,2,9,16,56.3,7,9,3,6,6,27,9,Matches
780,Jodel Dossou,bj,MF,DF,Clermont Foot,Ligue 1,30,1992,2.9,7,4,3,2,2,4,4,100.0,0,2,1,1,1,8,0,Matches
781,Lohann Doucet,fr,MF,FW,Nantes,Ligue 1,19,2002,1.0,3,0,2,0,1,3,4,75.0,1,2,0,2,2,5,4,Matches
782,Abdoulaye Doucouré,ml,MF,,Everton,Premier League,29,1993,17.0,31,20,9,15,7,12,37,32.4,25,26,3,23,13,44,11,Matches
783,Cheick Doucouré,ml,MF,,Crystal Palace,Premier League,22,2000,30.8,77,46,40,33,4,29,52,55.8,23,47,13,34,56,133,48,Matches
784,Siriné Doucouré,ml,FW,MF,Lorient,Ligue 1,20,2002,1.5,2,2,2,0,0,1,2,50.0,1,0,0,0,1,3,0,Matches
785,Désiré Doué,fr,MF,FW,Rennes,Ligue 1,17,2005,12.4,37,18,10,23,4,13,32,40.6,19,17,1,16,13,50,3,Matches
786,Guela Doué,ci,FW,MF,Rennes,Ligue 1,19,2002,0.1,0,0,0,0,0,0,0,,0,0,0,0,0,0,0,Matches
787,Ismaël Doukouré,fr,DF,MF,Strasbourg,Ligue 1,19,2003,25.5,48,24,23,21,4,20,34,58.8,14,26,8,18,27,75,54,Matches
788,Kamory Doumbia,ml,MF,,Reims,Ligue 1,19,2003,12.8,31,16,9,14,8,12,37,32.4,25,17,1,16,13,44,3,Matches
789,Souleyman Doumbia,ci,DF,FW,Angers,Ligue 1,25,1996,19.9,45,31,31,13,1,17,31,54.8,14,20,3,17,27,72,27,Matches
790,Flynn Downes,eng,MF,,West Ham,Premier League,23,1999,8.5,16,9,4,10,2,6,12,50.0,6,15,2,13,7,23,6,Matches
791,Kami Doyle,eng,MF,,Southampton,Premier League,16,2005,0.1,0,0,0,0,0,0,0,,0,0,0,0,0,0,0,Matches
792,Bartłomiej Drągowski,pl,GK,,Spezia,it Serie A,24,1997,32.7,1,0,1,0,0,1,5,20.0,4,0,0,0,1,2,15,Matches
793,Cody Drameh,eng,DF,,Leeds United,Premier League,20,2001,0.8,5,4,0,4,1,2,3,66.7,1,0,0,0,1,6,1,Matches
794,Dion Drena Beljo,hr,FW,,Augsburg,Bundesliga,20,2002,12.5,7,6,3,2,2,2,13,15.4,11,15,2,13,1,8,14,Matches
795,Dominick Drexler,de,MF,FW,Schalke 04,Bundesliga,32,1990,15.2,25,17,12,10,3,9,22,40.9,13,18,2,16,8,33,12,Matches
796,Domingos Duarte,pt,DF,,Getafe,La Liga,27,1995,29.5,26,18,21,5,0,19,26,73.1,7,29,23,6,39,65,145,Matches
797,Martin Dúbravka,sk,GK,,Newcastle Utd,Premier League,33,1989,1.7,0,0,0,0,0,0,1,0.0,1,0,0,0,0,0,1,Matches
798,Marvin Ducksch,de,FW,,Werder Bremen,Bundesliga,28,1994,31.7,8,3,2,4,2,3,16,18.8,13,13,2,11,9,17,41,Matches
799,Ondrej Duda,sk,MF,,Hellas Verona,it Serie A,27,1994,11.8,22,14,7,12,3,9,16,56.3,7,11,0,11,13,35,8,Matches
800,Ondrej Duda,sk,MF,,Köln,Bundesliga,27,1994,7.7,9,8,2,5,2,4,11,36.4,7,7,1,6,2,11,3,Matches
801,Shane Duffy,ie,DF,FW,Fulham,Premier League,30,1992,0.2,0,0,0,0,0,0,0,,0,0,0,0,0,0,0,Matches
802,Rémy Dugimont,fr,FW,MF,Auxerre,Ligue 1,36,1986,1.3,2,1,0,1,1,1,2,50.0,1,3,0,3,0,2,5,Matches
803,Denzel Dumfries,nl,DF,,Inter,it Serie A,26,1996,24.6,35,18,17,13,5,22,34,64.7,12,33,9,24,12,47,26,Matches
804,Alfred Duncan,gh,MF,,Fiorentina,it Serie A,29,1993,12.3,18,10,0,17,1,10,21,47.6,11,9,0,9,8,26,6,Matches
805,Lewis Dunk,eng,DF,,Brighton,Premier League,30,1991,36.0,30,19,19,9,2,18,41,43.9,23,37,27,10,34,64,81,Matches
806,Maxime Dupé,fr,GK,,Toulouse,Ligue 1,29,1993,38.0,0,0,0,0,0,0,0,,0,0,0,0,0,0,9,Matches
807,Jhon Durán,co,FW,MF,Aston Villa,Premier League,18,2003,1.5,2,2,0,1,1,1,4,25.0,3,0,0,0,2,4,2,Matches
808,Pablo Durán,es,MF,DF,Celta Vigo,La Liga,21,2001,0.4,0,0,0,0,0,0,0,,0,2,1,1,1,1,2,Matches
809,Julien Duranville,be,MF,,Dortmund,Bundesliga,16,2006,0.3,1,1,0,1,0,1,1,100.0,0,0,0,0,0,1,0,Matches
810,Hugo Duro,es,FW,,Valencia,La Liga,22,1999,15.4,15,12,2,6,7,7,17,41.2,10,11,1,10,2,17,7,Matches
811,Jean-Kevin Duverne,ht,DF,,Brest,Ligue 1,25,1997,27.9,72,38,44,24,4,42,73,57.5,31,33,5,28,28,100,65,Matches
812,Paulo Dybala,ar,MF,FW,Roma,it Serie A,28,1993,19.3,14,4,1,8,5,8,26,30.8,18,12,1,11,8,22,4,Matches
813,Edin Džeko,ba,FW,,Inter,it Serie A,36,1986,19.2,3,2,0,3,0,0,4,0.0,4,15,1,14,3,6,25,Matches
814,Malcolm Ebiowei,eng,MF,FW,Crystal Palace,Premier League,18,2003,0.4,1,1,1,0,0,0,1,0.0,1,2,0,2,0,1,0,Matches
815,Festy Ebosele,ie,DF,,Udinese,it Serie A,19,2002,4.6,15,10,8,7,0,4,10,40.0,6,5,0,5,2,17,5,Matches
816,Enzo Ebosse,cm,DF,,Udinese,it Serie A,23,1999,10.3,15,9,11,4,0,9,13,69.2,4,27,6,21,11,26,29,Matches
817,Tyronne Ebuehi,ng,DF,,Empoli,it Serie A,26,1995,21.4,22,14,11,7,4,9,13,69.2,4,23,12,11,12,34,79,Matches
818,Ederson,br,GK,,Manchester City,Premier League,28,1993,35.0,3,1,3,0,0,1,2,50.0,1,0,0,0,1,4,10,Matches
819,Éderson,br,MF,,Atalanta,it Serie A,23,1999,24.6,67,34,18,42,7,29,66,43.9,37,56,7,49,36,103,31,Matches
820,Odsonne Édouard,fr,FW,,Crystal Palace,Premier League,24,1998,20.0,25,13,7,12,6,7,13,53.8,6,17,5,12,3,28,22,Matches
821,Samuel Edozie,eng,FW,MF,Southampton,Premier League,19,2003,6.3,17,10,6,10,1,3,8,37.5,5,7,0,7,6,23,6,Matches
822,Maximilian Eggestein,de,MF,,Freiburg,Bundesliga,25,1996,27.2,51,29,21,24,6,17,35,48.6,18,37,8,29,36,87,27,Matches
823,Lilian Egloff,de,MF,FW,Stuttgart,Bundesliga,19,2002,2.7,12,10,4,5,3,4,6,66.7,2,2,0,2,1,13,1,Matches
824,Íñigo Eguaras,es,MF,,Almería,La Liga,30,1992,10.7,11,8,4,6,1,5,18,27.8,13,9,3,6,6,17,15,Matches
825,Kingsley Ehizibue,nl,DF,,Udinese,it Serie A,27,1995,17.1,47,31,28,13,6,29,45,64.4,16,21,3,18,10,57,42,Matches
826,Kingsley Ehizibue,nl,DF,,Köln,Bundesliga,27,1995,0.7,0,0,0,0,0,0,0,,0,1,0,1,2,2,1,Matches
827,Julian Eitschberger,de,FW,,Hertha BSC,Bundesliga,18,2004,0.0,0,0,0,0,0,0,0,,0,0,0,0,0,0,0,Matches
828,Chidera Ejuke,ng,FW,MF,Hertha BSC,Bundesliga,24,1998,9.9,5,4,1,4,0,1,5,20.0,4,4,0,4,4,9,1,Matches
829,Albin Ekdal,se,MF,,Spezia,it Serie A,33,1989,19.3,37,20,14,20,3,19,45,42.2,26,24,2,22,26,63,36,Matches
830,Hugo Ekitike,fr,FW,,Paris S-G,Ligue 1,20,2002,12.8,12,4,1,10,1,4,12,33.3,8,12,0,12,9,21,3,Matches
831,Emmanuel Ekong,se,FW,MF,Empoli,it Serie A,20,2002,0.2,0,0,0,0,0,0,0,,0,0,0,0,0,0,0,Matches
832,Anthony Elanga,se,FW,,Manchester Utd,Premier League,20,2002,4.7,3,0,0,2,1,1,2,50.0,1,4,0,4,2,5,4,Matches
833,Alberth Elis,hn,MF,FW,Brest,Ligue 1,26,1996,2.9,4,3,1,2,1,1,7,14.3,6,1,0,1,1,5,2,Matches
834,Mikael Ellertsson,is,MF,DF,Spezia,it Serie A,20,2002,1.9,4,2,1,3,0,0,3,0.0,3,2,1,1,2,6,0,Matches
835,Harvey Elliott,eng,MF,FW,Liverpool,Premier League,19,2003,17.9,27,18,6,12,9,9,37,24.3,28,26,1,25,15,42,8,Matches
836,Elif Elmas,mk,FW,MF,Napoli,it Serie A,22,1999,18.1,24,13,8,12,4,11,23,47.8,12,18,2,16,11,35,5,Matches
837,Mohamed Elneny,eg,MF,,Arsenal,Premier League,30,1992,1.3,1,1,1,0,0,1,1,100.0,0,0,0,0,0,1,0,Matches
838,Aritz Elustondo,es,DF,,Real Sociedad,La Liga,28,1994,16.1,26,17,15,10,1,14,26,53.8,12,15,6,9,20,46,43,Matches
839,Nico Elvedi,ch,DF,,Gladbach,Bundesliga,25,1996,31.4,46,24,32,12,2,27,41,65.9,14,31,16,15,35,81,149,Matches
840,Rodrigo Ely,br,DF,,Almería,La Liga,28,1993,35.1,30,21,26,4,0,18,25,72.0,7,46,33,13,31,61,203,Matches
841,Mohamed Elyounoussi,no,MF,FW,Southampton,Premier League,27,1994,24.1,46,28,22,20,4,19,44,43.2,25,40,3,37,27,73,37,Matches
842,Adri Embarba,es,FW,MF,Almería,La Liga,30,1992,16.4,50,27,21,26,3,22,46,47.8,24,23,0,23,9,59,9,Matches
843,Adri Embarba,es,FW,,Espanyol,La Liga,30,1992,0.4,1,0,0,1,0,1,1,100.0,0,1,0,1,0,1,0,Matches
844,Breel Embolo,ch,FW,,Monaco,Ligue 1,25,1997,20.7,15,9,2,7,6,5,10,50.0,5,14,3,11,5,20,12,Matches
845,Emerson,br,DF,,Tottenham,Premier League,23,1999,19.3,54,33,38,12,4,27,40,67.5,13,17,3,14,18,72,75,Matches
846,Youssef En-Nesyri,ma,FW,,Sevilla,La Liga,25,1997,18.5,16,8,3,7,6,4,14,28.6,10,6,2,4,4,20,16,Matches
847,Julio Enciso,py,FW,MF,Brighton,Premier League,18,2004,9.0,13,4,3,6,4,8,13,61.5,5,9,0,9,4,17,2,Matches
848,Wataru Endo,jp,MF,,Stuttgart,Bundesliga,29,1993,32.5,70,37,30,31,9,38,85,44.7,47,44,6,38,26,96,63,Matches
849,Arne Engels,be,MF,,Augsburg,Bundesliga,18,2003,16.0,20,9,9,10,1,8,19,42.1,11,17,5,12,15,35,12,Matches
850,Christian Eriksen,dk,MF,,Manchester Utd,Premier League,30,1992,22.8,22,18,10,7,5,10,33,30.3,23,23,9,14,11,33,20,Matches
851,Martin Erlic,hr,DF,,Sassuolo,it Serie A,24,1998,25.9,27,16,18,8,1,10,23,43.5,13,36,23,13,31,58,120,Matches
852,Tjark Ernst,de,GK,,Hertha BSC,Bundesliga,19,2003,1.0,0,0,0,0,0,0,0,,0,0,0,0,0,0,1,Matches
853,Gonzalo Escalante,ar,MF,,Cremonese,it Serie A,29,1993,6.2,16,8,8,8,0,10,13,76.9,3,7,1,6,10,26,4,Matches
854,Gonzalo Escalante,ar,MF,,Cádiz,La Liga,29,1993,12.5,36,24,15,20,1,15,29,51.7,14,18,4,14,17,53,26,Matches
855,Sergio Escudero,es,DF,,Valladolid,La Liga,32,1989,16.0,33,19,21,8,4,15,35,42.9,20,26,6,20,26,59,46,Matches
856,Alfonso Espino,uy,DF,,Cádiz,La Liga,30,1992,34.7,87,56,55,20,12,48,96,50.0,48,52,11,41,48,135,99,Matches
857,Bernardo Espinosa,co,DF,,Girona,La Liga,33,1989,13.6,6,2,2,4,0,3,9,33.3,6,17,10,7,12,18,70,Matches
858,Salvatore Esposito,it,MF,,Spezia,it Serie A,21,2000,10.8,15,12,8,5,2,5,21,23.8,16,9,1,8,11,26,18,Matches
859,Maxime Estève,fr,DF,,Montpellier,Ligue 1,20,2002,18.3,24,13,17,5,2,12,17,70.6,5,28,17,11,34,58,90,Matches
860,Pervis Estupiñán,ec,DF,,Brighton,Premier League,24,1998,29.7,61,31,36,19,6,35,60,58.3,25,30,8,22,37,98,37,Matches
861,Jonny Evans,nir,DF,,Leicester City,Premier League,34,1988,11.7,13,5,12,1,0,7,11,63.6,4,15,11,4,18,31,51,Matches
862,Edu Expósito,es,MF,,Espanyol,La Liga,25,1996,12.9,34,20,16,15,3,13,23,56.5,10,7,0,7,12,46,20,Matches
863,Eberechi Eze,eng,MF,FW,Crystal Palace,Premier League,24,1998,29.3,42,24,17,18,7,18,38,47.4,20,22,0,22,13,55,10,Matches
864,Kimberly Ezekwem,de,DF,,Freiburg,Bundesliga,21,2001,0.1,0,0,0,0,0,0,0,,0,1,0,1,0,0,0,Matches
865,Nicolás Ezequiel Fernández,ar,MF,DF,Elche,La Liga,22,2000,5.7,23,12,10,7,6,9,17,52.9,8,7,0,7,5,28,2,Matches
866,Abde Ezzalzouli,ma,FW,MF,Osasuna,La Liga,20,2001,16.7,29,19,13,12,4,13,23,56.5,10,20,0,20,4,33,6,Matches
867,Łukasz Fabiański,pl,GK,,West Ham,Premier League,37,1985,34.6,2,0,2,0,0,1,2,50.0,1,1,0,1,0,2,10,Matches
868,Fabinho,br,MF,,Liverpool,Premier League,28,1993,29.7,65,38,18,40,7,24,62,38.7,38,38,11,27,37,102,40,Matches
869,Fábio,br,DF,MF,Nantes,Ligue 1,32,1990,2.5,4,2,1,2,1,4,6,66.7,2,2,0,2,3,7,11,Matches
870,Noah Fadiga,sn,DF,,Brest,Ligue 1,22,1999,14.5,30,21,18,9,3,14,26,53.8,12,17,7,10,26,56,18,Matches
871,Wout Faes,be,DF,,Leicester City,Premier League,24,1998,31.0,56,33,28,26,2,28,44,63.6,16,53,37,16,41,97,113,Matches
872,Wout Faes,be,DF,,Reims,Ligue 1,24,1998,3.0,1,1,1,0,0,1,2,50.0,1,6,3,3,7,8,19,Matches
873,Nicolò Fagioli,it,MF,,Juventus,it Serie A,21,2001,16.9,29,19,12,15,2,8,27,29.6,19,16,2,14,8,37,7,Matches
874,Ralf Fährmann,de,GK,,Schalke 04,Bundesliga,33,1988,11.4,1,0,1,0,0,1,1,100.0,0,0,0,0,0,1,10,Matches
875,Romain Faivre,fr,MF,FW,Lorient,Ligue 1,24,1998,13.8,13,8,5,4,4,5,25,20.0,20,11,0,11,1,14,4,Matches
876,Romain Faivre,fr,MF,,Lyon,Ligue 1,24,1998,3.3,6,3,2,2,2,1,3,33.3,2,3,0,3,0,6,0,Matches
877,Radamel Falcao,co,FW,MF,Rayo Vallecano,La Liga,36,1986,6.8,4,4,1,3,0,1,8,12.5,7,5,1,4,2,6,10,Matches
878,Wladimiro Falcone,it,GK,,Lecce,it Serie A,27,1995,38.0,2,0,2,0,0,2,2,100.0,0,0,0,0,2,4,21,Matches
879,Fali,es,DF,MF,Cádiz,La Liga,28,1993,19.0,27,19,19,8,0,18,29,62.1,11,24,15,9,13,40,70,Matches
880,Fallou Fall,sn,DF,,Reims,Ligue 1,18,2004,0.4,0,0,0,0,0,0,1,0.0,1,3,3,0,0,0,4,Matches
881,Mamadou Fall,sn,DF,,Villarreal,La Liga,19,2002,0.3,0,0,0,0,0,0,0,,0,1,0,1,0,0,1,Matches
882,Davide Faraoni,it,DF,,Hellas Verona,it Serie A,30,1991,16.5,34,24,19,13,2,16,41,39.0,25,30,11,19,15,49,37,Matches
883,Ansu Fati,es,FW,,Barcelona,La Liga,19,2002,15.5,16,9,8,4,4,5,18,27.8,13,19,0,19,5,21,6,Matches
884,Khalil Fayad,fr,MF,,Montpellier,Ligue 1,18,2004,8.0,30,14,12,16,2,12,21,57.1,9,8,1,7,9,39,4,Matches
885,Cheikh Faye,sn,FW,,Montpellier,Ligue 1,23,1999,0.4,0,0,0,0,0,0,0,,0,0,0,0,1,1,0,Matches
886,Federico Fazio,ar,DF,,Salernitana,it Serie A,35,1987,11.9,15,12,8,7,0,4,11,36.4,7,9,4,5,28,43,61,Matches
887,Jacopo Fazzini,it,MF,,Empoli,it Serie A,19,2003,9.2,31,17,20,8,3,18,34,52.9,16,15,3,12,7,38,19,Matches
888,Zouhair Feddal,ma,DF,,Valladolid,La Liga,33,1989,4.2,4,2,1,3,0,3,4,75.0,1,9,9,0,5,9,27,Matches
889,Nabil Fekir,fr,MF,,Betis,La Liga,29,1993,10.7,11,5,3,3,5,2,9,22.2,7,6,2,4,1,12,0,Matches
890,Felipe,br,DF,,Nott'ham Forest,Premier League,33,1989,15.8,42,23,29,13,0,24,41,58.5,17,34,13,21,36,78,90,Matches
891,Felipe,br,DF,,Atlético Madrid,La Liga,33,1989,2.2,3,2,1,2,0,2,4,50.0,2,2,2,0,0,3,7,Matches
892,Luiz Felipe,it,DF,,Betis,La Liga,25,1997,19.6,34,23,23,11,0,18,34,52.9,16,43,24,19,28,62,106,Matches
893,João Félix,pt,FW,MF,Chelsea,Premier League,22,1999,10.5,14,7,5,6,3,4,12,33.3,8,3,0,3,1,15,1,Matches
894,João Félix,pt,FW,MF,Atlético Madrid,La Liga,22,1999,7.2,10,7,2,3,5,1,6,16.7,5,1,0,1,3,13,2,Matches
895,Ohis Felix Uduokhai,de,DF,,Augsburg,Bundesliga,24,1997,16.1,30,20,14,13,3,15,29,51.7,14,27,14,13,29,59,61,Matches
896,Kiko Femenía,es,DF,,Villarreal,La Liga,31,1991,12.6,18,9,14,3,1,13,18,72.2,5,15,6,9,20,38,22,Matches
897,Evan Ferguson,ie,FW,,Brighton,Premier League,17,2004,10.6,6,3,1,3,2,1,7,14.3,6,11,1,10,2,8,6,Matches
898,Lewis Ferguson,sct,MF,FW,Bologna,it Serie A,22,1999,25.7,44,25,16,20,8,20,40,50.0,20,22,7,15,19,63,25,Matches
899,Bruno Fernandes,pt,MF,FW,Manchester Utd,Premier League,27,1994,36.8,68,42,24,25,19,30,71,42.3,41,37,5,32,25,93,40,Matches
900,Edimilson Fernandes,ch,DF,,Mainz 05,Bundesliga,26,1996,27.1,35,25,26,5,4,18,34,52.9,16,37,16,21,54,89,87,Matches
901,Aitor Fernández,es,GK,,Osasuna,La Liga,31,1991,21.0,1,1,1,0,0,0,1,0.0,1,0,0,0,2,3,17,Matches
902,Álex Fernández,es,MF,FW,Cádiz,La Liga,29,1992,17.5,13,7,6,4,3,4,14,28.6,10,14,1,13,8,21,19,Matches
903,Álvaro Fernández,es,GK,,Espanyol,La Liga,24,1998,11.0,0,0,0,0,0,0,0,,0,0,0,0,0,0,7,Matches
904,Carlos Fernández,es,FW,,Real Sociedad,La Liga,26,1996,7.0,6,4,1,3,2,1,15,6.7,14,1,0,1,1,7,4,Matches
905,Enzo Fernández,ar,MF,,Chelsea,Premier League,21,2001,17.2,45,27,25,17,3,21,56,37.5,35,32,2,30,16,61,12,Matches
906,Federico Fernández,ar,DF,,Elche,La Liga,33,1989,1.0,1,1,1,0,0,1,1,100.0,0,0,0,0,2,3,12,Matches
907,Joaquín Fernández,es,DF,,Valladolid,La Liga,26,1996,24.0,35,28,20,11,4,19,30,63.3,11,31,22,9,27,62,98,Matches
908,Valery Fernández,es,MF,DF,Girona,La Liga,22,1999,10.7,12,6,4,6,2,5,9,55.6,4,8,1,7,10,22,9,Matches
909,Fernando,es,GK,,Almería,La Liga,32,1990,36.5,0,0,0,0,0,0,2,0.0,2,2,0,2,1,1,20,Matches
910,Fernando,br,MF,DF,Sevilla,La Liga,35,1987,17.5,34,23,14,17,3,18,30,60.0,12,21,10,11,24,58,29,Matches
911,Alex Ferrari,it,DF,,Sampdoria,it Serie A,28,1994,9.6,9,5,7,2,0,4,8,50.0,4,21,10,11,19,28,25,Matches
912,Alex Ferrari,it,DF,,Cremonese,it Serie A,28,1994,11.2,40,23,32,7,1,28,42,66.7,14,19,4,15,25,65,45,Matches
913,Salvador Ferrer,es,DF,,Spezia,it Serie A,24,1998,1.5,4,2,2,2,0,1,3,33.3,2,3,1,2,1,5,4,Matches
914,Jordan Ferri,fr,MF,,Montpellier,Ligue 1,30,1992,30.4,55,35,32,19,4,30,89,33.7,59,22,6,16,26,81,21,Matches
915,Fidel,es,MF,FW,Elche,La Liga,32,1989,19.0,15,10,8,5,2,4,38,10.5,34,9,0,9,5,20,8,Matches
916,Karol Fila,pl,DF,,Strasbourg,Ligue 1,24,1998,0.5,0,0,0,0,0,0,0,,0,0,0,0,1,1,1,Matches
917,Vincenzo Fiorillo,it,GK,,Salernitana,it Serie A,32,1990,1.0,0,0,0,0,0,0,0,,0,0,0,0,0,0,0,Matches
918,Roberto Firmino,br,FW,MF,Liverpool,Premier League,30,1991,13.5,17,12,2,12,3,4,22,18.2,18,16,1,15,7,24,2,Matches
919,Junior Firpo,do,DF,,Leeds United,Premier League,25,1996,15.2,47,25,27,15,5,24,46,52.2,22,23,7,16,24,71,40,Matches
920,Kilian Fischer,de,DF,FW,Wolfsburg,Bundesliga,21,2000,5.6,9,6,3,4,2,6,11,54.5,5,6,0,6,5,14,18,Matches
921,Mark Flekken,nl,GK,,Freiburg,Bundesliga,29,1993,34.0,0,0,0,0,0,0,1,0.0,1,1,0,1,0,0,9,Matches
922,Florian Flick,de,MF,,Schalke 04,Bundesliga,22,2000,5.7,12,3,7,5,0,4,14,28.6,10,9,3,6,4,16,18,Matches
923,Alexis Flips,fr,FW,MF,Reims,Ligue 1,22,2000,22.0,51,30,18,17,16,27,64,42.2,37,35,5,30,24,75,12,Matches
924,Alessandro Florenzi,it,DF,,Milan,it Serie A,31,1991,2.3,6,4,3,2,1,4,7,57.1,3,1,0,1,4,10,2,Matches
925,Phil Foden,eng,FW,,Manchester City,Premier League,22,2000,20.5,16,10,9,5,2,8,19,42.1,11,25,2,23,5,21,12,Matches
926,Seko Fofana,ci,MF,,Lens,Ligue 1,27,1995,34.1,28,13,8,18,2,15,39,38.5,24,17,4,13,19,47,14,Matches
927,Wesley Fofana,fr,DF,,Leicester City,Premier League,21,2000,2.0,4,2,1,2,1,1,3,33.3,2,1,1,0,9,13,5,Matches
928,Wesley Fofana,fr,DF,,Chelsea,Premier League,21,2000,13.1,30,18,19,7,4,13,26,50.0,13,17,10,7,20,50,33,Matches
929,Yahia Fofana,ci,GK,,Angers,Ligue 1,21,2000,11.0,0,0,0,0,0,0,0,,0,0,0,0,1,1,4,Matches
930,Youssouf Fofana,fr,MF,,Monaco,Ligue 1,23,1999,34.3,81,41,31,42,8,38,74,51.4,36,50,6,44,56,137,32,Matches
931,Thomas Foket,be,DF,,Reims,Ligue 1,27,1994,22.0,35,22,18,11,6,17,46,37.0,29,21,7,14,33,68,29,Matches
932,José Fonte,pt,DF,,Lille,Ligue 1,38,1983,28.8,23,17,18,4,1,10,21,47.6,11,27,14,13,25,48,112,Matches
933,Pablo Fornals,es,FW,MF,West Ham,Premier League,26,1996,16.7,30,15,9,12,9,13,34,38.2,21,16,2,14,14,44,9,Matches
934,Emil Forsberg,se,MF,FW,RB Leipzig,Bundesliga,30,1991,16.5,16,11,1,8,7,6,20,30.0,14,25,2,23,3,19,7,Matches
935,Adam Forshaw,eng,MF,,Leeds United,Premier League,30,1991,5.3,12,9,5,7,0,7,17,41.2,10,9,1,8,4,16,2,Matches
936,Fraser Forster,eng,GK,,Tottenham,Premier League,34,1988,13.5,1,0,1,0,0,0,0,,0,1,0,1,0,1,3,Matches
937,Philipp Förster,de,MF,,Bochum,Bundesliga,27,1995,14.5,31,19,11,15,5,12,40,30.0,28,22,0,22,6,37,6,Matches
938,Steven Fortes,cv,DF,,Lens,Ligue 1,30,1992,0.1,0,0,0,0,0,0,0,,0,0,0,0,0,0,0,Matches
939,Timothy Fosu-Mensah,nl,DF,,Leverkusen,Bundesliga,24,1998,2.1,7,5,3,3,1,4,4,100.0,0,2,0,2,0,7,1,Matches
940,Dimitri Foulquier,fr,DF,,Valencia,La Liga,29,1993,19.3,31,19,17,8,6,20,28,71.4,8,19,3,16,14,45,40,Matches
941,Juan Foyth,ar,DF,,Villarreal,La Liga,24,1998,21.8,73,48,49,22,2,41,57,71.9,16,32,11,21,20,93,68,Matches
942,Raphael Framberger,de,DF,FW,Augsburg,Bundesliga,26,1995,2.0,10,6,6,4,0,3,5,60.0,2,2,1,1,2,12,5,Matches
943,Tyrese Francois,au,FW,,Fulham,Premier League,22,2000,0.0,0,0,0,0,0,0,1,0.0,1,0,0,0,0,0,1,Matches
944,Bartol Franjić,hr,MF,,Wolfsburg,Bundesliga,22,2000,2.5,4,2,2,2,0,0,2,0.0,2,4,1,3,5,9,4,Matches
945,Przemysław Frankowski,pl,DF,MF,Lens,Ligue 1,27,1995,31.5,77,51,37,31,9,39,80,48.8,41,38,6,32,41,118,42,Matches
946,Ryan Fraser,sct,FW,,Newcastle Utd,Premier League,28,1994,3.5,2,2,0,0,2,2,5,40.0,3,3,1,2,0,2,3,Matches
947,Davide Frattesi,it,MF,,Sassuolo,it Serie A,22,1999,31.9,63,36,24,29,10,25,44,56.8,19,27,6,21,16,79,42,Matches
948,Oscar Fraulo,dk,FW,MF,Gladbach,Bundesliga,18,2003,0.1,0,0,0,0,0,0,0,,0,0,0,0,0,0,0,Matches
949,Fred,br,MF,,Manchester Utd,Premier League,29,1993,13.9,47,30,24,20,3,15,38,39.5,23,38,2,36,19,66,19,Matches
950,Ryan Fredericks,eng,DF,,Bournemouth,Premier League,29,1992,5.9,3,2,2,0,1,1,4,25.0,3,7,2,5,1,4,27,Matches
951,Iván Fresneda,es,DF,,Valladolid,La Liga,17,2004,19.4,48,34,31,13,4,29,47,61.7,18,32,8,24,15,63,60,Matches
952,Remo Freuler,ch,MF,,Nott'ham Forest,Premier League,30,1992,24.0,43,23,23,15,5,19,43,44.2,24,36,9,27,29,72,45,Matches
953,Michael Frey,ch,FW,,Schalke 04,Bundesliga,28,1994,9.6,13,5,2,8,3,4,13,30.8,9,6,0,6,2,15,1,Matches
954,Marco Friedl,at,DF,,Werder Bremen,Bundesliga,24,1998,28.8,62,46,40,22,0,41,68,60.3,27,46,17,29,58,120,127,Matches
955,Marvin Friedrich,de,DF,,Gladbach,Bundesliga,26,1995,13.9,17,11,13,3,1,10,13,76.9,3,14,6,8,11,28,52,Matches
956,Jeremie Frimpong,nl,DF,MF,Leverkusen,Bundesliga,21,2000,30.1,53,27,22,26,5,23,44,52.3,21,24,3,21,16,69,40,Matches
957,Chris Führich,de,FW,MF,Stuttgart,Bundesliga,24,1998,20.9,36,14,15,14,7,24,44,54.5,20,29,2,27,7,43,13,Matches
958,Angelo Fulgini,fr,MF,FW,Lens,Ligue 1,25,1996,9.5,14,7,2,4,8,5,14,35.7,9,11,0,11,8,22,2,Matches
959,Angelo Fulgini,fr,MF,,Mainz 05,Bundesliga,25,1996,5.8,6,5,2,3,1,5,12,41.7,7,5,0,5,5,11,7,Matches
960,Niclas Füllkrug,de,FW,,Werder Bremen,Bundesliga,29,1993,27.5,9,4,0,6,3,3,13,23.1,10,13,4,9,1,10,24,Matches
961,Matteo Gabbia,it,DF,,Milan,it Serie A,22,1999,6.8,17,10,12,5,0,6,8,75.0,2,8,3,5,5,22,29,Matches
962,Manolo Gabbiadini,it,FW,MF,Sampdoria,it Serie A,30,1991,26.2,23,15,8,9,6,9,23,39.1,14,16,2,14,6,29,25,Matches
963,Gianluca Gaetano,it,MF,,Napoli,it Serie A,22,2000,0.8,5,3,1,3,1,0,0,,0,1,0,1,1,6,0,Matches
964,Roberto Gagliardini,it,MF,,Inter,it Serie A,28,1994,8.7,16,6,9,6,1,10,21,47.6,11,14,5,9,4,20,15,Matches
965,Adolfo Gaich,ar,FW,,Hellas Verona,it Serie A,23,1999,8.1,5,3,0,3,2,1,6,16.7,5,7,2,5,3,8,7,Matches
966,Cody Gakpo,nl,FW,MF,Liverpool,Premier League,23,1999,16.2,26,15,4,13,9,13,38,34.2,25,13,1,12,4,30,2,Matches
967,Javi Galán,es,DF,,Celta Vigo,La Liga,27,1994,35.1,104,72,60,40,4,48,98,49.0,50,54,5,49,41,145,63,Matches
968,Iñigo Ruiz de Galarreta,es,MF,,Mallorca,La Liga,28,1993,27.2,54,38,27,23,4,20,52,38.5,32,26,9,17,30,84,19,Matches
969,Pablo Galdames Millán,cl,MF,,Cremonese,it Serie A,25,1996,8.2,14,10,8,3,3,5,33,15.2,28,13,2,11,10,24,13,Matches
970,Conor Gallagher,eng,MF,,Chelsea,Premier League,22,2000,18.0,46,33,17,19,10,10,37,27.0,27,41,10,31,23,69,18,Matches
971,Antonino Gallo,it,DF,,Lecce,it Serie A,22,2000,27.6,56,36,35,12,9,38,57,66.7,19,37,6,31,13,69,71,Matches
972,Gauthier Gallon,fr,GK,,Troyes,Ligue 1,29,1993,29.6,2,2,2,0,0,2,4,50.0,2,0,0,0,2,4,17,Matches
973,Cristian Gamboa,cr,DF,,Bochum,Bundesliga,32,1989,16.4,42,24,27,14,1,21,31,67.7,10,20,7,13,16,58,34,Matches
974,Kévin Gameiro,fr,FW,,Strasbourg,Ligue 1,35,1987,23.3,20,10,6,10,4,8,28,28.6,20,10,1,9,9,29,0,Matches
975,Idrissa Gana Gueye,sn,MF,,Everton,Premier League,32,1989,28.6,97,57,49,35,13,31,62,50.0,31,50,12,38,56,153,34,Matches
976,Ignatius Ganago,cm,FW,MF,Nantes,Ligue 1,23,1999,16.9,9,7,2,3,4,4,7,57.1,3,13,1,12,2,11,12,Matches
977,Ignatius Ganago,cm,FW,,Lens,Ligue 1,23,1999,0.7,0,0,0,0,0,0,0,,0,0,0,0,0,0,1,Matches
978,Silvère Ganvoula M'Boussy,cg,FW,MF,Bochum,Bundesliga,26,1996,2.7,2,2,0,1,1,0,0,,0,0,0,0,0,2,3,Matches
979,Aleix García,es,MF,,Girona,La Liga,25,1997,26.0,37,20,9,18,10,15,33,45.5,18,24,8,16,31,68,35,Matches
980,Álvaro García,es,FW,MF,Rayo Vallecano,La Liga,29,1992,31.9,49,28,21,13,15,11,33,33.3,22,41,4,37,34,83,24,Matches
981,Borja García,es,MF,FW,Girona,La Liga,31,1990,7.5,10,4,7,2,1,2,9,22.2,7,3,1,2,5,15,6,Matches
982,Carlos García,es,DF,,Cádiz,La Liga,22,2000,0.3,0,0,0,0,0,0,0,,0,0,0,0,0,0,2,Matches
983,Dani García,es,MF,,Athletic Club,La Liga,32,1990,16.5,46,27,17,25,4,29,47,61.7,18,21,6,15,19,65,21,Matches
984,David García,es,DF,,Osasuna,La Liga,28,1994,29.8,34,20,22,12,0,19,22,86.4,3,28,13,15,45,79,151,Matches
985,Eric García,es,DF,MF,Barcelona,La Liga,21,2001,15.7,24,16,16,5,3,9,20,45.0,11,23,10,13,19,43,36,Matches
986,Fran Garcia,es,DF,,Rayo Vallecano,La Liga,22,1999,37.9,84,54,53,23,8,55,96,57.3,41,49,8,41,44,128,66,Matches
987,Joan García,es,GK,,Espanyol,La Liga,21,2001,1.0,0,0,0,0,0,0,0,,0,0,0,0,0,0,0,Matches
988,Raúl García,es,FW,MF,Athletic Club,La Liga,36,1986,10.7,12,8,3,4,5,5,15,33.3,10,13,1,12,6,18,9,Matches
989,Rubén García,es,FW,MF,Osasuna,La Liga,29,1993,12.9,20,11,12,4,4,7,24,29.2,17,14,1,13,12,32,13,Matches
990,Unai García,es,DF,,Osasuna,La Liga,30,1992,19.0,23,13,13,8,2,12,17,70.6,5,23,14,9,19,42,60,Matches
991,Alejandro Garnacho,ar,FW,MF,Manchester Utd,Premier League,18,2004,6.3,5,2,2,0,3,1,11,9.1,10,5,0,5,5,10,3,Matches
992,James Garner,eng,MF,DF,Everton,Premier League,21,2001,8.9,16,13,4,8,4,9,19,47.4,10,9,1,8,12,28,13,Matches
993,Felix Garreta,es,DF,,Betis,La Liga,18,2004,1.0,1,0,0,1,0,0,0,,0,1,1,0,1,2,4,Matches
994,Aleix Garrido,es,FW,,Barcelona,La Liga,18,2004,0.1,2,1,1,0,1,1,1,100.0,0,1,0,1,0,2,0,Matches
995,Sékou Gassama,sn,FW,,Valladolid,La Liga,27,1995,0.4,0,0,0,0,0,0,0,,0,0,0,0,0,0,0,Matches
996,Johan Gastien,fr,MF,,Clermont Foot,Ligue 1,34,1988,28.9,62,34,30,23,9,38,111,34.2,73,37,7,30,36,98,25,Matches
997,Federico Gatti,it,DF,,Juventus,it Serie A,24,1998,16.1,15,11,9,4,2,9,15,60.0,6,20,14,6,21,36,54,Matches
998,Gavi,es,MF,FW,Barcelona,La Liga,17,2004,28.1,47,31,7,30,10,21,55,38.2,34,32,5,27,18,65,22,Matches
999,Paulo Gazzaniga,ar,GK,,Girona,La Liga,30,1992,28.0,0,0,0,0,0,0,1,0.0,1,0,0,0,1,1,9,Matches
1000,David de Gea,es,GK,,Manchester Utd,Premier League,31,1990,38.0,0,0,0,0,0,0,1,0.0,1,0,0,0,1,1,15,Matches
1001,Dario Gebuhr,de,DF,,Eint Frankfurt,Bundesliga,19,2003,0.2,0,0,0,0,0,0,1,0.0,1,0,0,0,0,0,0,Matches
1002,Dennis Geiger,de,MF,,Hoffenheim,Bundesliga,24,1998,21.7,45,25,15,28,2,22,35,62.9,13,27,3,24,24,69,18,Matches
1003,Joe Gelhardt,eng,FW,,Leeds United,Premier League,20,2002,2.4,6,2,1,3,2,3,5,60.0,2,5,0,5,0,6,4,Matches
1004,Valentin Gendrey,fr,DF,,Lecce,it Serie A,22,2000,34.5,88,57,54,25,9,40,71,56.3,31,45,4,41,37,125,89,Matches
1005,Denis Genreau,au,MF,,Toulouse,Ligue 1,23,1999,7.3,35,13,16,12,7,13,31,41.9,18,16,1,15,8,43,9,Matches
1006,Yannick Gerhardt,de,MF,,Wolfsburg,Bundesliga,28,1994,20.7,29,15,10,11,8,12,30,40.0,18,26,5,21,7,36,24,Matches
1007,Valère Germain,fr,FW,MF,Montpellier,Ligue 1,32,1990,7.6,13,11,3,5,5,4,12,33.3,8,8,0,8,6,19,12,Matches
1008,Gerson,br,MF,,Marseille,Ligue 1,25,1997,4.6,6,4,1,4,1,3,5,60.0,2,5,0,5,2,8,4,Matches
1009,Ismaël Gharbi,es,MF,FW,Paris S-G,Ligue 1,18,2004,0.6,0,0,0,0,0,0,2,0.0,2,2,0,2,3,3,0,Matches
1010,Paolo Ghiglione,it,DF,,Cremonese,it Serie A,25,1997,7.9,16,11,10,3,3,10,23,43.5,13,9,4,5,4,20,12,Matches
1011,Saman Ghoddos,ir,MF,FW,Brentford,Premier League,28,1993,1.5,2,1,0,1,1,1,3,33.3,2,5,1,4,4,6,2,Matches
1012,Faouzi Ghoulam,dz,DF,,Angers,Ligue 1,31,1991,5.3,3,3,1,1,1,3,5,60.0,2,4,2,2,4,7,12,Matches
1013,Morgan Gibbs-White,eng,FW,MF,Wolves,Premier League,22,2000,2.0,3,1,3,0,0,2,4,50.0,2,2,0,2,1,4,3,Matches
1014,Morgan Gibbs-White,eng,MF,FW,Nott'ham Forest,Premier League,22,2000,33.0,26,14,7,7,12,11,33,33.3,22,23,4,19,14,40,15,Matches
1015,Niko Gießelmann,de,DF,,Union Berlin,Bundesliga,30,1991,14.5,21,11,9,9,3,13,31,41.9,18,17,5,12,9,30,28,Matches
1016,Samuel Gigot,fr,DF,,Marseille,Ligue 1,28,1993,20.9,46,24,22,21,3,12,15,80.0,3,24,7,17,45,91,85,Matches
1017,Rafał Gikiewicz,pl,GK,,Augsburg,Bundesliga,34,1987,23.0,2,2,2,0,0,2,3,66.7,1,0,0,0,0,2,15,Matches
1018,Bryan Gil,es,MF,FW,Tottenham,Premier League,21,2001,1.6,3,1,3,0,0,0,3,0.0,3,3,0,3,1,4,1,Matches
1019,Bryan Gil,es,FW,DF,Sevilla,La Liga,21,2001,10.2,22,11,11,7,4,10,23,43.5,13,10,0,10,8,30,10,Matches
1020,David Gil,es,GK,,Cádiz,La Liga,28,1994,4.0,0,0,0,0,0,0,0,,0,0,0,0,0,0,3,Matches
1021,Óscar Gil,es,DF,,Espanyol,La Liga,25,1997,28.4,63,37,38,16,9,32,61,52.5,29,51,18,33,31,94,55,Matches
1022,Mario Gila,es,DF,,Lazio,it Serie A,21,2000,1.0,3,1,3,0,0,0,1,0.0,1,0,0,0,3,6,3,Matches
1023,Billy Gilmour,sct,MF,,Brighton,Premier League,21,2001,5.6,5,2,2,2,1,2,8,25.0,6,5,2,3,6,11,5,Matches
1024,Álvaro Giménez,es,FW,,Cádiz,La Liga,31,1991,0.2,0,0,0,0,0,0,1,0.0,1,0,0,0,0,0,0,Matches
1025,Gvidas Gineitis,lt,MF,,Torino,it Serie A,18,2004,1.5,3,1,0,2,1,1,2,50.0,1,0,0,0,0,3,1,Matches
1026,Matthias Ginter,de,DF,,Freiburg,Bundesliga,28,1994,34.0,43,20,29,12,2,26,40,65.0,14,40,24,16,35,78,153,Matches
1027,Andrei Girotto,br,DF,MF,Nantes,Ligue 1,30,1992,35.0,122,73,71,45,6,74,132,56.1,58,55,24,31,73,195,176,Matches
1028,Olivier Giroud,fr,FW,,Milan,it Serie A,35,1986,23.8,8,5,2,4,2,2,10,20.0,8,11,3,8,3,11,23,Matches
1029,Jamie Gittens,eng,FW,MF,Dortmund,Bundesliga,17,2004,5.9,8,4,2,5,1,2,7,28.6,5,1,0,1,1,9,2,Matches
1030,Serge Gnabry,de,FW,MF,Bayern Munich,Bundesliga,27,1995,21.6,35,23,11,14,10,17,43,39.5,26,24,1,23,11,46,5,Matches
1031,Wilfried Gnonto,it,FW,MF,Leeds United,Premier League,18,2003,15.0,27,17,7,15,5,10,30,33.3,20,24,1,23,5,32,7,Matches
1032,Ben Godfrey,eng,DF,,Everton,Premier League,24,1998,8.9,20,11,13,5,2,11,29,37.9,18,12,6,6,8,28,33,Matches
1033,Pierluigi Gollini,it,GK,,Fiorentina,it Serie A,27,1995,3.0,1,0,1,0,0,1,1,100.0,0,0,0,0,0,1,2,Matches
1034,Pierluigi Gollini,it,GK,,Napoli,it Serie A,27,1995,4.0,0,0,0,0,0,0,0,,0,0,0,0,0,0,1,Matches
1035,Aleksandr Golovin,ru,MF,FW,Monaco,Ligue 1,26,1996,27.4,62,36,19,32,11,28,72,38.9,44,28,1,27,37,99,10,Matches
1036,André Gomes,pt,MF,,Lille,Ligue 1,29,1993,18.1,37,19,12,17,8,19,52,36.5,33,20,5,15,9,46,16,Matches
1037,Angel Gomes,eng,MF,,Lille,Ligue 1,21,2000,31.3,41,19,12,21,8,18,49,36.7,31,22,2,20,13,54,11,Matches
1038,João Gomes,br,MF,,Wolves,Premier League,21,2001,7.3,29,13,14,14,1,13,23,56.5,10,12,3,9,4,33,11,Matches
1039,Toti Gomes,pt,DF,,Wolves,Premier League,23,1999,10.9,15,9,11,4,0,9,13,69.2,4,16,8,8,11,26,51,Matches
1040,Dani Gómez,es,MF,FW,Espanyol,La Liga,24,1998,1.0,2,1,1,1,0,1,2,50.0,1,0,0,0,1,3,0,Matches
1041,Joe Gomez,eng,DF,,Liverpool,Premier League,25,1997,16.3,28,21,15,11,2,11,19,57.9,8,17,11,6,24,52,51,Matches
1042,Maxi Gómez,uy,FW,,Valencia,La Liga,25,1996,1.2,0,0,0,0,0,0,0,,0,0,0,0,0,0,2,Matches
1043,Moi Gómez,es,MF,FW,Osasuna,La Liga,28,1994,27.3,26,17,9,14,3,15,32,46.9,17,15,3,12,10,36,5,Matches
1044,Papu Gómez,ar,FW,MF,Sevilla,La Liga,34,1988,11.8,6,4,3,3,0,2,10,20.0,8,8,1,7,4,10,5,Matches
1045,Sergi Gómez,es,DF,,Espanyol,La Liga,30,1992,26.0,29,16,20,9,0,18,22,81.8,4,33,19,14,27,56,125,Matches
1046,Sergio Gómez,es,DF,MF,Manchester City,Premier League,21,2000,3.9,9,4,6,1,2,5,8,62.5,3,5,3,2,2,11,9,Matches
1047,Antonio Gomis,es,GK,,Atlético Madrid,La Liga,19,2003,0.1,0,0,0,0,0,0,0,,0,0,0,0,0,0,0,Matches
1048,Maxime Gonalons,fr,MF,,Clermont Foot,Ligue 1,33,1989,16.1,52,32,25,21,6,25,53,47.2,28,21,1,20,20,72,7,Matches
1049,Diego González,es,DF,,Elche,La Liga,27,1995,10.6,12,7,9,3,0,7,11,63.6,4,14,12,2,7,19,50,Matches
1050,Édgar González,es,DF,,Betis,La Liga,25,1997,19.7,28,19,18,7,3,14,27,51.9,13,12,9,3,21,49,120,Matches
1051,Giovanni González,uy,DF,,Mallorca,La Liga,27,1994,10.3,16,8,11,2,3,9,22,40.9,13,8,2,6,7,23,22,Matches
1052,Joan Gonzàlez,es,MF,,Lecce,it Serie A,20,2002,24.4,48,28,20,18,10,17,51,33.3,34,37,8,29,16,64,28,Matches
1053,Nicolás González,ar,FW,MF,Fiorentina,it Serie A,24,1998,15.0,17,10,3,10,4,5,16,31.3,11,14,0,14,4,21,6,Matches
1054,Nicolás González,es,MF,,Valencia,La Liga,20,2002,15.6,27,15,11,13,3,9,25,36.0,16,21,7,14,19,46,16,Matches
1055,Oumar Gonzalez,cm,DF,,Ajaccio,Ligue 1,24,1998,28.6,51,28,34,13,4,23,37,62.2,14,32,11,21,52,103,82,Matches
1056,Roberto González,es,FW,MF,Betis,La Liga,21,2001,0.6,0,0,0,0,0,0,1,0.0,1,0,0,0,1,1,0,Matches
1057,Jacek Góralski,pl,MF,,Bochum,Bundesliga,29,1992,1.6,6,3,3,3,0,4,6,66.7,2,4,0,4,3,9,5,Matches
1058,Anthony Gordon,eng,FW,MF,Newcastle Utd,Premier League,21,2001,5.4,14,12,5,7,2,9,20,45.0,11,9,1,8,2,16,1,Matches
1059,Anthony Gordon,eng,FW,,Everton,Premier League,21,2001,12.2,34,22,17,10,7,8,24,33.3,16,19,0,19,4,38,11,Matches
1060,Leon Goretzka,de,MF,,Bayern Munich,Bundesliga,27,1995,19.2,43,24,21,16,6,27,48,56.3,21,40,3,37,30,73,32,Matches
1061,Andoni Gorosabel,es,DF,,Real Sociedad,La Liga,25,1996,19.0,41,25,23,9,9,26,43,60.5,17,21,2,19,17,58,23,Matches
1062,Robin Gosens,de,DF,,Inter,it Serie A,28,1994,13.2,34,18,15,10,9,15,25,60.0,10,16,2,14,23,57,15,Matches
1063,Mario Götze,de,MF,,Eint Frankfurt,Bundesliga,30,1992,30.4,42,25,13,22,7,14,47,29.8,33,25,0,25,13,55,12,Matches
1064,Amine Gouiri,dz,FW,MF,Nice,Ligue 1,22,2000,2.5,1,1,1,0,0,0,1,0.0,1,1,0,1,0,1,3,Matches
1065,Amine Gouiri,dz,FW,MF,Rennes,Ligue 1,22,2000,28.0,42,25,14,16,12,14,33,42.4,19,21,0,21,12,54,10,Matches
1066,Jeffrey Gouweleeuw,nl,DF,,Augsburg,Bundesliga,31,1991,31.1,42,27,19,17,6,24,49,49.0,25,41,23,18,50,92,141,Matches
1067,Jonathan Gradit,fr,DF,,Lens,Ligue 1,29,1992,31.4,62,40,30,25,7,31,53,58.5,22,40,26,14,38,100,83,Matches
1068,José Gragera,es,MF,DF,Espanyol,La Liga,21,2000,5.1,19,9,11,6,2,6,11,54.5,5,10,4,6,7,26,18,Matches
1069,Alberto Grassi,it,MF,,Empoli,it Serie A,27,1995,13.3,26,21,13,13,0,15,24,62.5,9,23,12,11,27,53,45,Matches
1070,Ryan Gravenberch,nl,MF,,Bayern Munich,Bundesliga,20,2002,6.4,17,8,4,10,3,7,13,53.8,6,9,1,8,9,26,10,Matches
1071,Andrew Gravillon,gp,DF,,Torino,it Serie A,24,1998,3.5,3,3,0,3,0,0,0,,0,4,2,2,9,12,16,Matches
1072,Andrew Gravillon,gp,DF,,Reims,Ligue 1,24,1998,11.5,16,8,9,6,1,8,13,61.5,5,18,9,9,21,37,36,Matches
1073,Demarai Gray,jm,FW,MF,Everton,Premier League,26,1996,27.9,33,24,9,14,10,17,31,54.8,14,23,3,20,13,46,18,Matches
1074,Adrian Grbić,at,MF,FW,Lorient,Ligue 1,25,1996,0.3,0,0,0,0,0,0,1,0.0,1,3,0,3,0,0,0,Matches
1075,Ivo Grbić,hr,GK,,Atlético Madrid,La Liga,26,1996,10.2,0,0,0,0,0,0,0,,0,0,0,0,0,0,9,Matches
1076,Jack Grealish,eng,FW,,Manchester City,Premier League,26,1995,22.8,25,16,10,12,3,13,23,56.5,10,17,3,14,7,32,9,Matches
1077,Sam Greenwood,eng,MF,FW,Leeds United,Premier League,20,2002,4.7,15,7,7,8,0,8,21,38.1,13,10,2,8,1,16,1,Matches
1078,Michael Gregoritsch,at,FW,,Freiburg,Bundesliga,28,1994,23.9,19,12,6,9,4,3,21,14.3,18,23,4,19,5,24,10,Matches
1079,Dominik Greif,sk,GK,,Mallorca,La Liga,25,1997,1.0,0,0,0,0,0,0,0,,0,0,0,0,0,0,0,Matches
1080,Leo Greiml,at,DF,,Schalke 04,Bundesliga,21,2001,4.0,10,5,4,5,1,5,12,41.7,7,7,3,4,3,13,16,Matches
1081,Clément Grenier,fr,MF,,Mallorca,La Liga,31,1991,8.0,20,8,6,12,2,10,20,50.0,10,9,1,8,6,26,7,Matches
1082,Antoine Griezmann,fr,FW,MF,Atlético Madrid,La Liga,31,1991,31.8,49,34,15,23,11,20,66,30.3,46,34,3,31,24,73,31,Matches
1083,Vincenzo Grifo,it,MF,FW,Freiburg,Bundesliga,29,1993,26.8,29,16,6,15,8,13,31,41.9,18,18,1,17,19,48,19,Matches
1084,Lennart Grill,de,GK,,Union Berlin,Bundesliga,23,1999,5.0,0,0,0,0,0,0,1,0.0,1,0,0,0,0,0,1,Matches
1085,Christian Groß,de,MF,,Werder Bremen,Bundesliga,33,1989,21.0,56,25,20,34,2,29,60,48.3,31,20,5,15,23,79,38,Matches
1086,Pascal Groß,de,MF,DF,Brighton,Premier League,31,1991,36.0,59,38,23,27,9,25,55,45.5,30,32,10,22,13,72,21,Matches
1087,Brajan Gruda,de,MF,,Mainz 05,Bundesliga,18,2004,0.0,0,0,0,0,0,0,0,,0,0,0,0,0,0,0,Matches
1088,Ilia Gruev,bg,MF,,Werder Bremen,Bundesliga,22,2000,17.6,44,27,16,25,3,18,31,58.1,13,23,6,17,22,66,21,Matches
1089,Carlos Gruezo,ec,MF,,Augsburg,Bundesliga,27,1995,10.7,21,12,12,9,0,9,16,56.3,7,13,4,9,10,31,15,Matches
1090,Vicente Guaita,es,GK,,Crystal Palace,Premier League,35,1987,27.0,0,0,0,0,0,0,0,,0,0,0,0,0,0,9,Matches
1091,Andrés Guardado,mx,MF,,Betis,La Liga,35,1986,15.3,41,25,17,20,4,18,43,41.9,25,14,5,9,23,64,29,Matches
1092,Sergi Guardiola,es,FW,,Valladolid,La Liga,31,1991,5.6,12,7,6,5,1,2,4,50.0,2,6,0,6,2,14,7,Matches
1093,Sergi Guardiola,es,FW,,Cádiz,La Liga,31,1991,12.9,9,7,0,6,3,3,12,25.0,9,5,0,5,3,12,7,Matches
1094,Nemanja Gudelj,rs,DF,MF,Sevilla,La Liga,30,1991,30.9,43,33,22,18,3,20,33,60.6,13,39,29,10,34,77,102,Matches
1095,Gabriel Gudmundsson,se,DF,FW,Lille,Ligue 1,23,1999,9.3,19,11,7,10,2,12,22,54.5,10,11,2,9,10,29,20,Matches
1096,Gonçalo Guedes,pt,FW,MF,Wolves,Premier League,25,1996,7.9,8,6,4,3,1,5,8,62.5,3,4,0,4,1,9,2,Matches
1097,Axel Gueguin,fr,FW,MF,Montpellier,Ligue 1,17,2005,0.3,0,0,0,0,0,0,0,,0,1,0,1,0,0,0,Matches
1098,Marc Guéhi,eng,DF,,Crystal Palace,Premier League,22,2000,37.0,52,27,39,11,2,26,42,61.9,16,45,24,21,45,97,134,Matches
1099,Mattéo Guendouzi,fr,MF,,Marseille,Ligue 1,23,1999,23.4,39,18,9,21,9,14,38,36.8,24,12,5,7,21,60,18,Matches
1100,Javier Guerra,es,MF,,Valencia,La Liga,19,2003,6.7,16,13,7,4,5,9,20,45.0,11,8,1,7,11,27,9,Matches
1101,Raphaël Guerreiro,pt,DF,MF,Dortmund,Bundesliga,28,1993,25.4,36,20,13,15,8,21,34,61.8,13,21,2,19,36,72,23,Matches
1102,Axel Guessand,fr,DF,,Udinese,it Serie A,17,2004,0.9,2,1,2,0,0,1,2,50.0,1,1,0,1,2,4,3,Matches
1103,Evann Guessand,ci,FW,MF,Nantes,Ligue 1,21,2001,14.0,24,16,8,13,3,6,12,50.0,6,17,1,16,9,33,6,Matches
1104,Ander Guevara,es,MF,,Real Sociedad,La Liga,25,1997,2.5,5,2,2,2,1,1,4,25.0,3,6,1,5,2,7,3,Matches
1105,Pape Gueye,sn,MF,,Sevilla,La Liga,23,1999,13.0,37,22,13,21,3,16,33,48.5,17,21,5,16,22,59,10,Matches
1106,Pape Gueye,sn,MF,DF,Marseille,Ligue 1,23,1999,5.5,18,7,10,7,1,7,15,46.7,8,9,2,7,9,27,2,Matches
1107,Josuha Guilavogui,fr,DF,MF,Wolfsburg,Bundesliga,31,1990,13.1,18,11,7,10,1,6,17,35.3,11,19,13,6,23,41,52,Matches
1108,Frederic Guilbert,fr,DF,,Strasbourg,Ligue 1,27,1994,16.2,47,29,18,23,6,25,43,58.1,18,24,3,21,43,90,33,Matches
1109,Hugo Guillamón,es,MF,,Valencia,La Liga,22,2000,18.1,20,12,10,8,2,8,24,33.3,16,14,2,12,19,39,30,Matches
1110,Bruno Guimarães,br,MF,,Newcastle Utd,Premier League,24,1997,30.3,78,40,27,46,5,38,65,58.5,27,28,4,24,36,114,22,Matches
1111,Serhou Guirassy,gn,MF,,Rennes,Ligue 1,26,1996,0.3,0,0,0,0,0,0,0,,0,0,0,0,0,0,0,Matches
1112,Serhou Guirassy,gn,FW,,Stuttgart,Bundesliga,26,1996,18.3,4,1,2,2,0,1,2,50.0,1,7,2,5,0,4,14,Matches
1113,Rafik Guitane,fr,FW,,Reims,Ligue 1,23,1999,0.0,0,0,0,0,0,0,0,,0,0,0,0,0,0,1,Matches
1114,Péter Gulácsi,hu,GK,,RB Leipzig,Bundesliga,32,1990,6.0,0,0,0,0,0,0,0,,0,0,0,0,0,0,2,Matches
1115,Manuel Gulde,de,DF,,Freiburg,Bundesliga,31,1991,7.1,14,8,10,4,0,2,4,50.0,2,5,1,4,19,33,25,Matches
1116,Gerard Gumbau,es,MF,,Elche,La Liga,27,1994,30.4,44,25,17,23,4,18,51,35.3,33,32,8,24,28,72,40,Matches
1117,Robert Gumny,pl,DF,,Augsburg,Bundesliga,24,1998,22.4,34,24,13,15,6,11,27,40.7,16,21,7,14,26,60,62,Matches
1118,İlkay Gündoğan,de,MF,,Manchester City,Premier League,31,1990,26.1,30,18,7,13,10,12,34,35.3,22,18,3,15,20,50,13,Matches
1119,Christian Günter,de,DF,MF,Freiburg,Bundesliga,29,1993,30.5,29,21,18,9,2,13,43,30.2,30,22,4,18,16,45,41,Matches
1120,Koray Günter,de,DF,,Hellas Verona,it Serie A,27,1994,11.1,10,6,1,8,1,4,7,57.1,3,24,15,9,30,40,46,Matches
1121,Koray Günter,de,DF,,Sampdoria,it Serie A,27,1994,8.6,10,8,6,4,0,6,9,66.7,3,10,5,5,11,21,46,Matches
1122,Gorka Guruzeta,es,FW,,Athletic Club,La Liga,25,1996,15.8,24,20,6,12,6,11,24,45.8,13,23,2,21,4,28,8,Matches
1123,Malo Gusto,fr,DF,,Lyon,Ligue 1,19,2003,17.7,42,26,23,11,8,21,43,48.8,22,22,5,17,28,70,23,Matches
1124,Raúl Guti,es,MF,,Elche,La Liga,25,1996,12.4,18,12,8,9,1,8,18,44.4,10,10,3,7,8,26,6,Matches
1125,Miguel Gutiérrez,es,DF,,Girona,La Liga,21,2001,26.6,41,23,23,13,5,23,37,62.2,14,23,5,18,18,59,42,Matches
1126,Joško Gvardiol,hr,DF,,RB Leipzig,Bundesliga,20,2002,24.1,23,17,15,8,0,9,22,40.9,13,34,17,17,34,57,76,Matches
1127,Darko Gyabi,eng,FW,,Leeds United,Premier League,18,2004,0.1,2,2,1,1,0,0,0,,0,2,0,2,0,2,0,Matches
1128,Emmanuel Gyasi,gh,FW,DF,Spezia,it Serie A,28,1994,31.2,24,15,11,10,3,9,36,25.0,27,24,6,18,8,32,26,Matches
1129,Norbert Gyömbér,sk,DF,,Salernitana,it Serie A,30,1992,19.3,32,23,25,6,1,16,24,66.7,8,33,22,11,35,67,92,Matches
1130,Christian Gytkjær,dk,FW,MF,Monza,it Serie A,32,1990,6.2,6,2,1,4,1,2,5,40.0,3,6,1,5,0,6,2,Matches
1131,Erling Haaland,no,FW,,Manchester City,Premier League,22,2000,30.8,3,2,0,2,1,1,5,20.0,4,12,4,8,3,6,14,Matches
1132,Nicolas Haas,ch,MF,,Empoli,it Serie A,26,1996,12.8,27,13,16,6,5,12,24,50.0,12,16,4,12,8,35,27,Matches
1133,Janik Haberer,de,MF,,Union Berlin,Bundesliga,28,1994,24.3,29,17,8,18,3,17,48,35.4,31,35,2,33,14,43,25,Matches
1134,Alexander Hack,de,DF,,Mainz 05,Bundesliga,28,1993,12.6,30,18,21,9,0,19,33,57.6,14,18,5,13,24,54,45,Matches
1135,Munir El Haddadi,ma,MF,FW,Getafe,La Liga,26,1995,12.8,12,7,3,7,2,2,10,20.0,8,23,2,21,9,21,7,Matches
1136,Jaouen Hadjam,dz,DF,,Nantes,Ligue 1,19,2003,8.9,27,21,13,9,5,16,25,64.0,9,10,3,7,12,39,12,Matches
1137,Dennis Hadzikadunic,ba,DF,,Mallorca,La Liga,24,1998,6.8,9,6,4,5,0,4,4,100.0,0,5,4,1,3,12,27,Matches
1138,André Hahn,de,FW,MF,Augsburg,Bundesliga,31,1990,4.3,9,5,4,4,1,8,12,66.7,4,9,2,7,4,13,14,Matches
1139,Amadou Haidara,ml,MF,,RB Leipzig,Bundesliga,24,1998,15.9,25,11,15,10,0,13,34,38.2,21,26,6,20,26,51,20,Matches
1140,Massadio Haïdara,ml,DF,MF,Lens,Ligue 1,29,1992,18.6,24,16,9,9,6,12,24,50.0,12,26,9,17,36,60,39,Matches
1141,Achraf Hakimi,ma,DF,MF,Paris S-G,Ligue 1,23,1998,22.8,54,34,19,20,15,31,59,52.5,28,34,2,32,16,70,19,Matches
1142,Lewis Hall,eng,DF,,Chelsea,Premier League,17,2004,7.3,23,12,19,4,0,15,22,68.2,7,8,0,8,11,34,11,Matches
1143,Sébastien Haller,ci,FW,,Dortmund,Bundesliga,28,1994,13.6,5,4,2,1,2,0,4,0.0,4,8,0,8,1,6,10,Matches
1144,Marcel Halstenberg,de,DF,,RB Leipzig,Bundesliga,30,1991,17.3,40,21,20,15,5,23,41,56.1,18,22,1,21,21,61,29,Matches
1145,Mathis Hamdi,fr,DF,,Troyes,Ligue 1,18,2003,0.8,0,0,0,0,0,0,1,0.0,1,0,0,0,1,1,1,Matches
1146,Ben Hamed Touré,ci,FW,,Ajaccio,Ligue 1,18,2003,2.3,4,4,2,2,0,1,5,20.0,4,2,0,2,1,5,4,Matches
1147,Romain Hamouma,fr,FW,MF,Ajaccio,Ligue 1,35,1987,12.0,8,3,3,3,2,3,6,50.0,3,8,0,8,2,10,2,Matches
1148,Saïd Hamulic,ba,FW,,Toulouse,Ligue 1,21,2000,1.2,0,0,0,0,0,0,0,,0,0,0,0,0,0,0,Matches
1149,Andreas Hanche-Olsen,no,DF,,Mainz 05,Bundesliga,25,1997,16.6,35,23,24,7,4,22,39,56.4,17,16,8,8,33,68,77,Matches
1150,Samir Handanović,si,GK,,Inter,it Serie A,38,1984,13.7,0,0,0,0,0,0,0,,0,0,0,0,0,0,5,Matches
1151,Genki Haraguchi,jp,MF,,Stuttgart,Bundesliga,31,1991,8.3,16,7,7,7,2,4,16,25.0,12,13,2,11,8,24,6,Matches
1152,Genki Haraguchi,jp,MF,,Union Berlin,Bundesliga,31,1991,5.5,12,8,1,10,1,3,9,33.3,6,7,1,6,3,15,9,Matches
1153,Amine Harit,ma,MF,FW,Marseille,Ligue 1,25,1997,5.7,6,4,0,3,3,3,8,37.5,5,4,1,3,4,10,6,Matches
1154,Luke Harris,wls,MF,FW,Fulham,Premier League,17,2005,0.1,0,0,0,0,0,0,0,,0,0,0,0,0,0,0,Matches
1155,Jack Harrison,eng,FW,MF,Leeds United,Premier League,25,1996,30.1,41,17,5,15,21,12,52,23.1,40,47,2,45,22,63,25,Matches
1156,Abdou Harroui,nl,MF,,Sassuolo,it Serie A,24,1998,7.2,17,6,6,7,4,2,7,28.6,5,6,1,5,2,19,10,Matches
1157,Makoto Hasebe,jp,DF,,Eint Frankfurt,Bundesliga,38,1984,14.5,18,12,16,2,0,7,22,31.8,15,22,9,13,17,35,45,Matches
1158,Haissem Hassan,fr,FW,MF,Villarreal,La Liga,20,2002,0.6,0,0,0,0,0,0,2,0.0,2,0,0,0,1,1,0,Matches
1159,Hans Hateboer,nl,DF,,Atalanta,it Serie A,28,1994,15.5,21,13,11,8,2,11,27,40.7,16,23,4,19,12,33,25,Matches
1160,Kai Havertz,de,FW,MF,Chelsea,Premier League,23,1999,28.5,34,16,4,20,10,10,30,33.3,20,28,0,28,7,41,41,Matches
1161,Eden Hazard,be,FW,,Real Madrid,La Liga,31,1991,2.2,0,0,0,0,0,0,2,0.0,2,1,0,1,1,1,0,Matches
1162,Thorgan Hazard,be,FW,DF,Dortmund,Bundesliga,29,1993,5.2,17,6,5,11,1,12,17,70.6,5,6,0,6,5,22,5,Matches
1163,Rhys Healey,wls,FW,,Toulouse,Ligue 1,27,1994,0.7,0,0,0,0,0,0,0,,0,0,0,0,0,0,0,Matches
1164,Jan Paul van Hecke,nl,DF,,Brighton,Premier League,22,2000,3.3,8,6,3,4,1,5,5,100.0,0,8,5,3,6,14,9,Matches
1165,Jonas Hector,de,DF,,Köln,Bundesliga,32,1990,31.4,112,66,59,43,10,66,113,58.4,47,61,9,52,39,151,74,Matches
1166,Hwang Hee-chan,kr,FW,MF,Wolves,Premier League,26,1996,12.6,20,9,7,8,5,6,20,30.0,14,18,2,16,5,25,5,Matches
1167,Gauthier Hein,fr,MF,FW,Auxerre,Ligue 1,25,1996,20.8,27,20,13,11,3,18,48,37.5,30,10,0,10,6,33,10,Matches
1168,Dominique Heintz,de,DF,,Bochum,Bundesliga,28,1993,8.8,13,9,5,7,1,6,17,35.3,11,11,7,4,12,25,34,Matches
1169,Dean Henderson,eng,GK,,Nott'ham Forest,Premier League,25,1997,18.0,0,0,0,0,0,0,0,,0,0,0,0,0,0,12,Matches
1170,Jordan Henderson,eng,MF,,Liverpool,Premier League,32,1990,23.0,32,23,10,18,4,15,36,41.7,21,21,3,18,21,53,16,Matches
1171,Liam Henderson,sct,MF,,Empoli,it Serie A,26,1996,11.2,13,10,6,5,2,4,21,19.0,17,10,2,8,10,23,10,Matches
1172,Jack Hendry,sct,DF,,Cremonese,it Serie A,27,1995,2.4,0,0,0,0,0,0,1,0.0,1,2,1,1,1,1,7,Matches
1173,Wayne Hennessey,wls,GK,,Nott'ham Forest,Premier League,35,1987,3.0,1,0,1,0,0,1,1,100.0,0,0,0,0,0,1,2,Matches
1174,Benjamin Henrichs,de,DF,MF,RB Leipzig,Bundesliga,25,1997,24.3,73,46,41,29,3,43,66,65.2,23,48,4,44,35,108,46,Matches
1175,Henrique,br,DF,FW,Lyon,Ligue 1,28,1994,4.0,9,4,3,2,4,6,13,46.2,7,3,1,2,5,14,8,Matches
1176,Luiz Henrique,br,FW,,Betis,La Liga,21,2001,20.1,48,34,27,15,6,20,44,45.5,24,22,0,22,14,62,17,Matches
1177,Matheus Henrique,br,MF,,Sassuolo,it Serie A,24,1997,21.6,26,12,9,11,6,12,24,50.0,12,15,4,11,12,38,10,Matches
1178,Rico Henry,eng,DF,,Brentford,Premier League,25,1997,36.0,57,31,20,28,9,22,41,53.7,19,29,8,21,30,87,84,Matches
1179,Thomas Henry,fr,FW,,Hellas Verona,it Serie A,27,1994,11.4,5,3,1,1,3,1,5,20.0,4,6,2,4,0,5,14,Matches
1180,Christophe Hérelle,mq,DF,,Brest,Ligue 1,29,1992,11.8,10,4,7,2,1,4,13,30.8,9,16,11,5,20,30,48,Matches
1181,Mario Hermoso,es,DF,,Atlético Madrid,La Liga,27,1995,23.4,22,15,14,6,2,9,30,30.0,21,19,9,10,19,41,85,Matches
1182,Javi Hernández,es,DF,,Girona,La Liga,24,1998,12.4,21,12,12,7,2,13,21,61.9,8,10,5,5,7,28,38,Matches
1183,Aridane Hernández,es,DF,,Osasuna,La Liga,33,1989,19.9,21,15,17,4,0,12,25,48.0,13,34,21,13,28,49,96,Matches
1184,Lucas Hernández,fr,DF,,Bayern Munich,Bundesliga,26,1996,5.3,6,4,3,3,0,5,6,83.3,1,2,1,1,5,11,7,Matches
1185,Luis Hernández,es,DF,,Cádiz,La Liga,33,1989,35.0,33,21,25,7,1,22,36,61.1,14,31,24,7,31,64,145,Matches
1186,Mario Hernández,es,DF,,Rayo Vallecano,La Liga,23,1999,1.1,3,2,2,1,0,3,7,42.9,4,2,0,2,2,5,0,Matches
1187,Theo Hernández,fr,DF,,Milan,it Serie A,24,1997,30.8,43,24,27,15,1,22,38,57.9,16,34,7,27,21,64,35,Matches
1188,Jorge Herrando,es,DF,,Osasuna,La Liga,21,2001,0.3,0,0,0,0,0,0,0,,0,1,0,1,0,0,3,Matches
1189,Ander Herrera,es,MF,,Athletic Club,La Liga,32,1989,7.7,18,10,8,7,3,6,18,33.3,12,12,3,9,11,29,12,Matches
1190,Sergio Herrera,es,GK,,Osasuna,La Liga,29,1993,17.0,2,0,2,0,0,2,2,100.0,0,1,0,1,1,3,6,Matches
1191,Yangel Herrera,ve,MF,FW,Girona,La Liga,24,1998,10.7,26,9,9,14,3,6,15,40.0,9,14,1,13,4,30,12,Matches
1192,Patrick Herrmann,de,FW,MF,Gladbach,Bundesliga,31,1991,1.8,6,2,4,1,1,2,4,50.0,2,2,0,2,2,8,1,Matches
1193,Son Heung-min,kr,MF,FW,Tottenham,Premier League,30,1992,32.1,24,12,7,8,9,9,30,30.0,21,23,2,21,13,37,6,Matches
1194,Aaron Hickey,sct,DF,,Brentford,Premier League,20,2002,21.3,38,26,27,11,0,18,32,56.3,14,18,7,11,17,55,32,Matches
1195,Isak Hien,se,DF,,Hellas Verona,it Serie A,23,1999,29.0,73,36,54,19,0,38,61,62.3,23,40,17,23,31,104,92,Matches
1196,Omar El Hilali,ma,DF,MF,Espanyol,La Liga,18,2003,1.0,3,2,3,0,0,1,2,50.0,1,1,0,1,1,4,6,Matches
1197,Piero Hincapié,ec,DF,MF,Leverkusen,Bundesliga,20,2002,27.3,51,34,28,20,3,25,38,65.8,13,41,20,21,31,82,83,Matches
1198,Jack Hinshelwood,eng,FW,,Brighton,Premier League,17,2005,0.0,1,0,1,0,0,0,0,,0,0,0,0,0,1,0,Matches
1199,Morten Hjulmand,dk,MF,,Lecce,it Serie A,23,1999,32.9,90,52,49,40,1,37,67,55.2,30,43,11,32,72,162,54,Matches
1200,Adam Hložek,cz,FW,MF,Leverkusen,Bundesliga,20,2002,14.3,9,4,4,3,2,3,9,33.3,6,9,2,7,6,15,9,Matches
1201,Joseph Hodge,ie,MF,,Wolves,Premier League,19,2002,1.9,5,2,1,3,1,3,4,75.0,1,5,0,5,0,5,2,Matches
1202,Nicolas Höfler,de,MF,,Freiburg,Bundesliga,32,1990,31.3,66,35,28,35,3,27,61,44.3,34,40,13,27,58,124,49,Matches
1203,Jonas Hofmann,de,FW,MF,Gladbach,Bundesliga,30,1992,29.8,31,16,17,8,6,15,52,28.8,37,36,2,34,16,47,21,Matches
1204,Philipp Hofmann,de,FW,,Bochum,Bundesliga,29,1993,29.2,18,11,0,13,5,5,12,41.7,7,20,8,12,6,24,48,Matches
1205,Rob Holding,eng,DF,,Arsenal,Premier League,26,1995,6.3,8,5,4,4,0,3,6,50.0,3,6,5,1,3,11,27,Matches
1206,Lucas Höler,de,FW,MF,Freiburg,Bundesliga,28,1994,16.7,19,14,5,7,7,6,22,27.3,16,22,5,17,10,29,17,Matches
1207,Mason Holgate,eng,DF,,Everton,Premier League,25,1996,5.6,11,7,8,3,0,3,11,27.3,8,7,3,4,7,18,28,Matches
1208,Emil Holm,se,DF,,Spezia,it Serie A,22,2000,15.5,26,15,13,8,5,16,31,51.6,15,21,6,15,9,35,41,Matches
1209,Noah Holm,no,FW,MF,Reims,Ligue 1,21,2001,2.2,6,4,2,2,2,2,5,40.0,3,0,0,0,0,6,5,Matches
1210,Gerrit Holtmann,ph,FW,MF,Bochum,Bundesliga,27,1995,10.5,14,7,6,7,1,12,21,57.1,9,15,1,14,2,16,4,Matches
1211,Martin Hongla,cm,MF,,Hellas Verona,it Serie A,24,1998,5.8,8,5,4,4,0,5,5,100.0,0,7,1,6,6,14,9,Matches
1212,Martin Hongla,cm,DF,MF,Valladolid,La Liga,24,1998,14.5,18,13,13,5,0,11,21,52.4,10,15,12,3,8,26,46,Matches
1213,Franck Honorat,fr,FW,MF,Brest,Ligue 1,25,1996,28.2,41,29,20,8,13,19,34,55.9,15,22,2,20,21,62,18,Matches
1214,Jannes Horn,de,DF,FW,Bochum,Bundesliga,25,1997,0.7,2,1,1,1,0,1,1,100.0,0,1,0,1,3,5,2,Matches
1215,Cédric Hountondji,bj,DF,,Angers,Ligue 1,28,1994,34.4,50,36,31,17,2,19,29,65.5,10,44,22,22,59,109,132,Matches
1216,Ilyes Housni,fr,FW,,Paris S-G,Ligue 1,17,2005,0.1,1,1,1,0,0,1,1,100.0,0,0,0,0,0,1,0,Matches
1217,Lukáš Hrádecký,fi,GK,,Leverkusen,Bundesliga,32,1989,33.0,0,0,0,0,0,0,0,,0,0,0,0,0,0,3,Matches
1218,Petko Hristov,bg,DF,,Spezia,it Serie A,23,1999,4.1,6,4,2,4,0,5,8,62.5,3,4,2,2,4,10,12,Matches
1219,Ajdin Hrustic,au,MF,,Hellas Verona,it Serie A,26,1996,2.5,2,1,1,1,0,1,2,50.0,1,2,0,2,0,2,2,Matches
1220,Timo Hübers,de,DF,,Köln,Bundesliga,26,1996,28.4,43,28,35,8,0,24,52,46.2,28,27,13,14,58,101,153,Matches
1221,Callum Hudson-Odoi,eng,FW,MF,Leverkusen,Bundesliga,21,2000,6.7,5,3,4,0,1,1,1,100.0,0,0,0,0,2,7,4,Matches
1222,Will Hughes,eng,MF,,Crystal Palace,Premier League,27,1995,9.4,29,16,11,16,2,11,20,55.0,9,16,7,9,16,45,9,Matches
1223,Mats Hummels,de,DF,,Dortmund,Bundesliga,33,1988,22.4,62,34,38,22,2,32,55,58.2,23,30,16,14,33,95,100,Matches
1224,Adrien Hunou,fr,MF,FW,Angers,Ligue 1,28,1994,24.8,39,20,17,16,6,16,45,35.6,29,35,0,35,7,46,7,Matches
1225,Denis Huseinbasic,ba,MF,FW,Köln,Bundesliga,21,2001,8.8,23,9,8,11,4,10,25,40.0,15,16,2,14,4,27,5,Matches
1226,Omari Hutchinson,eng,FW,,Chelsea,Premier League,18,2003,0.3,0,0,0,0,0,0,0,,0,0,0,0,1,1,0,Matches
1227,Elseid Hysaj,al,DF,,Lazio,it Serie A,28,1994,22.2,39,23,24,11,4,23,41,56.1,18,31,7,24,20,59,42,Matches
1228,Pierre Højbjerg,dk,MF,,Tottenham,Premier League,26,1995,34.8,56,30,28,22,6,26,67,38.8,41,46,17,29,49,105,64,Matches
1229,Rasmus Højlund,dk,FW,,Atalanta,it Serie A,19,2003,20.4,4,3,0,2,2,1,6,16.7,5,9,1,8,1,5,5,Matches
1230,Iago,br,DF,MF,Augsburg,Bundesliga,25,1997,17.8,34,16,20,10,4,11,29,37.9,18,18,5,13,17,51,53,Matches
1231,Pablo Ibáñez,es,MF,,Osasuna,La Liga,23,1998,11.8,29,13,7,17,5,12,35,34.3,23,19,2,17,8,37,24,Matches
1232,Roger Ibanez,br,DF,,Roma,it Serie A,23,1998,31.1,67,33,38,26,3,32,48,66.7,16,30,11,19,66,133,95,Matches
1233,Arijon Ibrahimović,de,MF,,Bayern Munich,Bundesliga,16,2005,0.2,1,1,1,0,0,0,0,,0,0,0,0,0,1,0,Matches
1234,Zlatan Ibrahimović,se,FW,,Milan,it Serie A,40,1981,1.6,0,0,0,0,0,0,0,,0,1,1,0,0,0,2,Matches
1235,Mounaim El Idrissy,fr,FW,,Ajaccio,Ligue 1,23,1999,27.7,32,19,5,20,7,10,36,27.8,26,22,0,22,13,45,20,Matches
1236,Antonio Iervolino,it,MF,,Salernitana,it Serie A,19,2003,0.1,0,0,0,0,0,0,1,0.0,1,0,0,0,0,0,0,Matches
1237,Iglesias,es,DF,MF,Getafe,La Liga,24,1998,23.8,61,35,40,18,3,33,65,50.8,32,40,5,35,21,82,91,Matches
1238,Borja Iglesias,es,FW,,Betis,La Liga,29,1993,26.3,8,4,3,3,2,2,13,15.4,11,9,1,8,1,9,17,Matches
1239,Igor,br,DF,,Fiorentina,it Serie A,24,1998,22.9,43,29,21,18,4,20,27,74.1,7,33,14,19,25,68,56,Matches
1240,Kelechi Iheanacho,ng,FW,MF,Leicester City,Premier League,25,1996,12.5,7,2,0,3,4,3,10,30.0,7,9,1,8,0,7,8,Matches
1241,Jonathan Ikone,fr,FW,,Fiorentina,it Serie A,24,1998,22.3,16,8,5,6,5,5,14,35.7,9,18,1,17,4,20,3,Matches
1242,Ivan Ilić,rs,MF,,Hellas Verona,it Serie A,21,2001,9.5,16,10,9,7,0,6,11,54.5,5,10,1,9,8,24,14,Matches
1243,Ivan Ilić,rs,MF,,Torino,it Serie A,21,2001,13.1,18,7,6,11,1,10,20,50.0,10,12,3,9,5,23,10,Matches
1244,Rareş Ilie,ro,MF,FW,Nice,Ligue 1,19,2003,1.6,3,3,0,1,2,2,4,50.0,2,2,0,2,1,4,1,Matches
1245,Samuel Iling-Junior,eng,DF,FW,Juventus,it Serie A,18,2003,3.5,7,2,3,1,3,4,9,44.4,5,5,1,4,2,9,6,Matches
1246,Emirhan İlkhan,tr,MF,,Torino,it Serie A,18,2004,1.0,1,1,0,1,0,1,1,100.0,0,3,1,2,2,3,2,Matches
1247,Emirhan İlkhan,tr,MF,,Sampdoria,it Serie A,18,2004,1.3,6,3,2,2,2,2,3,66.7,1,5,1,4,0,6,3,Matches
1248,Asier Illarramendi,es,MF,,Real Sociedad,La Liga,32,1990,12.0,36,18,10,22,4,16,44,36.4,28,27,8,19,18,54,20,Matches
1249,Ciro Immobile,it,FW,,Lazio,it Serie A,32,1990,24.7,11,5,4,4,3,6,9,66.7,3,10,2,8,1,12,14,Matches
1250,Danny Ings,eng,FW,,West Ham,Premier League,30,1992,8.6,9,8,0,4,5,5,14,35.7,9,8,2,6,3,12,5,Matches
1251,Danny Ings,eng,FW,,Aston Villa,Premier League,30,1992,9.2,10,5,1,6,3,1,6,16.7,5,12,1,11,1,11,11,Matches
1252,Marcus Ingvartsen,dk,FW,MF,Mainz 05,Bundesliga,26,1996,14.6,4,1,0,2,2,1,10,10.0,9,9,1,8,4,8,10,Matches
1253,Bonke Innocent,ng,MF,,Lorient,Ligue 1,26,1996,13.1,28,17,13,14,1,11,36,30.6,25,22,5,17,26,54,31,Matches
1254,Alexander Isak,se,FW,,Newcastle Utd,Premier League,22,1999,16.9,18,8,4,7,7,10,28,35.7,18,21,2,19,4,22,8,Matches
1255,Alexander Isak,se,FW,,Real Sociedad,La Liga,22,1999,1.7,1,1,0,0,1,0,0,,0,0,0,0,0,1,2,Matches
1256,Isco,es,MF,FW,Sevilla,La Liga,30,1992,8.9,15,9,6,5,4,8,14,57.1,6,3,0,3,10,25,3,Matches
1257,Ismaily,br,DF,,Lille,Ligue 1,32,1990,19.8,41,18,16,16,9,17,32,53.1,15,25,5,20,21,62,39,Matches
1258,Ardian Ismajli,al,DF,,Empoli,it Serie A,25,1996,23.3,40,32,25,15,0,18,24,75.0,6,47,31,16,27,67,120,Matches
1259,Ko Itakura,jp,DF,,Gladbach,Bundesliga,25,1997,22.0,29,17,18,7,4,16,30,53.3,14,41,25,16,27,56,95,Matches
1260,Hiroki Ito,jp,DF,,Stuttgart,Bundesliga,23,1999,28.5,40,29,24,14,2,18,35,51.4,17,38,17,21,40,80,94,Matches
1261,Junya Ito,jp,FW,,Reims,Ligue 1,29,1993,32.4,40,20,14,15,11,13,53,24.5,40,29,1,28,8,48,4,Matches
1262,Diego Iturralde,es,DF,,Sevilla,La Liga,19,2003,0.5,1,0,1,0,0,0,2,0.0,2,0,0,0,0,1,1,Matches
1263,Andreas Ivan,ro,MF,,Schalke 04,Bundesliga,27,1995,0.5,0,0,0,0,0,0,1,0.0,1,0,0,0,0,0,1,Matches
1264,Mihailo Ivanović,rs,FW,,Sampdoria,it Serie A,17,2004,0.0,0,0,0,0,0,0,0,,0,0,0,0,0,0,0,Matches
1265,Daniel Iversen,dk,GK,,Leicester City,Premier League,25,1997,12.0,0,0,0,0,0,0,0,,0,0,0,0,0,0,6,Matches
1266,Alex Iwobi,ng,MF,FW,Everton,Premier League,26,1996,37.5,69,37,37,28,4,33,65,50.8,32,41,2,39,25,94,29,Matches
1267,Armando Izzo,it,DF,,Monza,it Serie A,30,1992,27.4,73,50,44,27,2,29,45,64.4,16,29,17,12,50,123,87,Matches
1268,Nicolas Jackson,sn,FW,,Villarreal,La Liga,21,2001,17.8,14,11,2,10,2,2,8,25.0,6,18,2,16,2,16,4,Matches
1269,Lee Jae-sung,kr,MF,,Mainz 05,Bundesliga,29,1992,21.0,38,17,9,21,8,16,36,44.4,20,29,5,24,17,55,21,Matches
1270,Paul Jaeckel,de,DF,,Union Berlin,Bundesliga,24,1998,13.3,24,18,11,11,2,17,35,48.6,18,11,5,6,19,43,44,Matches
1271,Mato Jajalo,ba,MF,,Udinese,it Serie A,34,1988,0.7,0,0,0,0,0,0,1,0.0,1,0,0,0,0,0,2,Matches
1272,Kristijan Jakić,hr,DF,MF,Eint Frankfurt,Bundesliga,25,1997,16.2,33,21,19,12,2,22,41,53.7,19,32,10,22,14,47,49,Matches
1273,Ismail Jakobs,sn,DF,FW,Monaco,Ligue 1,22,1999,12.4,11,5,7,3,1,5,12,41.7,7,9,1,8,9,20,18,Matches
1274,Marin Jakoliš,hr,FW,,Angers,Ligue 1,25,1996,0.3,1,1,0,0,1,0,0,,0,0,0,0,0,1,0,Matches
1275,Daniel James,wls,FW,,Leeds United,Premier League,24,1997,2.2,6,2,1,3,2,3,6,50.0,3,4,0,4,2,8,2,Matches
1276,Daniel James,wls,FW,,Fulham,Premier League,24,1997,6.9,10,6,4,5,1,4,9,44.4,5,5,1,4,1,11,5,Matches
1277,Reece James,eng,DF,MF,Chelsea,Premier League,22,1999,13.8,31,20,10,18,3,15,19,78.9,4,17,2,15,12,43,23,Matches
1278,Vitaly Janelt,de,MF,DF,Brentford,Premier League,24,1998,24.5,54,27,20,24,10,21,49,42.9,28,29,9,20,29,83,26,Matches
1279,Saidy Janko,gm,DF,,Bochum,Bundesliga,26,1995,12.6,23,15,13,8,2,12,20,60.0,8,24,10,14,11,34,33,Matches
1280,Pontus Jansson,se,DF,,Brentford,Premier League,31,1991,8.0,5,3,4,1,0,3,5,60.0,2,13,9,4,9,14,38,Matches
1281,Tony Jantschke,de,DF,MF,Gladbach,Bundesliga,32,1990,1.1,2,1,1,1,0,1,1,100.0,0,5,3,2,0,2,5,Matches
1282,Adnan Januzaj,be,FW,,Sevilla,La Liga,27,1995,0.5,0,0,0,0,0,0,1,0.0,1,0,0,0,1,1,0,Matches
1283,Léo Jardim,br,GK,,Lille,Ligue 1,27,1995,6.0,0,0,0,0,0,0,1,0.0,1,0,0,0,0,0,0,Matches
1284,Luis Javier Suárez,co,FW,,Almería,La Liga,24,1997,16.6,17,11,5,6,6,6,26,23.1,20,13,3,10,3,20,10,Matches
1285,Luis Javier Suárez,co,FW,,Marseille,Ligue 1,24,1997,3.3,4,1,1,2,1,1,4,25.0,3,1,0,1,3,7,6,Matches
1286,Dany Jean,ht,DF,MF,Strasbourg,Ligue 1,19,2002,0.1,0,0,0,0,0,0,1,0.0,1,1,0,1,0,0,0,Matches
1287,Julian Jeanvier,gn,DF,,Auxerre,Ligue 1,30,1992,19.6,32,17,24,8,0,13,22,59.1,9,24,17,7,27,59,96,Matches
1288,Jeffinho,br,FW,,Lyon,Ligue 1,22,1999,5.0,17,4,4,9,4,6,15,40.0,9,6,0,6,1,18,0,Matches
1289,Fredrik Jensen,fi,FW,MF,Augsburg,Bundesliga,24,1997,10.3,15,10,8,3,4,5,10,50.0,5,12,5,7,4,19,12,Matches
1290,Mathias Jensen,dk,MF,,Brentford,Premier League,26,1996,31.1,71,36,29,30,12,34,97,35.1,63,54,5,49,32,103,24,Matches
1291,Moritz Jenz,de,DF,,Schalke 04,Bundesliga,23,1999,10.5,14,11,8,5,1,5,8,62.5,3,16,10,6,8,22,53,Matches
1292,Jesé,es,FW,,Sampdoria,it Serie A,29,1993,2.3,2,0,0,2,0,0,1,0.0,1,3,1,2,1,3,2,Matches
1293,Gabriel Jesus,br,FW,,Arsenal,Premier League,25,1997,22.9,33,25,16,8,9,15,31,48.4,16,27,3,24,11,44,15,Matches
1294,Juan Jesus,br,DF,,Napoli,it Serie A,31,1991,10.4,16,11,9,6,1,9,12,75.0,3,18,11,7,10,26,29,Matches
1295,Raúl Jiménez,mx,FW,,Wolves,Premier League,31,1991,9.4,9,6,3,5,1,3,6,50.0,3,9,0,9,0,9,8,Matches
1296,Joaquín,es,MF,FW,Betis,La Liga,41,1981,5.5,3,3,2,1,0,1,3,33.3,2,7,2,5,4,7,5,Matches
1297,Joelinton,br,MF,FW,Newcastle Utd,Premier League,25,1996,29.6,70,49,36,26,8,26,62,41.9,36,52,7,45,48,118,39,Matches
1298,Þórir Jóhann Helgason,is,MF,,Lecce,it Serie A,21,2000,2.5,2,2,1,0,1,2,3,66.7,1,3,1,2,3,5,3,Matches
1299,Ben Johnson,eng,DF,,West Ham,Premier League,22,2000,9.6,20,14,12,4,4,12,18,66.7,6,12,4,8,9,29,28,Matches
1300,Brennan Johnson,wls,FW,MF,Nott'ham Forest,Premier League,21,2001,32.6,34,20,18,8,8,8,29,27.6,21,30,1,29,5,39,7,Matches
1301,Sam Johnstone,eng,GK,,Crystal Palace,Premier League,29,1993,9.0,0,0,0,0,0,0,0,,0,0,0,0,0,0,5,Matches
1302,Paul Joly,fr,DF,,Auxerre,Ligue 1,22,2000,9.6,33,21,21,10,2,19,35,54.3,16,13,2,11,24,57,29,Matches
1303,Curtis Jones,eng,MF,,Liverpool,Premier League,21,2001,11.5,34,17,8,12,14,18,31,58.1,13,12,2,10,3,37,9,Matches
1304,Frenkie de Jong,nl,MF,,Barcelona,La Liga,25,1997,28.2,46,26,16,21,9,17,41,41.5,24,11,1,10,35,81,22,Matches
1305,Joan Jordán,es,MF,,Sevilla,La Liga,28,1994,17.7,32,17,13,17,2,16,38,42.1,22,14,7,7,16,48,14,Matches
1306,Jorginho,it,MF,,Arsenal,Premier League,30,1991,9.5,18,13,6,10,2,5,24,20.8,19,7,2,5,9,27,8,Matches
1307,Jorginho,it,MF,,Chelsea,Premier League,30,1991,14.2,42,23,22,14,6,22,46,47.8,24,18,3,15,21,63,7,Matches
1308,Josan,es,DF,MF,Elche,La Liga,32,1989,12.0,25,20,20,5,0,14,27,51.9,13,8,0,8,7,32,15,Matches
1309,Willian José,br,FW,,Betis,La Liga,30,1991,8.1,9,6,6,3,0,4,9,44.4,5,4,0,4,1,10,15,Matches
1310,Joselu,es,FW,,Espanyol,La Liga,32,1990,33.2,13,11,3,4,6,4,17,23.5,13,25,4,21,8,21,43,Matches
1311,Mateo Joseph,es,FW,MF,Leeds United,Premier League,18,2003,0.3,0,0,0,0,0,0,0,,0,1,0,1,0,0,1,Matches
1312,Diogo Jota,pt,FW,,Liverpool,Premier League,25,1996,12.6,23,15,8,8,7,12,37,32.4,25,5,0,5,3,26,11,Matches
1313,Stevan Jovetić,me,FW,MF,Hertha BSC,Bundesliga,32,1989,9.9,3,2,2,1,0,1,11,9.1,10,2,1,1,2,5,10,Matches
1314,Luka Jović,rs,FW,MF,Fiorentina,it Serie A,24,1997,17.0,6,3,1,4,1,2,8,25.0,6,7,2,5,2,8,10,Matches
1315,Juanmi,es,FW,,Betis,La Liga,29,1993,10.3,14,10,4,7,3,7,31,22.6,24,10,0,10,4,18,4,Matches
1316,Juanpe,es,DF,,Girona,La Liga,31,1991,15.8,19,11,10,9,0,11,17,64.7,6,12,9,3,10,29,60,Matches
1317,Jubal,br,DF,,Auxerre,Ligue 1,28,1993,35.7,41,26,29,11,1,19,38,50.0,19,57,34,23,53,94,193,Matches
1318,Christopher Jullien,fr,DF,,Montpellier,Ligue 1,29,1993,29.9,46,28,29,14,3,28,51,54.9,23,35,18,17,43,89,114,Matches
1319,Anthony Jung,de,DF,FW,Werder Bremen,Bundesliga,30,1991,29.1,46,27,19,20,7,31,58,53.4,27,30,6,24,22,68,63,Matches
1320,Eli Junior Kroupi,fr,FW,MF,Lorient,Ligue 1,16,2006,0.1,0,0,0,0,0,0,1,0.0,1,0,0,0,1,1,0,Matches
1321,Lago Junior,ci,FW,MF,Mallorca,La Liga,31,1990,0.6,1,0,0,1,0,1,1,100.0,0,0,0,0,0,1,0,Matches
1322,Hamed Junior Traorè,ci,FW,MF,Bournemouth,Premier League,22,2000,4.7,17,11,5,9,3,6,18,33.3,12,9,0,9,2,19,1,Matches
1323,Hamed Junior Traorè,ci,MF,FW,Sassuolo,it Serie A,22,2000,6.6,11,6,4,6,1,4,11,36.4,7,4,0,4,2,13,0,Matches
1324,Vinicius Júnior,br,FW,,Real Madrid,La Liga,22,2000,31.4,30,21,10,12,8,14,39,35.9,25,24,1,23,6,36,1,Matches
1325,Josip Juranović,hr,DF,,Union Berlin,Bundesliga,26,1995,10.4,9,7,5,2,2,7,18,38.9,11,9,3,6,6,15,22,Matches
1326,James Justin,eng,DF,,Leicester City,Premier League,24,1998,13.9,20,18,7,12,1,9,18,50.0,9,24,6,18,15,35,47,Matches
1327,Filip Jørgensen,dk,GK,,Villarreal,La Liga,20,2002,2.0,0,0,0,0,0,0,1,0.0,1,0,0,0,0,0,0,Matches
1328,Mathias Jørgensen,dk,DF,,Brentford,Premier League,32,1990,12.3,17,8,9,8,0,9,21,42.9,12,19,12,7,16,33,39,Matches
1329,Ozan Kabak,tr,DF,,Hoffenheim,Bundesliga,22,2000,26.5,51,34,27,21,3,17,30,56.7,13,35,23,12,45,96,83,Matches
1330,Issa Kaboré,bf,DF,,Marseille,Ligue 1,21,2001,11.4,33,19,10,18,5,21,32,65.6,11,11,1,10,12,45,21,Matches
1331,Abdoul Kader Bamba,fr,FW,MF,Nantes,Ligue 1,28,1994,0.9,0,0,0,0,0,0,2,0.0,2,3,1,2,0,0,1,Matches
1332,Pavel Kadeřábek,cz,DF,,Hoffenheim,Bundesliga,30,1992,18.5,26,20,10,9,7,15,23,65.2,8,12,2,10,14,40,37,Matches
1333,Tino Kadewere,zw,FW,MF,Mallorca,La Liga,26,1996,6.0,6,3,3,3,0,4,9,44.4,5,6,2,4,2,8,1,Matches
1334,Kaiky,br,DF,,Almería,La Liga,18,2004,6.5,5,5,5,0,0,3,7,42.9,4,18,10,8,11,16,28,Matches
1335,Florian Kainz,at,MF,FW,Köln,Bundesliga,29,1992,26.0,21,10,7,12,2,8,26,30.8,18,27,6,21,32,53,30,Matches
1336,Gaël Kakuta,cd,FW,,Lens,Ligue 1,31,1991,0.2,0,0,0,0,0,0,0,,0,0,0,0,0,0,1,Matches
1337,Sasa Kalajdzic,at,FW,,Wolves,Premier League,25,1997,0.5,0,0,0,0,0,0,0,,0,0,0,0,1,1,0,Matches
1338,Sasa Kalajdzic,at,FW,,Stuttgart,Bundesliga,25,1997,2.6,3,2,0,1,2,1,3,33.3,2,1,0,1,0,3,0,Matches
1339,Arnaud Kalimuendo,fr,FW,,Rennes,Ligue 1,20,2002,20.5,15,8,3,6,6,5,20,25.0,15,15,2,13,2,17,9,Matches
1340,Yayah Kallon,sl,MF,FW,Hellas Verona,it Serie A,21,2001,9.6,14,10,5,4,5,7,12,58.3,5,10,0,10,8,22,5,Matches
1341,Gedeon Kalulu,cd,DF,,Lorient,Ligue 1,24,1997,27.1,64,34,43,14,7,30,48,62.5,18,32,3,29,28,92,79,Matches
1342,Pierre Kalulu,fr,DF,,Milan,it Serie A,22,2000,28.3,57,39,33,21,3,28,42,66.7,14,41,17,24,41,98,56,Matches
1343,Justin-Noël Kalumba,fr,DF,,Angers,Ligue 1,17,2004,6.1,9,5,5,2,2,5,16,31.3,11,4,1,3,4,13,5,Matches
1344,Daichi Kamada,jp,MF,,Eint Frankfurt,Bundesliga,25,1996,25.2,51,31,10,37,4,31,57,54.4,26,31,2,29,16,67,17,Matches
1345,Waren Kamanzi,no,DF,,Toulouse,Ligue 1,21,2000,7.4,16,9,9,5,2,13,19,68.4,6,8,2,6,8,24,9,Matches
1346,Bingourou Kamara,sn,GK,,Montpellier,Ligue 1,25,1996,4.5,0,0,0,0,0,0,0,,0,0,0,0,0,0,2,Matches
1347,Boubacar Kamara,fr,MF,,Aston Villa,Premier League,22,1999,19.7,58,25,25,23,10,27,56,48.2,29,38,12,26,19,77,24,Matches
1348,Jakub Kamiński,pl,FW,DF,Wolfsburg,Bundesliga,20,2002,22.9,36,25,15,13,8,20,40,50.0,20,37,2,35,8,44,15,Matches
1349,Marcin Kamiński,pl,DF,,Schalke 04,Bundesliga,30,1992,7.0,6,4,4,0,2,2,4,50.0,2,8,7,1,9,15,28,Matches
1350,Kevin Kampl,si,MF,,RB Leipzig,Bundesliga,31,1990,15.2,21,11,6,14,1,6,27,22.2,21,26,9,17,22,43,11,Matches
1351,Nordine Kandil,fr,MF,FW,Strasbourg,Ligue 1,20,2001,1.1,3,2,1,2,0,0,3,0.0,3,2,0,2,1,4,1,Matches
1352,Harry Kane,eng,FW,,Tottenham,Premier League,29,1993,37.8,15,12,1,6,8,7,21,33.3,14,27,7,20,2,17,18,Matches
1353,Lee Kang-in,kr,MF,FW,Mallorca,La Liga,21,2001,31.4,42,24,10,22,10,18,61,29.5,43,25,2,23,11,53,7,Matches
1354,Wilfried Kanga,ci,FW,,Hertha BSC,Bundesliga,24,1998,15.7,5,4,2,1,2,2,4,50.0,2,14,3,11,2,7,13,Matches
1355,N'Golo Kanté,fr,MF,,Chelsea,Premier League,31,1991,5.8,16,10,4,10,2,4,8,50.0,4,11,0,11,6,22,2,Matches
1356,Kenan Karaman,tr,FW,,Schalke 04,Bundesliga,28,1994,10.8,11,8,3,5,3,3,12,25.0,9,9,1,8,3,14,9,Matches
1357,Yann Karamoh,fr,MF,FW,Torino,it Serie A,24,1998,8.0,5,2,3,2,0,1,5,20.0,4,5,0,5,0,5,2,Matches
1358,Atakan Karazor,,MF,,Stuttgart,Bundesliga,25,1996,21.8,49,30,18,25,6,24,47,51.1,23,39,11,28,31,80,44,Matches
1359,Ayman Kari,fr,MF,DF,Lorient,Ligue 1,17,2004,1.1,0,0,0,0,0,0,0,,0,4,0,4,3,3,0,Matches
1360,Jon Karrikaburu,es,FW,,Real Sociedad,La Liga,19,2002,1.0,1,0,0,1,0,0,0,,0,2,0,2,0,1,0,Matches
1361,Rick Karsdorp,nl,DF,,Roma,it Serie A,27,1995,7.9,21,13,11,7,3,13,22,59.1,9,0,0,0,7,28,15,Matches
1362,Denso Kasius,nl,DF,,Bologna,it Serie A,19,2002,3.8,12,6,7,4,1,8,10,80.0,2,6,3,3,3,15,6,Matches
1363,Thomas Kastanaras,gr,FW,DF,Stuttgart,Bundesliga,19,2003,0.8,0,0,0,0,0,0,0,,0,1,0,1,0,0,0,Matches
1364,Grigoris Kastanos,cy,MF,DF,Salernitana,it Serie A,24,1998,14.3,39,23,18,19,2,16,40,40.0,24,20,6,14,8,47,8,Matches
1365,Silas Katompa,cd,FW,MF,Stuttgart,Bundesliga,23,1998,22.1,25,17,5,14,6,6,20,30.0,14,17,2,15,8,33,1,Matches
1366,Moise Kean,it,FW,,Juventus,it Serie A,22,2000,11.1,8,6,2,5,1,3,7,42.9,4,4,0,4,5,13,2,Matches
1367,Michael Keane,eng,DF,,Everton,Premier League,29,1993,10.9,7,4,5,2,0,5,8,62.5,3,12,7,5,14,21,55,Matches
1368,Neeskens Kebano,cd,FW,,Fulham,Premier League,30,1992,8.5,17,9,8,6,3,9,18,50.0,9,14,0,14,1,18,8,Matches
1369,Kévin Keben Biakolo,cm,DF,,Toulouse,Ligue 1,18,2004,4.0,3,2,2,0,1,0,4,0.0,4,1,0,1,5,8,9,Matches
1370,Thilo Kehrer,de,DF,,West Ham,Premier League,25,1996,24.8,43,24,25,14,4,21,45,46.7,24,16,6,10,34,77,76,Matches
1371,Check Keita,fr,DF,,Reims,Ligue 1,19,2003,7.6,12,9,9,3,0,4,9,44.4,5,6,5,1,5,17,24,Matches
1372,Naby Keïta,gn,MF,,Liverpool,Premier League,27,1995,3.3,5,4,2,3,0,1,4,25.0,3,1,0,1,2,7,3,Matches
1373,Yannik Keitel,de,MF,,Freiburg,Bundesliga,22,2000,7.6,11,7,4,6,1,3,5,60.0,2,6,3,3,13,24,8,Matches
1374,Caoimhín Kelleher,ie,GK,,Liverpool,Premier League,23,1998,1.0,0,0,0,0,0,0,0,,0,0,0,0,0,0,0,Matches
1375,Lloyd Kelly,eng,DF,,Bournemouth,Premier League,23,1998,22.7,33,18,23,9,1,13,19,68.4,6,26,15,11,26,59,101,Matches
1376,Marc-Oliver Kempf,de,DF,,Hertha BSC,Bundesliga,27,1995,30.1,44,27,29,14,1,16,22,72.7,6,42,32,10,51,95,143,Matches
1377,Kenedy,br,FW,DF,Valladolid,La Liga,26,1996,3.1,6,2,3,3,0,2,4,50.0,2,2,0,2,1,7,0,Matches
1378,Jonjoe Kenny,eng,DF,,Hertha BSC,Bundesliga,25,1997,24.9,46,34,27,16,3,24,42,57.1,18,38,9,29,46,92,74,Matches
1379,Franck Kessié,ci,MF,,Barcelona,La Liga,25,1996,11.0,15,9,6,6,3,8,18,44.4,10,10,2,8,12,27,11,Matches
1380,Saîf-Eddine Khaoui,tn,MF,,Clermont Foot,Ligue 1,27,1995,22.5,47,28,14,25,8,15,47,31.9,32,17,2,15,33,80,8,Matches
1381,Wahbi Khazri,tn,FW,MF,Montpellier,Ligue 1,31,1991,18.2,26,13,13,7,6,6,25,24.0,19,17,1,16,9,35,20,Matches
1382,Rani Khedira,de,MF,,Union Berlin,Bundesliga,28,1994,32.0,60,33,21,32,7,25,50,50.0,25,33,10,23,40,100,33,Matches
1383,Anthony Khelifa,dz,DF,,Ajaccio,Ligue 1,16,2005,0.1,0,0,0,0,0,0,0,,0,0,0,0,0,0,0,Matches
1384,Kiké,es,FW,,Osasuna,La Liga,32,1989,11.3,6,3,0,4,2,2,5,40.0,3,6,1,5,1,7,13,Matches
1385,Luca Kilian,de,DF,,Köln,Bundesliga,22,1999,12.5,22,16,14,7,1,12,21,57.1,9,16,8,8,11,33,48,Matches
1386,Max Kilman,eng,DF,,Wolves,Premier League,25,1997,36.7,36,20,26,9,1,16,30,53.3,14,70,42,28,19,55,164,Matches
1387,Joshua Kimmich,de,MF,,Bayern Munich,Bundesliga,27,1995,31.2,78,49,24,46,8,38,72,52.8,34,36,7,29,41,119,39,Matches
1388,Presnel Kimpembe,fr,DF,,Paris S-G,Ligue 1,26,1995,8.1,17,8,9,6,2,9,13,69.2,4,12,7,5,13,30,9,Matches
1389,Jakub Kiwior,pl,DF,,Arsenal,Premier League,22,2000,4.7,7,5,6,1,0,5,8,62.5,3,5,3,2,6,13,10,Matches
1390,Jakub Kiwior,pl,DF,,Spezia,it Serie A,22,2000,16.0,22,17,15,7,0,6,24,25.0,18,26,18,8,24,46,71,Matches
1391,Simon Kjær,dk,DF,,Milan,it Serie A,33,1989,11.2,15,8,9,6,0,7,11,63.6,4,14,11,3,9,24,35,Matches
1392,Pascal Klemens,de,DF,,Hertha BSC,Bundesliga,17,2005,1.0,0,0,0,0,0,0,1,0.0,1,1,0,1,1,1,3,Matches
1393,Mateusz Klich,pl,MF,FW,Leeds United,Premier League,32,1990,3.1,12,8,3,4,5,7,13,53.8,6,4,0,4,0,12,1,Matches
1394,Lukas Klostermann,de,DF,,RB Leipzig,Bundesliga,26,1996,10.1,16,8,7,9,0,8,15,53.3,7,6,3,3,13,29,31,Matches
1395,Justin Kluivert,nl,FW,MF,Valencia,La Liga,23,1999,16.1,17,14,7,4,6,6,12,50.0,6,4,0,4,7,24,4,Matches
1396,Ansgar Knauff,de,DF,,Eint Frankfurt,Bundesliga,20,2002,14.3,36,25,22,11,3,15,34,44.1,19,19,1,18,15,51,26,Matches
1397,Robin Knoche,de,DF,,Union Berlin,Bundesliga,30,1992,31.9,45,29,29,12,4,24,47,51.1,23,35,18,17,38,83,140,Matches
1398,Gregor Kobel,ch,GK,,Dortmund,Bundesliga,24,1997,27.0,0,0,0,0,0,0,1,0.0,1,1,0,1,0,0,7,Matches
1399,Robin Koch,de,DF,,Leeds United,Premier League,26,1996,35.3,53,30,32,16,5,24,56,42.9,32,44,21,23,43,96,152,Matches
1400,Samuel Koeberlé,fr,MF,,Reims,Ligue 1,17,2004,0.0,0,0,0,0,0,0,0,,0,0,0,0,0,0,0,Matches
1401,Rudy Kohon,fr,DF,,Troyes,Ligue 1,18,2004,0.7,4,3,4,0,0,2,2,100.0,0,1,0,1,1,5,2,Matches
1402,Dominik Kohr,de,MF,,Mainz 05,Bundesliga,28,1994,25.5,59,33,23,31,5,29,61,47.5,32,46,9,37,34,93,26,Matches
1403,Koke,es,MF,,Atlético Madrid,La Liga,30,1992,28.3,55,38,23,25,7,28,72,38.9,44,35,13,22,20,75,19,Matches
1404,Sead Kolašinac,ba,DF,,Marseille,Ligue 1,29,1993,24.6,52,36,24,22,6,24,37,64.9,13,19,2,17,43,95,35,Matches
1405,Luca Koleosho,it,FW,DF,Espanyol,La Liga,17,2004,0.7,2,2,0,0,2,1,2,50.0,1,1,0,1,0,2,0,Matches
1406,Randal Kolo Muani,fr,FW,,Eint Frankfurt,Bundesliga,23,1998,29.2,14,10,3,3,8,1,9,11.1,8,19,2,17,3,17,13,Matches
1407,Timothée Kolodziejczak,fr,DF,,Schalke 04,Bundesliga,30,1991,0.3,0,0,0,0,0,0,1,0.0,1,0,0,0,1,1,1,Matches
1408,Cheick Konaté,ml,DF,,Clermont Foot,Ligue 1,18,2004,6.4,19,12,10,7,2,13,22,59.1,9,7,1,6,13,32,8,Matches
1409,Ibrahima Konaté,fr,DF,,Liverpool,Premier League,23,1999,17.2,38,26,25,13,0,16,27,59.3,11,12,5,7,26,64,61,Matches
1410,Geoffrey Kondogbia,cf,MF,,Atlético Madrid,La Liga,29,1993,11.2,40,23,19,20,1,17,25,68.0,8,9,1,8,26,66,12,Matches
1411,Ibrahima Koné,ml,FW,,Lorient,Ligue 1,23,1999,17.5,24,13,3,13,8,5,11,45.5,6,13,0,13,4,28,18,Matches
1412,Manu Koné,fr,MF,,Gladbach,Bundesliga,21,2001,29.0,74,39,37,33,4,24,47,51.1,23,44,12,32,32,106,21,Matches
1413,Youssouf Koné,ml,DF,,Ajaccio,Ligue 1,27,1995,10.2,28,19,24,4,0,18,25,72.0,7,9,2,7,12,40,32,Matches
1414,Ezri Konsa,eng,DF,,Aston Villa,Premier League,24,1997,36.9,42,20,25,15,2,18,26,69.2,8,41,23,18,26,68,120,Matches
1415,Teun Koopmeiners,nl,MF,,Atalanta,it Serie A,24,1998,31.8,46,26,15,24,7,28,55,50.9,27,41,5,36,19,65,36,Matches
1416,Odilon Kossounou,ci,DF,,Leverkusen,Bundesliga,21,2001,16.9,21,14,12,7,2,8,16,50.0,8,26,11,15,24,45,58,Matches
1417,Filip Kostić,rs,DF,FW,Juventus,it Serie A,29,1992,28.5,41,26,17,20,4,21,47,44.7,26,30,4,26,16,57,32,Matches
1418,Filip Kostić,rs,DF,MF,Eint Frankfurt,Bundesliga,29,1992,0.8,2,0,1,1,0,0,0,,0,0,0,0,1,3,0,Matches
1419,Christian Kouamé,ci,FW,,Fiorentina,it Serie A,24,1997,20.7,27,18,8,10,9,7,14,50.0,7,15,3,12,12,39,8,Matches
1420,Rominigue Kouamé,ml,MF,,Troyes,Ligue 1,25,1996,29.6,44,27,28,14,2,17,41,41.5,24,32,11,21,49,93,46,Matches
1421,Tomáš Koubek,cz,GK,,Augsburg,Bundesliga,29,1992,11.0,0,0,0,0,0,0,0,,0,0,0,0,0,0,7,Matches
1422,Kalidou Koulibaly,sn,DF,,Chelsea,Premier League,31,1991,20.0,45,31,34,8,3,26,40,65.0,14,30,13,17,29,74,77,Matches
1423,Jules Koundé,fr,DF,,Barcelona,La Liga,23,1998,27.0,37,23,18,13,6,21,31,67.7,10,24,9,15,19,56,61,Matches
1424,Boubakar Kouyaté,ml,DF,,Montpellier,Ligue 1,25,1997,14.0,31,18,18,11,2,19,35,54.3,16,24,14,10,34,65,73,Matches
1425,Cheikhou Kouyaté,sn,MF,,Nott'ham Forest,Premier League,32,1989,9.8,29,21,18,8,3,9,13,69.2,4,14,2,12,10,39,24,Matches
1426,Mateo Kovačić,hr,MF,,Chelsea,Premier League,28,1994,19.0,36,24,16,14,6,14,36,38.9,22,10,1,9,19,55,16,Matches
1427,Viktor Kovalenko,ua,MF,,Spezia,it Serie A,26,1996,6.1,9,5,1,6,2,5,8,62.5,3,11,2,9,4,13,7,Matches
1428,Soichiro Kozuki,jp,FW,MF,Schalke 04,Bundesliga,21,2000,4.2,6,4,3,3,0,4,6,66.7,2,5,0,5,3,9,3,Matches
1429,Emil Krafth,se,DF,,Newcastle Utd,Premier League,27,1994,0.0,0,0,0,0,0,0,0,,0,0,0,0,0,0,0,Matches
1430,Alex Král,cz,MF,,Schalke 04,Bundesliga,24,1998,26.2,34,24,10,22,2,17,37,45.9,20,31,6,25,17,51,53,Matches
1431,Andrej Kramarić,hr,MF,FW,Hoffenheim,Bundesliga,31,1991,26.5,5,2,2,1,2,1,11,9.1,10,14,2,12,6,11,13,Matches
1432,Christoph Kramer,de,MF,,Gladbach,Bundesliga,31,1991,24.7,44,33,24,15,5,22,55,40.0,33,34,2,32,17,61,40,Matches
1433,Tom Krauß,de,MF,,Schalke 04,Bundesliga,21,2001,27.9,112,68,39,62,11,51,100,51.0,49,39,6,33,36,148,35,Matches
1434,Rasmus Kristensen,dk,DF,,Leeds United,Premier League,25,1997,21.8,62,35,35,21,6,42,76,55.3,34,32,14,18,35,97,61,Matches
1435,Julian Kristoffersen,no,FW,,Salernitana,it Serie A,25,1997,0.2,0,0,0,0,0,0,0,,0,1,0,1,0,0,0,Matches
1436,Raimonds Krollis,lv,FW,DF,Spezia,it Serie A,20,2001,0.4,1,1,0,0,1,0,1,0.0,1,0,0,0,0,1,0,Matches
1437,Toni Kroos,de,MF,,Real Madrid,La Liga,32,1990,23.9,51,32,16,33,2,23,69,33.3,46,23,4,19,24,75,11,Matches
1438,Rade Krunić,ba,MF,,Milan,it Serie A,28,1993,18.4,40,28,18,18,4,16,50,32.0,34,31,11,20,16,56,21,Matches
1439,Max Kruse,de,MF,FW,Wolfsburg,Bundesliga,34,1988,3.0,1,1,0,1,0,0,1,0.0,1,2,1,1,0,1,1,Matches
1440,Lukas Kübler,de,DF,,Freiburg,Bundesliga,29,1992,18.2,37,25,24,9,4,18,30,60.0,12,25,11,14,29,66,50,Matches
1441,Takefusa Kubo,jp,FW,MF,Real Sociedad,La Liga,21,2001,27.1,44,26,18,16,10,16,38,42.1,22,29,1,28,9,53,4,Matches
1442,Dejan Kulusevski,se,MF,FW,Tottenham,Premier League,22,2000,23.0,38,15,23,7,8,16,44,36.4,28,19,0,19,13,51,7,Matches
1443,Sael Kumbedi,fr,DF,,Lyon,Ligue 1,17,2005,14.7,47,27,27,13,7,20,38,52.6,18,23,7,16,10,57,16,Matches
1444,Marash Kumbulla,al,DF,,Roma,it Serie A,22,2000,2.9,4,4,2,2,0,2,3,66.7,1,2,1,1,4,8,6,Matches
1445,Pierre Kunde,cm,MF,FW,Bochum,Bundesliga,27,1995,4.2,12,6,3,8,1,6,14,42.9,8,7,1,6,7,19,9,Matches
1446,Alou Kuol,au,FW,,Stuttgart,Bundesliga,21,2000,0.1,0,0,0,0,0,0,0,,0,0,0,0,0,0,0,Matches
1447,Layvin Kurzawa,fr,DF,,Fulham,Premier League,29,1992,1.5,3,2,1,1,1,3,3,100.0,0,1,1,0,2,5,4,Matches
1448,Khvicha Kvaratskhelia,ge,FW,,Napoli,it Serie A,21,2001,28.0,43,23,12,8,23,17,43,39.5,26,20,0,20,5,48,6,Matches
1449,Grejohn Kyei,fr,FW,,Clermont Foot,Ligue 1,26,1995,24.8,16,7,2,9,5,4,13,30.8,9,14,3,11,6,22,22,Matches
1450,Daniel Kyereh,gh,MF,FW,Freiburg,Bundesliga,26,1996,6.2,6,4,2,4,0,3,6,50.0,3,4,0,4,2,8,6,Matches
1451,Giorgos Kyriakopoulos,gr,DF,FW,Bologna,it Serie A,26,1996,7.8,13,6,4,5,4,10,23,43.5,13,14,2,12,4,17,10,Matches
1452,Giorgos Kyriakopoulos,gr,FW,DF,Sassuolo,it Serie A,26,1996,8.5,21,8,7,9,5,10,14,71.4,4,7,1,6,11,32,12,Matches
1453,César de la Hoz,es,MF,,Almería,La Liga,30,1992,18.6,37,20,17,18,2,19,37,51.4,18,26,6,20,13,50,37,Matches
1454,Luca de la Torre,us,MF,,Celta Vigo,La Liga,24,1998,16.5,28,19,11,14,3,12,32,37.5,20,22,1,21,9,37,6,Matches
1455,Rémy Labeau Lascary,gp,FW,MF,Lens,Ligue 1,19,2003,1.4,4,2,4,0,0,0,0,,0,4,0,4,1,5,0,Matches
1456,Gaëtan Laborde,fr,FW,,Nice,Ligue 1,28,1994,27.8,45,25,13,17,15,18,40,45.0,22,27,2,25,9,54,13,Matches
1457,Gaëtan Laborde,fr,FW,,Rennes,Ligue 1,28,1994,2.8,1,1,1,0,0,0,1,0.0,1,1,0,1,0,1,1,Matches
1458,Alexandre Lacazette,fr,FW,,Lyon,Ligue 1,31,1991,32.5,43,23,7,17,19,10,29,34.5,19,23,3,20,15,58,4,Matches
1459,Qazim Laçi,al,MF,,Ajaccio,Ligue 1,26,1996,2.4,6,3,2,3,1,4,9,44.4,5,5,0,5,2,8,3,Matches
1460,Maxence Lacroix,fr,DF,,Wolfsburg,Bundesliga,22,2000,18.1,22,13,15,7,0,8,16,50.0,8,22,11,11,26,48,85,Matches
1461,Alban Lafont,fr,GK,,Nantes,Ligue 1,23,1999,37.0,0,0,0,0,0,0,1,0.0,1,0,0,0,0,0,20,Matches
1462,Aïssa Laïdouni,tn,MF,,Union Berlin,Bundesliga,25,1996,9.7,14,7,6,8,0,5,17,29.4,12,22,4,18,9,23,3,Matches
1463,Konrad Laimer,at,MF,,RB Leipzig,Bundesliga,25,1997,16.3,60,31,23,30,7,30,54,55.6,24,31,4,27,18,78,8,Matches
1464,Stefan Lainer,at,DF,,Gladbach,Bundesliga,29,1992,9.1,16,8,10,5,1,10,23,43.5,13,8,1,7,14,30,34,Matches
1465,Kenny Lala,mg,DF,,Brest,Ligue 1,30,1991,15.7,36,19,19,15,2,22,38,57.9,16,15,5,10,21,57,28,Matches
1466,Adam Lallana,eng,MF,FW,Brighton,Premier League,34,1988,8.0,9,4,6,2,1,0,7,0.0,7,6,0,6,2,11,1,Matches
1467,Vassilis Lambropoulos,gr,DF,,Bochum,Bundesliga,32,1990,7.0,10,8,7,3,0,6,9,66.7,3,5,3,2,13,23,41,Matches
1468,Érik Lamela,ar,FW,MF,Sevilla,La Liga,30,1992,20.5,46,27,14,16,16,12,34,35.3,22,26,2,24,7,53,3,Matches
1469,Mohamed Lamine Bayo,gn,FW,MF,Lille,Ligue 1,24,1998,7.2,3,3,0,2,1,0,12,0.0,12,3,1,2,0,3,1,Matches
1470,Sam Lammers,nl,FW,,Sampdoria,it Serie A,25,1997,12.2,12,5,2,7,3,6,15,40.0,9,10,3,7,6,18,11,Matches
1471,Sam Lammers,nl,FW,,Empoli,it Serie A,25,1997,9.8,20,10,5,9,6,7,11,63.6,4,4,1,3,3,23,8,Matches
1472,Tariq Lamptey,gh,DF,,Brighton,Premier League,21,2000,5.0,11,6,6,4,1,5,7,71.4,2,7,3,4,7,18,2,Matches
1473,Manuel Lanzini,ar,MF,FW,West Ham,Premier League,29,1993,2.8,2,2,1,1,0,2,6,33.3,4,2,0,2,2,4,0,Matches
1474,Aymeric Laporte,es,DF,,Manchester City,Premier League,28,1994,11.0,11,8,6,4,1,7,11,63.6,4,10,4,6,3,14,30,Matches
1475,Julien Laporte,fr,DF,,Lorient,Ligue 1,28,1993,18.4,22,16,18,3,1,16,22,72.7,6,33,27,6,18,40,108,Matches
1476,Cyle Larin,ca,FW,,Valladolid,La Liga,27,1995,16.3,9,3,2,4,3,3,7,42.9,4,6,3,3,0,9,15,Matches
1477,Juan Larios,es,DF,,Southampton,Premier League,18,2004,1.7,7,6,6,1,0,5,5,100.0,0,2,0,2,3,10,4,Matches
1478,Yasser Larouci,dz,DF,MF,Troyes,Ligue 1,21,2001,20.0,23,13,13,8,2,15,24,62.5,9,15,1,14,26,49,46,Matches
1479,Jordan Larsson,se,FW,MF,Schalke 04,Bundesliga,25,1997,5.1,8,5,1,7,0,2,9,22.2,7,9,0,9,4,12,3,Matches
1480,Kevin Lasagna,it,FW,MF,Hellas Verona,it Serie A,29,1992,17.5,12,6,7,3,2,6,14,42.9,8,17,1,16,5,17,13,Matches
1481,Jamaal Lascelles,eng,DF,,Newcastle Utd,Premier League,28,1993,2.4,1,0,1,0,0,1,1,100.0,0,3,2,1,0,1,17,Matches
1482,Juanmi Latasa,es,FW,,Getafe,La Liga,21,2001,5.0,5,4,2,0,3,1,1,100.0,0,3,1,2,1,6,8,Matches
1483,Toni Lato,es,DF,MF,Valencia,La Liga,24,1997,10.2,23,11,9,12,2,9,21,42.9,12,10,1,9,6,29,14,Matches
1484,Danny Latza,de,MF,,Schalke 04,Bundesliga,32,1989,9.5,17,13,8,8,1,5,17,29.4,12,16,1,15,5,22,15,Matches
1485,Armand Lauriente,fr,FW,,Sassuolo,it Serie A,23,1998,24.2,21,15,5,7,9,8,21,38.1,13,20,0,20,12,33,8,Matches
1486,Armand Lauriente,fr,FW,,Lorient,Ligue 1,23,1998,3.0,8,7,3,4,1,3,7,42.9,4,5,1,4,4,12,1,Matches
1487,Roméo Lavia,be,MF,,Southampton,Premier League,18,2004,24.7,60,35,27,29,4,21,53,39.6,32,47,11,36,33,93,23,Matches
1488,Lázaro,br,FW,MF,Almería,La Liga,20,2002,8.0,4,3,3,0,1,3,15,20.0,12,16,1,15,2,6,1,Matches
1489,Valentino Lazaro,at,DF,,Torino,it Serie A,26,1996,15.3,10,5,6,0,4,6,14,42.9,8,16,3,13,3,13,29,Matches
1490,Marko Lazetić,rs,FW,,Milan,it Serie A,18,2004,0.1,0,0,0,0,0,0,0,,0,0,0,0,0,0,0,Matches
1491,Darko Lazović,rs,MF,DF,Hellas Verona,it Serie A,31,1990,24.9,24,13,9,12,3,13,29,44.8,16,14,3,11,16,40,19,Matches
1492,Manuel Lazzari,it,DF,,Lazio,it Serie A,28,1993,20.9,33,21,13,14,6,21,36,58.3,15,20,6,14,18,51,36,Matches
1493,Théo Le Bris,fr,MF,DF,Lorient,Ligue 1,19,2002,16.1,31,19,17,11,3,15,33,45.5,18,21,2,19,18,49,31,Matches
1494,Julien Le Cardinal,fr,DF,,Lens,Ligue 1,24,1997,1.8,6,4,5,0,1,4,6,66.7,2,3,0,3,2,8,5,Matches
1495,Jérémy Le Douaron,fr,MF,FW,Brest,Ligue 1,24,1998,23.0,15,9,5,9,1,3,27,11.1,24,29,2,27,11,26,30,Matches
1496,Enzo Le Fée,fr,MF,,Lorient,Ligue 1,22,2000,33.6,108,64,52,40,16,43,113,38.1,70,50,5,45,34,142,38,Matches
1497,Vincent Le Goff,fr,DF,,Lorient,Ligue 1,32,1989,37.0,75,32,56,16,3,45,62,72.6,17,29,9,20,41,116,105,Matches
1498,Maxime Le Marchand,fr,DF,,Strasbourg,Ligue 1,32,1989,22.4,39,24,23,14,2,19,31,61.3,12,22,14,8,37,76,74,Matches
1499,Robin Le Normand,es,DF,,Real Sociedad,La Liga,25,1996,31.1,36,23,25,9,2,14,27,51.9,13,22,14,8,33,69,93,Matches
1500,Rafael Leão,pt,FW,MF,Milan,it Serie A,23,1999,26.9,8,7,2,3,3,6,14,42.9,8,9,2,7,15,23,8,Matches
1501,Paolo Lebas,fr,MF,,Ajaccio,Ligue 1,19,2003,0.6,0,0,0,0,0,0,0,,0,0,0,0,0,0,0,Matches
1502,Jean-Louis Leca,fr,GK,,Lens,Ligue 1,36,1985,1.0,0,0,0,0,0,0,0,,0,0,0,0,0,0,0,Matches
1503,Benjamin Lecomte,fr,GK,,Espanyol,La Liga,31,1991,10.0,0,0,0,0,0,0,0,,0,0,0,0,0,0,3,Matches
1504,Benjamin Lecomte,fr,GK,,Montpellier,Ligue 1,31,1991,19.0,0,0,0,0,0,0,2,0.0,2,0,0,0,0,0,6,Matches
1505,Jeremías Ledesma,ar,GK,,Cádiz,La Liga,29,1993,34.0,3,2,3,0,0,3,7,42.9,4,1,0,1,2,5,23,Matches
1506,Pierre Lees-Melou,fr,MF,,Brest,Ligue 1,29,1993,30.7,97,55,55,37,5,57,123,46.3,66,48,13,35,52,149,46,Matches
1507,Diogo Leite,pt,DF,,Union Berlin,Bundesliga,23,1999,25.0,35,20,21,14,0,21,34,61.8,13,23,14,9,26,61,99,Matches
1508,Maxim Leitsch,de,DF,,Mainz 05,Bundesliga,24,1998,7.4,9,7,6,3,0,4,5,80.0,1,7,4,3,18,27,26,Matches
1509,Florian Lejeune,fr,DF,,Rayo Vallecano,La Liga,31,1991,28.5,28,17,19,8,1,17,25,68.0,8,24,16,8,15,43,123,Matches
1510,Iñigo Lekue,es,DF,,Athletic Club,La Liga,29,1993,14.7,24,17,20,4,0,12,19,63.2,7,16,2,14,13,37,31,Matches
1511,Thomas Lemar,fr,MF,,Atlético Madrid,La Liga,26,1995,13.9,30,18,10,13,7,10,28,35.7,18,12,3,9,7,37,12,Matches
1512,Félix Lemaréchal,fr,MF,,Brest,Ligue 1,18,2003,3.2,5,5,2,1,2,0,3,0.0,3,6,0,6,1,6,2,Matches
1513,Dexter Lembikisa,jm,DF,,Wolves,Premier League,18,2003,0.3,0,0,0,0,0,0,0,,0,0,0,0,0,0,0,Matches
1514,Mario Lemina,ga,MF,,Wolves,Premier League,28,1993,14.4,38,24,22,13,3,20,38,52.6,18,26,8,18,14,52,24,Matches
1515,Mario Lemina,ga,MF,DF,Nice,Ligue 1,28,1993,9.3,32,21,11,14,7,12,18,66.7,6,13,5,8,11,43,20,Matches
1516,Tim Lemperle,de,FW,MF,Köln,Bundesliga,20,2002,1.5,6,4,3,1,2,3,5,60.0,2,5,0,5,1,7,4,Matches
1517,Clément Lenglet,fr,DF,,Tottenham,Premier League,27,1995,22.4,38,23,18,15,5,16,34,47.1,18,26,11,15,18,56,68,Matches
1518,Bernd Leno,de,GK,,Fulham,Premier League,30,1992,36.0,0,0,0,0,0,0,3,0.0,3,0,0,0,0,0,18,Matches
1519,Christopher Lenz,de,DF,,Eint Frankfurt,Bundesliga,27,1994,14.3,29,21,17,7,5,16,37,43.2,21,16,3,13,21,50,34,Matches
1520,Donovan Léon,gf,GK,,Auxerre,Ligue 1,29,1992,2.0,0,0,0,0,0,0,0,,0,0,0,0,0,0,1,Matches
1521,Sergio León,es,FW,,Valladolid,La Liga,33,1989,14.8,6,4,0,4,2,3,6,50.0,3,6,0,6,0,6,4,Matches
1522,Johann Lepenant,fr,MF,,Lyon,Ligue 1,19,2002,21.5,58,34,24,27,7,32,86,37.2,54,29,5,24,28,86,17,Matches
1523,Mehdi Léris,dz,MF,DF,Sampdoria,it Serie A,24,1998,27.3,63,46,30,24,9,23,55,41.8,32,38,6,32,27,90,34,Matches
1524,Jefferson Lerma,co,MF,,Bournemouth,Premier League,27,1994,36.1,50,30,23,23,4,20,45,44.4,25,32,15,17,47,97,91,Matches
1525,Benjamin Leroy,fr,GK,,Ajaccio,Ligue 1,33,1989,31.1,0,0,0,0,0,0,2,0.0,2,0,0,0,1,1,16,Matches
1526,Léo Leroy,fr,MF,,Montpellier,Ligue 1,22,2000,13.2,53,38,24,26,3,31,57,54.4,26,25,2,23,14,67,8,Matches
1527,Alexandre Letellier,fr,GK,,Paris S-G,Ligue 1,31,1990,0.1,0,0,0,0,0,0,0,,0,0,0,0,0,0,0,Matches
1528,Ruan Levine,br,MF,FW,Ajaccio,Ligue 1,23,1999,0.3,2,2,1,1,0,0,0,,0,1,0,1,2,4,0,Matches
1529,Robert Lewandowski,pl,FW,,Barcelona,La Liga,33,1988,31.6,17,11,2,5,10,7,14,50.0,7,20,0,20,2,19,14,Matches
1530,Jamie Leweling,de,FW,MF,Union Berlin,Bundesliga,21,2001,2.9,5,3,2,2,1,3,5,60.0,2,3,0,3,1,6,0,Matches
1531,Jamal Lewis,nir,DF,FW,Newcastle Utd,Premier League,24,1998,0.1,0,0,0,0,0,0,0,,0,0,0,0,0,0,0,Matches
1532,Rico Lewis,eng,DF,MF,Manchester City,Premier League,17,2004,10.0,16,9,9,5,2,6,11,54.5,5,8,4,4,6,22,13,Matches
1533,Keane Lewis-Potter,eng,FW,MF,Brentford,Premier League,21,2001,3.6,1,0,0,1,0,0,0,,0,5,1,4,0,1,2,Matches
1534,Dimitri Liénard,fr,DF,MF,Strasbourg,Ligue 1,34,1988,17.1,46,29,20,18,8,34,57,59.6,23,28,4,24,16,62,24,Matches
1535,Philipp Lienhart,at,DF,,Freiburg,Bundesliga,26,1996,27.8,29,18,19,10,0,13,27,48.1,14,29,15,14,35,64,97,Matches
1536,Matthijs de Ligt,nl,DF,,Bayern Munich,Bundesliga,22,1999,26.7,32,23,15,16,1,15,24,62.5,9,31,20,11,23,55,85,Matches
1537,Dimitris Limnios,gr,FW,,Köln,Bundesliga,24,1998,0.4,0,0,0,0,0,0,0,,0,0,0,0,1,1,0,Matches
1538,Victor Lindelöf,se,DF,,Manchester Utd,Premier League,28,1994,15.2,22,17,10,9,3,9,17,52.9,8,18,9,9,21,43,63,Matches
1539,Jesper Lindstrøm,dk,MF,FW,Eint Frankfurt,Bundesliga,22,2000,18.7,26,11,15,7,4,7,22,31.8,15,25,3,22,9,35,9,Matches
1540,Karol Linetty,pl,MF,,Torino,it Serie A,27,1995,21.0,32,17,7,22,3,13,25,52.0,12,28,8,20,19,51,25,Matches
1541,Jesse Lingard,eng,FW,MF,Nott'ham Forest,Premier League,29,1992,10.3,4,4,2,2,0,1,7,14.3,6,11,0,11,5,9,4,Matches
1542,Samuel Lino,br,FW,MF,Valencia,La Liga,22,1999,32.1,66,43,17,37,12,26,72,36.1,46,34,0,34,18,84,16,Matches
1543,Pol Lirola,es,DF,,Elche,La Liga,24,1997,7.0,13,6,9,3,1,8,13,61.5,5,3,2,1,7,20,16,Matches
1544,Mateusz Lis,pl,GK,,Troyes,Ligue 1,25,1997,8.3,0,0,0,0,0,0,1,0.0,1,1,0,1,0,0,3,Matches
1545,Marcin Listkowski,pl,MF,FW,Lecce,it Serie A,24,1998,0.9,0,0,0,0,0,0,0,,0,0,0,0,3,3,2,Matches
1546,Valentino Livramento,eng,DF,FW,Southampton,Premier League,19,2002,0.3,2,1,2,0,0,0,0,,0,0,0,0,2,4,3,Matches
1547,Dejan Ljubicic,at,MF,FW,Köln,Bundesliga,24,1997,19.0,25,14,7,14,4,13,40,32.5,27,20,1,19,8,33,8,Matches
1548,Javier Llabrés,es,FW,,Mallorca,La Liga,19,2002,0.2,0,0,0,0,0,0,0,,0,0,0,0,0,0,1,Matches
1549,Diego Llorente,es,DF,,Leeds United,Premier League,28,1993,7.2,13,10,8,5,0,4,8,50.0,4,6,2,4,15,28,24,Matches
1550,Diego Llorente,es,DF,,Roma,it Serie A,28,1993,6.4,10,5,6,4,0,5,12,41.7,7,4,2,2,11,21,20,Matches
1551,Marcos Llorente,es,MF,DF,Atlético Madrid,La Liga,27,1995,18.9,32,15,16,10,6,17,30,56.7,13,26,2,24,17,49,19,Matches
1552,Hugo Lloris,fr,GK,,Tottenham,Premier League,35,1986,24.5,1,1,1,0,0,1,3,33.3,2,0,0,0,1,2,13,Matches
1553,Giovani Lo Celso,ar,MF,FW,Villarreal,La Liga,26,1996,12.5,32,28,7,15,10,12,21,57.1,9,14,2,12,6,38,5,Matches
1554,Stanislav Lobotka,sk,MF,,Napoli,it Serie A,27,1994,34.5,83,44,35,35,13,43,73,58.9,30,29,7,22,23,106,16,Matches
1555,Manuel Locatelli,it,MF,,Juventus,it Serie A,24,1998,27.2,59,33,26,23,10,30,53,56.6,23,50,22,28,27,86,59,Matches
1556,Luka Lochoshvili,ge,DF,,Cremonese,it Serie A,24,1998,20.4,45,19,30,11,4,22,31,71.0,9,31,10,21,22,67,89,Matches
1557,Bradley Locko,fr,DF,,Reims,Ligue 1,20,2002,11.8,31,16,21,4,6,15,27,55.6,12,17,4,13,20,51,21,Matches
1558,Bradley Locko,fr,DF,,Brest,Ligue 1,20,2002,3.0,4,3,2,1,1,2,3,66.7,1,4,0,4,2,6,13,Matches
1559,Renan Lodi,br,DF,,Nott'ham Forest,Premier League,24,1998,24.6,52,39,38,8,6,33,66,50.0,33,25,6,19,33,85,74,Matches
1560,Ruben Loftus-Cheek,eng,MF,DF,Chelsea,Premier League,26,1996,17.1,25,14,8,14,3,12,22,54.5,10,15,2,13,12,37,23,Matches
1561,Sean Longstaff,eng,MF,,Newcastle Utd,Premier League,24,1997,28.0,42,21,16,20,6,20,52,38.5,32,35,8,27,16,58,23,Matches
1562,Ademola Lookman,ng,FW,MF,Atalanta,it Serie A,24,1997,19.2,13,5,2,6,5,3,15,20.0,12,18,0,18,4,17,1,Matches
1563,Anthony Lopes,pt,GK,,Lyon,Ligue 1,31,1990,31.3,1,0,1,0,0,1,4,25.0,3,0,0,0,3,4,10,Matches
1564,Rony Lopes,pt,MF,FW,Troyes,Ligue 1,26,1995,26.1,24,12,6,15,3,7,31,22.6,24,14,2,12,9,33,10,Matches
1565,David López,es,DF,,Girona,La Liga,32,1989,18.4,31,18,17,13,1,19,27,70.4,8,29,19,10,14,45,64,Matches
1566,Diego López,es,GK,,Rayo Vallecano,La Liga,40,1981,1.1,0,0,0,0,0,0,0,,0,0,0,0,0,0,0,Matches
1567,Diego López,es,FW,MF,Valencia,La Liga,20,2002,5.0,2,2,1,1,0,2,15,13.3,13,9,0,9,3,5,5,Matches
1568,Maxime Lopez,fr,MF,,Sassuolo,it Serie A,24,1997,25.5,42,18,26,12,4,16,56,28.6,40,24,6,18,22,64,21,Matches
1569,Pau López,es,GK,,Marseille,Ligue 1,27,1994,32.5,0,0,0,0,0,0,1,0.0,1,0,0,0,0,0,5,Matches
1570,Unai López,es,MF,,Rayo Vallecano,La Liga,26,1995,13.9,32,20,10,17,5,13,37,35.1,24,12,1,11,15,47,6,Matches
1571,Dion Lopy,sn,MF,,Reims,Ligue 1,20,2002,15.3,45,24,22,16,7,23,62,37.1,39,27,3,24,22,67,18,Matches
1572,Anthony Losilla,fr,MF,,Bochum,Bundesliga,36,1986,30.2,76,49,32,34,10,38,77,49.4,39,39,12,27,37,113,67,Matches
1573,Jordan Lotomba,ch,DF,,Nice,Ligue 1,23,1998,27.3,65,38,33,24,8,31,48,64.6,17,38,11,27,32,97,53,Matches
1574,Matteo Lovato,it,DF,,Salernitana,it Serie A,22,2000,9.0,17,14,14,3,0,10,25,40.0,15,8,5,3,13,30,33,Matches
1575,Dejan Lovren,hr,DF,,Lyon,Ligue 1,33,1989,16.2,25,19,20,5,0,20,29,69.0,9,20,10,10,26,51,70,Matches
1576,Sandi Lovrić,si,MF,,Udinese,it Serie A,24,1998,25.9,40,18,16,16,8,25,43,58.1,18,25,2,23,26,66,21,Matches
1577,Jamal Lowe,jm,MF,FW,Bournemouth,Premier League,28,1994,0.1,0,0,0,0,0,0,0,,0,0,0,0,0,0,0,Matches
1578,Anthony Lozano,hn,FW,,Cádiz,La Liga,29,1993,16.0,6,4,1,4,1,1,7,14.3,6,12,1,11,3,9,17,Matches
1579,Hirving Lozano,mx,FW,,Napoli,it Serie A,27,1995,17.8,24,13,10,6,8,9,21,42.9,12,31,0,31,15,39,6,Matches
1580,Pol Lozano,es,MF,,Espanyol,La Liga,22,1999,0.2,0,0,0,0,0,0,0,,0,1,0,1,0,0,1,Matches
1581,Jean Lucas,br,MF,,Monaco,Ligue 1,24,1998,3.2,9,5,3,5,1,6,12,50.0,6,2,1,1,4,13,2,Matches
1582,Jhon Lucumí,co,DF,,Bologna,it Serie A,24,1998,32.2,53,37,39,13,1,24,43,55.8,19,43,26,17,35,88,100,Matches
1583,José Luis Gayà,es,DF,,Valencia,La Liga,27,1995,30.1,80,46,61,16,3,43,74,58.1,31,28,9,19,23,103,48,Matches
1584,José Luis Morales,es,FW,MF,Villarreal,La Liga,35,1987,13.5,7,6,1,2,4,5,17,29.4,12,12,1,11,2,9,2,Matches
1585,José Luis Palomino,ar,DF,,Atalanta,it Serie A,32,1990,8.4,23,14,16,7,0,11,19,57.9,8,11,4,7,28,51,20,Matches
1586,Douglas Luiz,br,MF,,Aston Villa,Premier League,24,1998,32.5,72,42,31,32,9,29,63,46.0,34,36,7,29,40,112,27,Matches
1587,Romelu Lukaku,be,FW,,Inter,it Serie A,29,1993,18.4,3,1,1,0,2,2,5,40.0,3,3,1,2,0,3,16,Matches
1588,Castello Lukeba,fr,DF,,Lyon,Ligue 1,19,2002,33.2,39,23,27,8,4,21,31,67.7,10,42,24,18,75,114,105,Matches
1589,Dodi Lukebakio,be,FW,MF,Hertha BSC,Bundesliga,24,1997,26.6,18,11,7,8,3,6,27,22.2,21,23,5,18,13,31,17,Matches
1590,Saša Lukić,rs,MF,,Fulham,Premier League,25,1996,4.6,8,3,1,4,3,3,7,42.9,4,6,2,4,5,13,3,Matches
1591,Saša Lukić,rs,MF,,Torino,it Serie A,25,1996,13.3,21,14,10,10,1,9,15,60.0,6,17,7,10,13,34,10,Matches
1592,Andriy Lunin,ua,GK,,Real Madrid,La Liga,23,1999,7.0,0,0,0,0,0,0,0,,0,0,0,0,0,0,1,Matches
1593,Andrey Lunyov,ru,GK,,Leverkusen,Bundesliga,30,1991,1.0,0,0,0,0,0,0,0,,0,0,0,0,0,0,0,Matches
1594,Sebastiano Luperto,it,DF,,Empoli,it Serie A,25,1996,34.8,33,18,24,8,1,9,20,45.0,11,54,42,12,43,76,163,Matches
1595,Lyanco,br,DF,,Southampton,Premier League,25,1997,13.1,24,16,15,9,0,12,18,66.7,6,30,25,5,20,44,65,Matches
1596,Charalambos Lykogiannis,gr,DF,,Bologna,it Serie A,28,1993,12.3,16,8,5,6,5,5,13,38.5,8,9,4,5,15,31,30,Matches
1597,Youssouf M'Changama,km,MF,,Auxerre,Ligue 1,31,1990,12.0,22,11,7,12,3,7,13,53.8,6,6,0,6,15,37,6,Matches
1598,Awer Mabil,au,MF,FW,Cádiz,La Liga,26,1995,1.8,2,0,0,1,1,1,3,33.3,2,1,1,0,0,2,1,Matches
1599,Alexis Mac Allister,ar,MF,,Brighton,Premier League,23,1998,32.1,70,39,22,40,8,34,71,47.9,37,26,2,24,22,92,10,Matches
1600,Deiver Machado,co,DF,MF,Lens,Ligue 1,28,1993,24.3,45,26,18,20,7,21,34,61.8,13,21,4,17,21,66,27,Matches
1601,Darwin Machís,ve,FW,,Valladolid,La Liga,29,1993,6.7,3,2,0,2,1,1,8,12.5,7,5,0,5,3,6,4,Matches
1602,James Maddison,eng,MF,FW,Leicester City,Premier League,25,1996,27.6,51,26,25,19,7,19,50,38.0,31,19,1,18,13,64,6,Matches
1603,Noni Madueke,eng,FW,,Chelsea,Premier League,20,2002,7.1,12,8,5,4,3,6,13,46.2,7,13,2,11,4,16,7,Matches
1604,Pablo Maffeo,es,DF,,Mallorca,La Liga,25,1997,33.1,75,46,54,16,5,45,78,57.7,33,38,11,27,26,101,76,Matches
1605,Gabriel Magalhães,br,DF,,Arsenal,Premier League,24,1997,37.9,48,30,29,15,4,18,27,66.7,9,49,26,23,32,80,125,Matches
1606,Lisandro Magallán,ar,DF,,Elche,La Liga,28,1993,10.0,19,11,11,5,3,10,12,83.3,2,14,5,9,13,32,30,Matches
1607,Soungoutou Magassa,fr,MF,,Monaco,Ligue 1,18,2003,0.9,4,1,2,2,0,2,4,50.0,2,3,0,3,1,5,1,Matches
1608,Giulio Maggiore,it,MF,,Salernitana,it Serie A,24,1998,9.9,20,8,11,6,3,10,21,47.6,11,19,4,15,8,28,10,Matches
1609,Giangiacomo Magnani,it,DF,,Hellas Verona,it Serie A,26,1995,17.0,33,22,20,11,2,19,25,76.0,6,20,15,5,21,54,76,Matches
1610,Hugo Magnetti,fr,MF,,Brest,Ligue 1,24,1998,18.8,43,27,18,23,2,23,63,36.5,40,21,1,20,25,68,12,Matches
1611,Yohann Magnin,fr,MF,,Clermont Foot,Ligue 1,25,1997,26.7,89,54,37,45,7,54,106,50.9,52,50,12,38,25,114,46,Matches
1612,Harry Maguire,eng,DF,,Manchester Utd,Premier League,29,1993,8.5,8,6,6,1,1,4,5,80.0,1,18,11,7,13,21,41,Matches
1613,Jon Magunacelaya,es,MF,FW,Real Sociedad,La Liga,22,2000,0.7,1,0,0,0,1,0,2,0.0,2,0,0,0,0,1,1,Matches
1614,Riyad Mahrez,dz,FW,MF,Manchester City,Premier League,31,1991,21.3,30,14,8,13,9,13,39,33.3,26,27,1,26,9,39,5,Matches
1615,Arne Maier,de,MF,,Augsburg,Bundesliga,23,1999,21.8,31,22,17,11,3,10,18,55.6,8,21,0,21,15,46,22,Matches
1616,Mike Maignan,fr,GK,,Milan,it Serie A,27,1995,22.0,1,0,1,0,0,1,1,100.0,0,0,0,0,1,2,10,Matches
1617,Linton Maina,de,FW,MF,Köln,Bundesliga,23,1999,24.9,18,12,5,11,2,7,30,23.3,23,19,0,19,5,23,9,Matches
1618,Kobbie Mainoo,eng,MF,,Manchester Utd,Premier League,17,2005,0.1,0,0,0,0,0,0,0,,0,1,1,0,0,0,0,Matches
1619,Ainsley Maitland-Niles,eng,DF,MF,Southampton,Premier League,24,1997,15.6,45,24,23,18,4,28,44,63.6,16,28,7,21,22,67,45,Matches
1620,Jordan Majchrzak,pl,FW,,Roma,it Serie A,17,2004,0.2,0,0,0,0,0,0,0,,0,0,0,0,0,0,0,Matches
1621,Lovro Majer,hr,MF,FW,Rennes,Ligue 1,24,1998,18.5,34,23,16,13,5,8,29,27.6,21,21,1,20,21,55,5,Matches
1622,Jean-Victor Makengo,fr,MF,,Udinese,it Serie A,24,1998,8.9,16,13,7,7,2,5,9,55.6,4,8,2,6,9,25,3,Matches
1623,Jean-Victor Makengo,fr,MF,,Lorient,Ligue 1,24,1998,11.8,16,8,5,10,1,6,20,30.0,14,8,5,3,10,26,13,Matches
1624,Béni Makouana,cg,FW,MF,Montpellier,Ligue 1,19,2002,2.2,1,0,0,1,0,0,2,0.0,2,3,1,2,0,1,1,Matches
1625,Nemanja Maksimović,rs,MF,,Getafe,La Liga,27,1995,22.8,41,30,17,18,6,19,32,59.4,13,36,14,22,34,75,27,Matches
1626,Tyrell Malacia,nl,DF,,Manchester Utd,Premier League,22,1999,15.5,46,33,33,12,1,14,25,56.0,11,13,3,10,25,71,49,Matches
1627,Lorenzo Malagrida,it,MF,DF,Sampdoria,it Serie A,18,2003,1.2,1,0,0,0,1,1,3,33.3,2,1,0,1,0,1,1,Matches
1628,Daniel Maldini,it,FW,MF,Spezia,it Serie A,20,2001,7.0,12,5,3,4,5,4,11,36.4,7,9,0,9,1,13,8,Matches
1629,Youssef Maleh,ma,MF,,Fiorentina,it Serie A,23,1998,3.3,3,1,0,3,0,0,4,0.0,4,5,0,5,1,4,3,Matches
1630,Youssef Maleh,ma,MF,,Lecce,it Serie A,23,1998,7.5,17,8,3,7,7,6,14,42.9,8,20,1,19,5,22,10,Matches
1631,Donyell Malen,nl,FW,,Dortmund,Bundesliga,23,1999,19.0,13,5,3,4,6,5,12,41.7,7,14,1,13,4,17,11,Matches
1632,Ruslan Malinovskyi,ua,MF,FW,Atalanta,it Serie A,29,1993,6.1,14,8,5,6,3,6,17,35.3,11,8,1,7,5,19,2,Matches
1633,Ruslan Malinovskyi,ua,MF,FW,Marseille,Ligue 1,29,1993,13.6,21,11,3,12,6,10,26,38.5,16,13,1,12,3,24,9,Matches
1634,Hugo Mallo,es,DF,,Celta Vigo,La Liga,31,1991,24.0,53,29,34,14,5,28,42,66.7,14,28,7,21,24,77,73,Matches
1635,Mickael Malsa,mq,MF,,Valladolid,La Liga,26,1995,0.8,2,2,1,1,0,1,4,25.0,3,1,1,0,2,4,3,Matches
1636,Giorgi Mamardashvili,ge,GK,,Valencia,La Liga,21,2000,38.0,0,0,0,0,0,0,0,,0,0,0,0,1,1,11,Matches
1637,Hianga Mananga Mbock,fr,MF,,Brest,Ligue 1,22,1999,0.2,0,0,0,0,0,0,1,0.0,1,0,0,0,0,0,0,Matches
1638,Gianluca Mancini,it,DF,,Roma,it Serie A,26,1996,31.8,37,19,27,9,1,18,34,52.9,16,38,17,21,46,83,67,Matches
1639,Steve Mandanda,fr,GK,,Rennes,Ligue 1,37,1985,33.5,0,0,0,0,0,0,2,0.0,2,0,0,0,0,0,9,Matches
1640,Reinildo Mandava,mz,DF,,Atlético Madrid,La Liga,28,1994,20.6,66,43,46,19,1,38,49,77.6,11,27,12,15,30,96,59,Matches
1641,Aïssa Mandi,dz,DF,,Villarreal,La Liga,30,1991,16.2,18,10,14,3,1,6,12,50.0,6,19,14,5,21,39,58,Matches
1642,Rolando Mandragora,it,MF,,Fiorentina,it Serie A,25,1997,21.7,42,24,12,22,8,23,52,44.2,29,25,3,22,16,58,21,Matches
1643,Sadio Mané,sn,FW,MF,Bayern Munich,Bundesliga,30,1992,15.8,11,5,3,3,5,1,9,11.1,8,15,2,13,0,11,4,Matches
1644,Orel Mangala,be,MF,,Nott'ham Forest,Premier League,24,1998,17.2,28,20,16,10,2,12,29,41.4,17,21,7,14,23,51,15,Matches
1645,Thomas Mangani,fr,MF,,Ajaccio,Ligue 1,35,1987,14.8,32,17,14,15,3,18,47,38.3,29,22,3,19,24,56,22,Matches
1646,Vito Mannone,it,GK,,Lorient,Ligue 1,34,1988,17.9,0,0,0,0,0,0,0,,0,0,0,0,0,0,4,Matches
1647,Javier Manquillo,es,DF,,Newcastle Utd,Premier League,28,1994,0.4,3,2,2,1,0,2,2,100.0,0,1,0,1,1,4,1,Matches
1648,Myziane Maolida,km,MF,FW,Reims,Ligue 1,23,1999,2.6,8,3,2,5,1,5,12,41.7,7,1,0,1,2,10,0,Matches
1649,Myziane Maolida,km,FW,MF,Hertha BSC,Bundesliga,23,1999,1.1,1,1,1,0,0,1,2,50.0,1,0,0,0,0,1,1,Matches
1650,Faitout Maouassa,fr,FW,DF,Montpellier,Ligue 1,24,1998,21.4,52,32,26,20,6,18,41,43.9,23,31,3,28,20,72,23,Matches
1651,Sekou Mara,fr,FW,MF,Southampton,Premier League,20,2002,6.2,14,10,5,8,1,3,9,33.3,6,11,0,11,1,15,5,Matches
1652,Marcão,br,DF,,Sevilla,La Liga,26,1996,4.2,2,2,1,1,0,1,1,100.0,0,3,3,0,6,8,14,Matches
1653,Solly March,eng,FW,DF,Brighton,Premier League,28,1994,30.2,53,31,16,17,20,8,28,28.6,20,34,3,31,24,77,32,Matches
1654,Agustín Marchesín,ar,GK,,Celta Vigo,La Liga,34,1988,19.0,0,0,0,0,0,0,1,0.0,1,0,0,0,0,0,7,Matches
1655,Federico Marchetti,it,GK,,Spezia,it Serie A,39,1983,0.7,0,0,0,0,0,0,0,,0,0,0,0,0,0,0,Matches
1656,Vincent Marchetti,fr,MF,,Ajaccio,Ligue 1,25,1997,27.2,55,26,29,19,7,25,68,36.8,43,23,3,20,19,74,31,Matches
1657,Riccardo Marchizza,it,DF,,Sassuolo,it Serie A,24,1998,3.1,2,2,1,1,0,2,4,50.0,2,2,0,2,2,4,8,Matches
1658,Gian Marco Ferrari,it,DF,,Sassuolo,it Serie A,30,1992,24.7,23,16,11,10,2,10,17,58.8,7,29,20,9,23,46,81,Matches
1659,Emiliano Marcondes,dk,MF,,Bournemouth,Premier League,27,1995,0.1,0,0,0,0,0,0,0,,0,0,0,0,0,0,1,Matches
1660,Óscar de Marcos,es,DF,,Athletic Club,La Liga,33,1989,31.3,67,33,34,22,11,40,76,52.6,36,42,6,36,29,96,59,Matches
1661,Alberto Marí,es,FW,MF,Valencia,La Liga,21,2001,1.0,0,0,0,0,0,0,2,0.0,2,0,0,0,0,0,1,Matches
1662,José Mari,es,MF,,Cádiz,La Liga,34,1987,4.4,16,7,12,3,1,10,16,62.5,6,3,1,2,5,21,9,Matches
1663,Pablo Marí,es,DF,,Monza,it Serie A,28,1993,27.6,37,19,29,7,1,17,26,65.4,9,22,14,8,31,68,111,Matches
1664,José María Giménez,uy,DF,,Atlético Madrid,La Liga,27,1995,26.9,43,25,28,14,1,24,35,68.6,11,37,17,20,24,67,138,Matches
1665,Mariano,do,FW,,Real Madrid,La Liga,28,1993,1.7,1,0,0,1,0,0,0,,0,1,0,1,0,1,0,Matches
1666,Pablo Marín,es,MF,FW,Real Sociedad,La Liga,19,2003,4.0,10,5,5,4,1,2,7,28.6,5,1,0,1,4,14,2,Matches
1667,Răzvan Marin,ro,MF,,Empoli,it Serie A,26,1996,28.2,44,22,22,21,1,19,40,47.5,21,29,11,18,14,58,33,Matches
1668,Diego Mariño,es,GK,,Almería,La Liga,32,1990,0.5,0,0,0,0,0,0,0,,0,0,0,0,0,0,0,Matches
1669,Guillermo Maripán,cl,DF,,Monaco,Ligue 1,28,1994,24.0,46,26,26,20,0,17,33,51.5,16,39,27,12,38,84,87,Matches
1670,Marlon,br,DF,,Monza,it Serie A,26,1995,17.7,35,21,20,14,1,15,29,51.7,14,13,4,9,18,53,50,Matches
1671,Omar Marmoush,eg,FW,,Wolfsburg,Bundesliga,23,1999,16.4,16,10,8,2,6,4,16,25.0,12,21,1,20,7,23,4,Matches
1672,Marquinhos,br,MF,,Arsenal,Premier League,19,2003,0.0,0,0,0,0,0,0,0,,0,0,0,0,0,0,0,Matches
1673,Marquinhos,br,DF,,Paris S-G,Ligue 1,28,1994,30.2,33,25,18,12,3,18,26,69.2,8,43,27,16,23,56,83,Matches
1674,Luca Marrone,it,DF,,Monza,it Serie A,32,1990,1.5,0,0,0,0,0,0,2,0.0,2,2,2,0,0,0,4,Matches
1675,Eric Martel,de,MF,,Köln,Bundesliga,20,2002,22.4,66,41,29,30,7,30,60,50.0,30,29,9,20,33,99,49,Matches
1676,Roger Martí,es,FW,,Elche,La Liga,31,1991,7.3,5,2,3,2,0,1,5,20.0,4,4,0,4,1,6,7,Matches
1677,Roger Martí,es,FW,,Cádiz,La Liga,31,1991,7.1,6,4,2,3,1,1,8,12.5,7,7,0,7,2,8,7,Matches
1678,Anthony Martial,fr,FW,,Manchester Utd,Premier League,26,1995,10.9,5,3,0,2,3,1,4,25.0,3,11,2,9,1,6,4,Matches
1679,Aarón Martín,es,DF,,Mainz 05,Bundesliga,25,1997,20.5,42,27,25,11,6,21,40,52.5,19,22,1,21,15,57,31,Matches
1680,Ander Martin,es,MF,FW,Real Sociedad,La Liga,21,2000,0.5,2,2,1,1,0,1,4,25.0,3,0,0,0,0,2,1,Matches
1681,Andrés Martín,es,FW,MF,Rayo Vallecano,La Liga,23,1999,2.3,4,2,2,1,1,3,5,60.0,2,2,0,2,1,5,2,Matches
1682,Carlos Martín,es,FW,MF,Atlético Madrid,La Liga,20,2002,0.3,2,2,0,2,0,2,3,66.7,1,0,0,0,1,3,0,Matches
1683,Iván Martín,es,MF,,Girona,La Liga,23,1999,17.6,9,7,4,4,1,8,23,34.8,15,12,0,12,9,18,12,Matches
1684,Jonas Martin,fr,MF,,Lille,Ligue 1,32,1990,3.1,9,7,4,5,0,5,14,35.7,9,3,1,2,7,16,3,Matches
1685,Gabriel Martinelli,br,FW,,Arsenal,Premier League,21,2001,31.0,31,18,13,12,6,9,22,40.9,13,24,1,23,9,40,14,Matches
1686,Arnau Martinez,es,DF,,Girona,La Liga,19,2003,30.4,69,45,41,19,9,38,85,44.7,47,44,10,34,25,94,54,Matches
1687,Emiliano Martínez,ar,GK,,Aston Villa,Premier League,29,1992,34.9,0,0,0,0,0,0,2,0.0,2,0,0,0,1,1,23,Matches
1688,Iñigo Martínez,es,DF,,Athletic Club,La Liga,31,1991,14.9,18,8,11,7,0,6,9,66.7,3,17,11,6,18,36,55,Matches
1689,Lautaro Martínez,ar,FW,,Inter,it Serie A,24,1997,28.6,25,14,3,15,7,7,23,30.4,16,31,1,30,13,38,16,Matches
1690,Lisandro Martínez,ar,DF,,Manchester Utd,Premier League,24,1998,23.5,54,28,33,18,3,30,43,69.8,13,51,27,24,33,87,103,Matches
1691,Lucas Martínez Quarta,ar,DF,,Fiorentina,it Serie A,26,1996,24.1,80,48,44,32,4,42,61,68.9,19,41,19,22,48,128,78,Matches
1692,Roger Martínez,es,DF,,Espanyol,La Liga,18,2004,0.1,0,0,0,0,0,0,0,,0,0,0,0,0,0,0,Matches
1693,Gelson Martins,pt,MF,FW,Monaco,Ligue 1,27,1995,3.8,15,8,6,4,5,4,13,30.8,9,4,1,3,3,18,2,Matches
1694,Adam Marušić,me,DF,,Lazio,it Serie A,29,1992,30.7,41,30,23,14,4,25,39,64.1,14,20,6,14,38,79,63,Matches
1695,Omar Mascarell,gq,MF,DF,Elche,La Liga,29,1993,27.2,53,26,32,19,2,31,64,48.4,33,51,19,32,45,98,54,Matches
1696,Adam Masina,ma,DF,,Udinese,it Serie A,28,1994,8.8,10,7,7,3,0,6,15,40.0,9,11,4,7,10,20,28,Matches
1697,Jordi Masip,es,GK,,Valladolid,La Liga,33,1989,27.9,0,0,0,0,0,0,2,0.0,2,0,0,0,1,1,3,Matches
1698,Erhan Mašović,rs,DF,MF,Bochum,Bundesliga,23,1998,24.2,50,31,28,21,1,30,51,58.8,21,30,14,16,27,77,79,Matches
1699,Han-Noah Massengo,fr,MF,,Auxerre,Ligue 1,21,2001,12.4,27,15,10,15,2,7,16,43.8,9,12,3,9,14,41,7,Matches
1700,Yanis Massolin,fr,MF,,Clermont Foot,Ligue 1,19,2002,0.7,2,1,1,0,1,0,1,0.0,1,1,0,1,2,4,0,Matches
1701,Jaime Mata,es,FW,MF,Getafe,La Liga,33,1988,4.9,13,10,4,5,4,7,22,31.8,15,7,2,5,3,16,6,Matches
1702,Pape Matar Sarr,sn,MF,FW,Tottenham,Premier League,19,2002,2.4,7,6,4,2,1,4,8,50.0,4,3,2,1,6,13,6,Matches
1703,Eliot Matazo,be,MF,,Monaco,Ligue 1,20,2002,13.1,26,12,11,13,2,11,26,42.3,15,18,4,14,15,41,11,Matches
1704,Jean-Philippe Mateta,fr,FW,,Crystal Palace,Premier League,25,1997,8.6,7,1,2,4,1,1,3,33.3,2,3,1,2,3,10,18,Matches
1705,Nemanja Matić,rs,MF,,Roma,it Serie A,33,1988,20.6,47,27,24,19,4,19,33,57.6,14,27,7,20,25,72,21,Matches
1706,Joël Matip,cm,DF,,Liverpool,Premier League,30,1991,12.1,14,8,12,2,0,11,23,47.8,12,8,3,5,21,35,45,Matches
1707,Henning Matriciani,de,DF,,Schalke 04,Bundesliga,22,2000,20.7,43,23,28,12,3,26,60,43.3,34,28,11,17,23,66,57,Matches
1708,Chrislain Matsima,fr,DF,MF,Lorient,Ligue 1,20,2002,2.5,0,0,0,0,0,0,0,,0,3,3,0,2,2,7,Matches
1709,Chrislain Matsima,fr,DF,,Monaco,Ligue 1,20,2002,5.0,11,6,7,2,2,4,7,57.1,3,5,5,0,9,20,16,Matches
1710,Jean Mattéo Bahoya,fr,FW,MF,Angers,Ligue 1,17,2005,3.0,7,3,1,3,3,4,7,57.1,3,4,0,4,0,7,0,Matches
1711,Azor Matusiwa,nl,MF,,Reims,Ligue 1,24,1998,27.6,66,41,30,29,7,36,61,59.0,25,37,11,26,46,112,52,Matches
1712,Neal Maupay,fr,FW,,Everton,Premier League,25,1996,12.4,11,5,3,4,4,2,4,50.0,2,8,0,8,5,16,0,Matches
1713,Aïman Maurer,ma,MF,,Clermont Foot,Ligue 1,17,2004,5.6,2,1,1,1,0,1,10,10.0,9,1,0,1,3,5,5,Matches
1714,Stephy Mavididi,eng,FW,,Montpellier,Ligue 1,24,1998,14.3,24,19,12,8,4,13,27,48.1,14,21,1,20,4,28,10,Matches
1715,Konstantinos Mavropanos,gr,DF,,Stuttgart,Bundesliga,24,1997,25.4,50,27,32,15,3,28,38,73.7,10,39,18,21,63,113,99,Matches
1716,Christian Mawissa,fr,DF,,Toulouse,Ligue 1,17,2005,1.1,2,0,1,1,0,1,3,33.3,2,0,0,0,3,5,1,Matches
1717,Philipp Max,de,DF,,Eint Frankfurt,Bundesliga,28,1993,7.7,12,9,4,7,1,5,16,31.3,11,10,2,8,3,15,11,Matches
1718,Eric Maxim Choupo-Moting,cm,FW,,Bayern Munich,Bundesliga,33,1989,12.4,10,7,2,6,2,1,2,50.0,1,8,0,8,0,10,5,Matches
1719,Luís Maximiano,pt,GK,,Lazio,it Serie A,23,1999,0.1,0,0,0,0,0,0,0,,0,0,0,0,0,0,0,Matches
1720,Keke Maximilian Topp,de,FW,,Schalke 04,Bundesliga,18,2004,0.2,0,0,0,0,0,0,0,,0,0,0,0,1,1,0,Matches
1721,Fernand Mayembo,cg,DF,,Ajaccio,Ligue 1,26,1996,7.9,8,5,6,2,0,4,9,44.4,5,2,0,2,11,19,36,Matches
1722,Borja Mayoral,es,FW,,Getafe,La Liga,25,1997,30.7,9,4,7,2,0,5,31,16.1,26,18,0,18,3,12,10,Matches
1723,Ibrahim Maza,dz,MF,FW,Hertha BSC,Bundesliga,16,2005,0.8,1,1,1,0,0,0,1,0.0,1,2,0,2,0,1,1,Matches
1724,Derek Mazou-Sacko,fr,MF,,Troyes,Ligue 1,17,2004,0.2,0,0,0,0,0,0,1,0.0,1,1,0,1,1,1,1,Matches
1725,Noussair Mazraoui,ma,DF,,Bayern Munich,Bundesliga,24,1997,11.9,29,21,9,9,11,15,24,62.5,9,13,2,11,10,39,25,Matches
1726,Pasquale Mazzocchi,it,DF,,Salernitana,it Serie A,27,1995,21.8,32,18,21,5,6,17,37,45.9,20,10,2,8,10,42,37,Matches
1727,Kevin Mbabu,ch,DF,FW,Fulham,Premier League,27,1995,1.6,3,2,2,1,0,1,3,33.3,2,2,0,2,3,6,3,Matches
1728,Noah Mbamba,be,MF,,Leverkusen,Bundesliga,17,2005,0.0,0,0,0,0,0,0,0,,0,0,0,0,0,0,0,Matches
1729,Kylian Mbappé,fr,FW,,Paris S-G,Ligue 1,23,1998,31.3,10,4,0,5,5,5,16,31.3,11,5,0,5,5,15,6,Matches
1730,Mamadou Mbaye,sn,DF,,Cádiz,La Liga,24,1998,8.4,10,7,7,3,0,6,8,75.0,2,10,8,2,7,17,50,Matches
1731,Chancel Mbemba,cd,DF,,Marseille,Ligue 1,27,1994,31.7,43,26,24,17,2,22,31,71.0,9,25,12,13,42,85,89,Matches
1732,Bryan Mbeumo,cm,FW,,Brentford,Premier League,22,1999,32.3,26,18,5,13,8,8,42,19.0,34,24,1,23,13,39,21,Matches
1733,Jason Mbock,fr,MF,FW,Angers,Ligue 1,22,1999,0.3,0,0,0,0,0,0,0,,0,0,0,0,0,0,0,Matches
1734,Jean-Manuel Mbom,de,MF,,Werder Bremen,Bundesliga,22,2000,0.1,0,0,0,0,0,0,1,0.0,1,0,0,0,0,0,0,Matches
1735,Nathanael Mbuku,cd,FW,MF,Reims,Ligue 1,20,2002,0.7,2,1,2,0,0,2,2,100.0,0,0,0,0,0,2,0,Matches
1736,Nathanael Mbuku,cd,MF,FW,Augsburg,Bundesliga,20,2002,0.4,1,0,0,1,0,0,0,,0,0,0,0,0,1,0,Matches
1737,James McArthur,sct,MF,,Crystal Palace,Premier League,34,1987,0.6,1,1,1,0,0,1,1,100.0,0,2,1,1,1,2,2,Matches
1738,Alex McCarthy,eng,GK,,Southampton,Premier League,32,1989,6.0,0,0,0,0,0,0,1,0.0,1,0,0,0,1,1,3,Matches
1739,John McGinn,sct,MF,FW,Aston Villa,Premier League,27,1994,29.9,66,36,27,29,10,34,71,47.9,37,43,4,39,24,90,19,Matches
1740,Scott McKenna,sct,DF,,Nott'ham Forest,Premier League,25,1996,17.5,12,7,7,3,2,6,10,60.0,4,20,14,6,12,24,85,Matches
1741,Weston McKennie,us,MF,,Leeds United,Premier League,23,1998,16.0,30,13,5,18,7,10,29,34.5,19,22,3,19,22,52,26,Matches
1742,Weston McKennie,us,MF,DF,Juventus,it Serie A,23,1998,11.7,14,5,3,9,2,5,8,62.5,3,15,4,11,11,25,15,Matches
1743,Dwight McNeil,eng,FW,MF,Everton,Premier League,22,1999,27.8,64,41,35,14,15,27,65,41.5,38,46,7,39,31,95,41,Matches
1744,Scott McTominay,sct,MF,,Manchester Utd,Premier League,25,1996,12.9,32,19,16,10,6,13,22,59.1,9,15,6,9,14,46,45,Matches
1745,Gary Medel,cl,MF,DF,Bologna,it Serie A,34,1987,16.4,25,15,16,7,2,9,16,56.3,7,17,10,7,28,53,34,Matches
1746,Facundo Medina,ar,DF,,Lens,Ligue 1,23,1999,30.9,31,20,16,15,0,13,35,37.1,22,25,9,16,26,57,62,Matches
1747,Fernando Medrano,es,DF,,Celta Vigo,La Liga,22,2000,0.1,2,1,2,0,0,1,1,100.0,0,0,0,0,1,3,1,Matches
1748,Ben Mee,eng,DF,,Brentford,Premier League,32,1989,36.3,45,24,28,13,4,20,37,54.1,17,54,42,12,48,93,122,Matches
1749,Bamo Meïté,ci,DF,,Lorient,Ligue 1,20,2001,16.7,18,8,13,4,1,7,16,43.8,9,33,23,10,16,34,70,Matches
1750,Soualiho Meïté,fr,MF,,Cremonese,it Serie A,28,1994,26.3,47,31,25,15,7,22,46,47.8,24,27,6,21,27,74,36,Matches
1751,Farid El Melali,dz,DF,FW,Angers,Ligue 1,25,1997,9.0,21,12,7,12,2,11,22,50.0,11,16,0,16,8,29,7,Matches
1752,Gonzalo Melero,es,MF,,Almería,La Liga,28,1994,20.6,32,16,9,18,5,11,39,28.2,28,23,2,21,7,39,19,Matches
1753,Birger Meling,no,DF,,Rennes,Ligue 1,27,1994,13.4,24,15,9,12,3,12,25,48.0,13,18,2,16,23,47,26,Matches
1754,Memphis,nl,FW,,Atlético Madrid,La Liga,28,1994,3.0,1,0,0,0,1,0,1,0.0,1,0,0,0,0,1,0,Matches
1755,Memphis,nl,FW,,Barcelona,La Liga,28,1994,1.3,1,1,1,0,0,0,1,0.0,1,0,0,0,0,1,0,Matches
1756,Houboulang Mendes,gw,DF,,Almería,La Liga,24,1998,9.8,19,11,16,3,0,11,27,40.7,16,12,2,10,7,26,23,Matches
1757,Nuno Mendes,pt,DF,,Paris S-G,Ligue 1,20,2002,17.2,45,30,29,12,4,30,41,73.2,11,19,3,16,17,62,18,Matches
1758,Pedro Mendes,pt,DF,,Montpellier,Ligue 1,31,1990,0.1,0,0,0,0,0,0,0,,0,0,0,0,0,0,0,Matches
1759,Thiago Mendes,br,MF,DF,Lyon,Ligue 1,30,1992,22.9,48,27,24,21,3,30,40,75.0,10,28,8,20,47,95,51,Matches
1760,Brais Méndez,es,MF,,Real Sociedad,La Liga,25,1997,26.7,58,34,18,30,10,24,64,37.5,40,27,3,24,12,70,14,Matches
1761,Diego Méndez,es,MF,,Rayo Vallecano,La Liga,18,2003,0.0,0,0,0,0,0,0,0,,0,0,0,0,1,1,0,Matches
1762,Antoine Mendy,fr,DF,,Nice,Ligue 1,18,2004,5.8,22,13,16,5,1,9,15,60.0,6,6,1,5,2,24,16,Matches
1763,Arial Mendy,sn,DF,,Clermont Foot,Ligue 1,27,1994,2.5,4,2,3,0,1,2,2,100.0,0,2,0,2,4,8,4,Matches
1764,Batista Mendy,fr,MF,DF,Angers,Ligue 1,22,2000,31.8,70,30,34,28,8,37,53,69.8,16,38,6,32,21,91,29,Matches
1765,Edouard Mendy,sn,GK,,Chelsea,Premier League,30,1992,9.5,0,0,0,0,0,0,0,,0,0,0,0,0,0,3,Matches
1766,Ferland Mendy,fr,DF,,Real Madrid,La Liga,27,1995,15.0,21,12,14,6,1,12,20,60.0,8,7,2,5,14,35,16,Matches
1767,Nampalys Mendy,sn,MF,,Leicester City,Premier League,30,1992,8.4,13,9,7,6,0,8,15,53.3,7,20,4,16,13,26,2,Matches
1768,Gideon Mensah,gh,DF,,Auxerre,Ligue 1,24,1998,25.1,80,44,43,32,5,44,77,57.1,33,33,10,23,38,118,41,Matches
1769,Chris Mepham,wls,DF,,Bournemouth,Premier League,24,1997,24.4,45,22,37,8,0,19,30,63.3,11,40,27,13,30,75,152,Matches
1770,Jorge Meré,es,DF,,Cádiz,La Liga,25,1997,6.7,11,7,9,2,0,5,8,62.5,3,9,6,3,6,17,32,Matches
1771,Alex Meret,it,GK,,Napoli,it Serie A,25,1997,34.0,0,0,0,0,0,0,0,,0,0,0,0,0,0,6,Matches
1772,Mikel Merino,es,MF,,Real Sociedad,La Liga,26,1996,27.7,77,49,28,33,16,31,62,50.0,31,38,8,30,20,97,51,Matches
1773,Quentin Merlin,fr,DF,,Nantes,Ligue 1,20,2002,19.9,31,19,19,8,4,18,38,47.4,20,27,4,23,24,55,30,Matches
1774,Yıldırım Mert Çetin,tr,DF,,Lecce,it Serie A,25,1997,0.2,1,0,1,0,0,0,0,,0,0,0,0,1,2,1,Matches
1775,Roque Mesa,es,MF,,Valladolid,La Liga,33,1989,18.0,27,15,16,10,1,12,38,31.6,26,16,4,12,13,40,18,Matches
1776,Illan Meslier,fr,GK,,Leeds United,Premier League,22,2000,34.0,2,1,2,0,0,2,4,50.0,2,0,0,0,1,3,30,Matches
1777,Lionel Messi,ar,FW,MF,Paris S-G,Ligue 1,35,1987,31.5,26,18,1,13,12,11,27,40.7,16,11,0,11,2,28,0,Matches
1778,Junior Messias,br,FW,DF,Milan,it Serie A,31,1991,16.6,24,18,9,9,6,5,19,26.3,14,20,4,16,7,31,28,Matches
1779,Amine Messoussa,fr,FW,,Lille,Ligue 1,17,2004,0.0,0,0,0,0,0,0,0,,0,0,0,0,0,0,0,Matches
1780,Thomas Meunier,be,DF,,Dortmund,Bundesliga,30,1991,6.5,16,7,8,5,3,10,17,58.8,7,7,2,5,9,25,16,Matches
1781,Alexander Meyer,de,GK,,Dortmund,Bundesliga,31,1991,7.0,0,0,0,0,0,0,1,0.0,1,0,0,0,0,0,1,Matches
1782,Sven Michel,de,FW,MF,Union Berlin,Bundesliga,32,1990,5.5,9,5,1,5,3,4,8,50.0,4,5,1,4,0,9,4,Matches
1783,Alex Mighten,eng,FW,,Nott'ham Forest,Premier League,20,2002,0.1,0,0,0,0,0,0,1,0.0,1,0,0,0,0,0,0,Matches
1784,Tommaso Milanese,it,MF,,Cremonese,it Serie A,20,2002,0.3,0,0,0,0,0,0,0,,0,1,1,0,0,0,0,Matches
1785,Nikola Milenković,rs,DF,,Fiorentina,it Serie A,24,1997,23.7,40,25,20,17,3,18,27,66.7,9,27,14,13,22,62,72,Matches
1786,Lewis Miley,eng,MF,,Newcastle Utd,Premier League,16,2006,0.2,0,0,0,0,0,0,0,,0,1,0,1,0,0,0,Matches
1787,Arkadiusz Milik,pl,FW,,Juventus,it Serie A,28,1994,17.6,12,8,2,8,2,2,8,25.0,6,10,1,9,1,13,14,Matches
1788,Arkadiusz Milik,pl,FW,,Marseille,Ligue 1,28,1994,1.4,1,1,0,0,1,0,1,0.0,1,0,0,0,0,1,2,Matches
1789,Sergej Milinković-Savić,rs,MF,,Lazio,it Serie A,27,1995,33.6,58,35,22,23,13,24,67,35.8,43,50,12,38,28,86,49,Matches
1790,Vanja Milinković-Savić,rs,GK,,Torino,it Serie A,25,1997,38.0,2,1,2,0,0,2,2,100.0,0,0,0,0,1,3,19,Matches
1791,Éder Militão,br,DF,,Real Madrid,La Liga,24,1998,30.0,46,32,25,18,3,26,33,78.8,7,67,39,28,42,88,104,Matches
1792,Luka Milivojević,rs,MF,,Crystal Palace,Premier League,31,1991,5.7,13,7,7,4,2,7,10,70.0,3,13,4,9,12,25,10,Matches
1793,Luis Milla,es,MF,,Getafe,La Liga,27,1994,20.6,48,30,21,18,9,19,44,43.2,25,13,1,12,32,80,25,Matches
1794,Pere Milla,es,FW,MF,Elche,La Liga,29,1992,20.5,31,20,18,8,5,14,41,34.1,27,18,3,15,9,40,19,Matches
1795,Enzo Millot,fr,MF,,Stuttgart,Bundesliga,20,2002,9.9,23,16,9,10,4,12,19,63.2,7,20,3,17,12,35,7,Matches
1796,James Milner,eng,MF,DF,Liverpool,Premier League,36,1986,10.1,26,16,11,11,4,15,34,44.1,19,14,2,12,12,38,15,Matches
1797,Marko Milovanović,rs,FW,,Almería,La Liga,18,2003,0.2,0,0,0,0,0,0,0,,0,0,0,0,0,0,0,Matches
1798,Kim Min-jae,kr,DF,,Napoli,it Serie A,25,1996,33.9,55,30,32,22,1,25,29,86.2,4,36,26,10,41,96,123,Matches
1799,Yerry Mina,co,DF,,Everton,Premier League,27,1994,6.6,15,8,9,6,0,9,11,81.8,2,7,4,3,6,21,28,Matches
1800,Takumi Minamino,jp,MF,FW,Monaco,Ligue 1,27,1995,8.0,15,8,5,7,3,7,35,20.0,28,14,0,14,6,21,4,Matches
1801,Tyrone Mings,eng,DF,,Aston Villa,Premier League,29,1993,35.0,15,7,10,5,0,9,20,45.0,11,40,21,19,54,69,163,Matches
1802,Óscar Mingueza,es,DF,,Celta Vigo,La Liga,23,1999,14.3,37,21,27,9,1,25,32,78.1,7,10,4,6,12,49,25,Matches
1803,Rafa Mir,es,FW,,Sevilla,La Liga,25,1997,14.4,8,2,2,4,2,2,5,40.0,3,5,1,4,4,12,11,Matches
1804,Aleksei Miranchuk,ru,MF,,Torino,it Serie A,26,1995,23.2,11,5,3,4,4,3,11,27.3,8,11,0,11,2,13,5,Matches
1805,Juan Miranda,es,DF,,Betis,La Liga,22,2000,16.4,23,16,16,6,1,14,29,48.3,15,20,7,13,20,43,63,Matches
1806,Antonio Mirante,it,GK,,Milan,it Serie A,39,1983,0.0,0,0,0,0,0,0,0,,0,0,0,0,0,0,0,Matches
1807,Fabio Miretti,it,MF,FW,Juventus,it Serie A,18,2003,13.7,24,11,15,6,3,12,29,41.4,17,20,1,19,4,28,11,Matches
1808,Filippo Missori,it,DF,,Roma,it Serie A,18,2004,2.0,4,3,3,0,1,3,6,50.0,3,0,0,0,3,7,5,Matches
1809,Tyrick Mitchell,eng,DF,,Crystal Palace,Premier League,22,1999,32.1,71,49,43,23,5,30,53,56.6,23,48,11,37,42,113,78,Matches
1810,Kaoru Mitoma,jp,FW,MF,Brighton,Premier League,25,1997,25.8,44,27,15,16,13,20,41,48.8,21,25,0,25,17,61,10,Matches
1811,Aleksandar Mitrović,rs,FW,,Fulham,Premier League,27,1994,22.3,14,7,8,4,2,5,12,41.7,7,22,5,17,3,17,20,Matches
1812,Stefan Mitrović,rs,DF,,Getafe,La Liga,32,1990,18.7,14,6,12,2,0,7,11,63.6,4,12,10,2,17,31,90,Matches
1813,Maximilian Mittelstädt,de,DF,MF,Hertha BSC,Bundesliga,25,1997,9.4,39,20,31,6,2,17,39,43.6,22,13,2,11,26,65,27,Matches
1814,Henrikh Mkhitaryan,am,MF,,Inter,it Serie A,33,1989,22.1,41,26,13,22,6,14,41,34.1,27,27,4,23,21,62,18,Matches
1815,Anthony Modeste,fr,FW,,Dortmund,Bundesliga,34,1988,9.0,4,4,2,0,2,2,5,40.0,3,7,0,7,2,6,22,Matches
1816,Luka Modrić,hr,MF,,Real Madrid,La Liga,36,1985,19.4,19,9,6,6,7,10,25,40.0,15,15,5,10,10,29,7,Matches
1817,Terem Moffi,ng,FW,,Nice,Ligue 1,23,1999,14.8,12,6,0,6,6,2,12,16.7,10,3,0,3,2,14,5,Matches
1818,Terem Moffi,ng,FW,,Lorient,Ligue 1,23,1999,15.4,8,5,1,4,3,3,5,60.0,2,11,3,8,3,11,10,Matches
1819,Mostafa Mohamed,eg,FW,,Nantes,Ligue 1,24,1997,21.5,18,13,5,7,6,9,20,45.0,11,23,1,22,10,28,33,Matches
1820,Tobias Mohr,de,DF,MF,Schalke 04,Bundesliga,26,1995,9.3,8,5,3,5,0,2,7,28.6,5,14,5,9,8,16,19,Matches
1821,Johan Mojica,co,DF,,Villarreal,La Liga,29,1992,7.1,13,9,9,3,1,5,9,55.6,4,8,3,5,4,17,14,Matches
1822,Johan Mojica,co,DF,MF,Elche,La Liga,29,1992,3.0,6,3,5,1,0,2,3,66.7,1,3,2,1,4,10,5,Matches
1823,Clinton Mola,eng,DF,,Stuttgart,Bundesliga,21,2001,0.2,3,1,2,1,0,1,1,100.0,0,1,1,0,1,4,2,Matches
1824,Nahuel Molina,ar,DF,,Atlético Madrid,La Liga,24,1998,31.9,69,43,38,18,13,39,91,42.9,52,38,7,31,18,87,63,Matches
1825,Salvatore Molina,it,DF,,Monza,it Serie A,30,1992,2.5,6,5,2,4,0,4,5,80.0,1,4,2,2,1,7,2,Matches
1826,Florent Mollet,fr,MF,,Nantes,Ligue 1,30,1991,12.1,14,6,5,4,5,7,24,29.2,17,12,1,11,10,24,11,Matches
1827,Florent Mollet,fr,MF,,Schalke 04,Bundesliga,30,1991,4.6,4,1,0,4,0,2,7,28.6,5,7,1,6,1,5,1,Matches
1828,Jon Moncayola,es,MF,DF,Osasuna,La Liga,24,1998,27.2,55,39,24,22,9,30,76,39.5,46,37,5,32,17,72,32,Matches
1829,Monchu,es,MF,,Valladolid,La Liga,22,1999,22.6,50,29,20,21,9,19,46,41.3,27,28,11,17,18,68,22,Matches
1830,César Montes,mx,DF,,Espanyol,La Liga,25,1997,17.7,17,9,10,7,0,10,18,55.6,8,19,12,7,14,31,101,Matches
1831,Daniele Montevago,it,FW,,Sampdoria,it Serie A,19,2003,2.6,1,0,0,0,1,0,1,0.0,1,2,1,1,0,1,1,Matches
1832,Gonzalo Montiel,ar,DF,,Sevilla,La Liga,25,1997,16.9,26,15,12,14,0,15,29,51.7,14,25,7,18,19,45,38,Matches
1833,Lorenzo Montipò,it,GK,,Hellas Verona,it Serie A,26,1996,37.0,1,0,1,0,0,0,3,0.0,3,1,0,1,0,1,26,Matches
1834,Martín Montoya,es,DF,,Betis,La Liga,31,1991,5.0,13,8,9,4,0,10,12,83.3,2,6,1,5,9,22,14,Matches
1835,Kieffer Moore,wls,FW,,Bournemouth,Premier League,29,1992,14.2,14,11,2,9,3,5,16,31.3,11,12,5,7,1,15,26,Matches
1836,Andrew Moran,ie,FW,,Brighton,Premier League,18,2003,0.1,0,0,0,0,0,0,0,,0,1,0,1,0,0,0,Matches
1837,Álvaro Morata,es,FW,,Atlético Madrid,La Liga,29,1992,21.1,16,11,4,8,4,3,8,37.5,5,11,3,8,0,16,23,Matches
1838,Jon Morcillo,es,FW,MF,Athletic Club,La Liga,23,1998,0.8,1,0,1,0,0,0,1,0.0,1,0,0,0,1,2,0,Matches
1839,Alberto Moreno,es,DF,,Villarreal,La Liga,30,1992,14.4,23,12,10,10,3,11,24,45.8,13,12,1,11,23,46,26,Matches
1840,Álex Moreno,es,DF,,Aston Villa,Premier League,29,1993,14.8,23,14,15,5,3,13,36,36.1,23,18,3,15,7,30,37,Matches
1841,Álex Moreno,es,DF,,Betis,La Liga,29,1993,15.0,29,22,19,10,0,18,36,50.0,18,17,4,13,17,46,39,Matches
1842,Diego Moreno,es,DF,,Osasuna,La Liga,21,2001,7.1,4,4,2,2,0,3,8,37.5,5,7,4,3,5,9,21,Matches
1843,Gerard Moreno,es,FW,,Villarreal,La Liga,30,1992,13.7,11,6,0,6,5,3,6,50.0,3,6,2,4,5,16,10,Matches
1844,Marlos Moreno,co,MF,DF,Troyes,Ligue 1,25,1996,0.1,2,2,2,0,0,2,3,66.7,1,1,1,0,0,2,0,Matches
1845,Tete Morente,es,MF,DF,Elche,La Liga,25,1996,23.0,33,21,18,13,2,15,36,41.7,21,23,3,20,25,58,28,Matches
1846,Ilaix Moriba,gn,MF,,Valencia,La Liga,19,2003,11.2,35,16,14,17,4,14,24,58.3,10,11,1,10,4,39,12,Matches
1847,Manu Morlanes,es,MF,,Villarreal,La Liga,23,1999,1.8,3,2,2,1,0,3,3,100.0,0,3,2,1,1,4,2,Matches
1848,Manu Morlanes,es,MF,,Mallorca,La Liga,23,1999,7.8,22,9,12,8,2,13,24,54.2,11,10,5,5,5,27,9,Matches
1849,Nikola Moro,hr,MF,,Bologna,it Serie A,24,1998,13.6,32,21,11,15,6,14,36,38.9,22,15,2,13,8,40,18,Matches
1850,Loren Morón,es,FW,,Betis,La Liga,28,1993,0.2,2,2,0,1,1,0,0,,0,0,0,0,0,2,1,Matches
1851,Cristhian Mosquera,es,DF,,Valencia,La Liga,18,2004,1.6,4,2,3,1,0,4,5,80.0,1,1,0,1,1,5,5,Matches
1852,Dany Mota,pt,FW,MF,Monza,it Serie A,24,1998,21.2,8,7,1,3,4,2,10,20.0,8,5,1,4,6,14,25,Matches
1853,Lebo Mothiba,za,FW,MF,Strasbourg,Ligue 1,26,1996,4.8,1,0,1,0,0,0,1,0.0,1,6,1,5,0,1,4,Matches
1854,Youssoufa Moukoko,de,FW,,Dortmund,Bundesliga,17,2004,12.7,13,7,3,6,4,3,6,50.0,3,9,0,9,2,15,1,Matches
1855,Steve Mounié,bj,FW,,Brest,Ligue 1,27,1994,18.4,13,5,1,7,5,5,14,35.7,9,18,7,11,3,16,20,Matches
1856,Mason Mount,eng,MF,FW,Chelsea,Premier League,23,1999,18.3,33,19,6,16,11,14,27,51.9,13,24,6,18,8,41,9,Matches
1857,Lucas Moura,br,MF,DF,Tottenham,Premier League,29,1992,1.7,8,5,1,3,4,1,4,25.0,3,0,0,0,2,10,1,Matches
1858,Bevic Moussiti-Oko,cg,FW,,Ajaccio,Ligue 1,27,1995,7.8,3,1,1,1,1,1,2,50.0,1,5,3,2,2,5,8,Matches
1859,João Moutinho,pt,MF,,Wolves,Premier League,35,1986,19.8,51,30,24,21,6,19,46,41.3,27,22,6,16,18,69,20,Matches
1860,João Moutinho,pt,DF,FW,Spezia,it Serie A,24,1998,0.6,7,1,5,1,1,3,4,75.0,1,1,1,0,0,7,0,Matches
1861,Samuel Moutoussamy,cd,MF,,Nantes,Ligue 1,25,1996,26.7,64,34,27,28,9,26,76,34.2,50,23,2,21,24,88,15,Matches
1862,Divin Mubama,eng,FW,,West Ham,Premier League,17,2004,0.4,1,1,1,0,0,0,0,,0,0,0,0,0,1,0,Matches
1863,Mykhailo Mudryk,ua,FW,MF,Chelsea,Premier League,21,2001,7.3,11,9,2,4,5,4,13,30.8,9,7,1,6,0,11,3,Matches
1864,François Mughe,cm,MF,,Marseille,Ligue 1,18,2004,0.1,0,0,0,0,0,0,0,,0,0,0,0,0,0,0,Matches
1865,Nordi Mukiele,fr,DF,,Paris S-G,Ligue 1,24,1997,12.6,31,23,16,6,9,19,29,65.5,10,22,9,13,14,45,16,Matches
1866,Mert Müldür,tr,FW,DF,Sassuolo,it Serie A,23,1999,0.1,0,0,0,0,0,0,0,,0,0,0,0,0,0,0,Matches
1867,Florian Müller,de,GK,,Stuttgart,Bundesliga,24,1997,19.0,0,0,0,0,0,0,0,,0,0,0,0,0,0,7,Matches
1868,Thomas Müller,de,FW,MF,Bayern Munich,Bundesliga,32,1989,18.5,21,12,5,9,7,6,16,37.5,10,19,3,16,4,25,16,Matches
1869,Abdul Mumin,gh,DF,,Rayo Vallecano,La Liga,24,1998,10.2,11,9,5,6,0,3,7,42.9,4,13,5,8,9,20,36,Matches
1870,Marshall Munetsi,zw,MF,,Reims,Ligue 1,26,1996,30.0,58,27,13,31,14,20,48,41.7,28,37,11,26,26,84,41,Matches
1871,Iker Muniain,es,MF,FW,Athletic Club,La Liga,29,1992,18.8,21,16,7,11,3,6,17,35.3,11,10,1,9,4,25,2,Matches
1872,Aihen Muñoz,es,DF,,Real Sociedad,La Liga,24,1997,19.5,38,23,17,17,4,22,47,46.8,25,26,5,21,9,47,38,Matches
1873,Iker Muñoz,es,MF,,Osasuna,La Liga,19,2002,2.8,1,0,0,1,0,0,3,0.0,3,2,1,1,3,4,8,Matches
1874,Pablo Muñoz,es,MF,,Rayo Vallecano,La Liga,18,2003,0.1,0,0,0,0,0,0,1,0.0,1,0,0,0,0,0,0,Matches
1875,Luis Muriel,co,FW,MF,Atalanta,it Serie A,31,1991,11.9,9,6,2,3,4,5,16,31.3,11,9,0,9,2,11,2,Matches
1876,Jeison Murillo,co,DF,,Sampdoria,it Serie A,30,1992,11.7,22,11,16,6,0,17,26,65.4,9,22,14,8,8,30,39,Matches
1877,Vedat Muriqi,xk,FW,,Mallorca,La Liga,28,1994,32.6,12,7,4,7,1,3,13,23.1,10,19,7,12,12,24,73,Matches
1878,Jacob Murphy,eng,FW,,Newcastle Utd,Premier League,27,1995,13.9,15,7,3,8,4,8,20,40.0,12,17,0,17,7,22,3,Matches
1879,Nicola Murru,it,DF,,Sampdoria,it Serie A,27,1994,8.7,24,14,15,8,1,7,13,53.8,6,17,7,10,10,34,21,Matches
1880,Yunus Musah,us,MF,,Valencia,La Liga,19,2002,23.4,48,35,17,23,8,20,30,66.7,10,20,1,19,11,59,16,Matches
1881,Jamal Musiala,de,MF,FW,Bayern Munich,Bundesliga,19,2003,24.4,34,23,9,16,9,13,35,37.1,22,30,3,27,19,53,3,Matches
1882,Juan Musso,ar,GK,,Atalanta,it Serie A,28,1994,23.1,1,1,1,0,0,1,1,100.0,0,0,0,0,0,1,11,Matches
1883,Marlon Mustapha,at,FW,MF,Mainz 05,Bundesliga,21,2001,0.8,2,2,0,2,0,0,0,,0,4,0,4,0,2,0,Matches
1884,Yvon Mvogo,ch,GK,,Lorient,Ligue 1,28,1994,20.1,0,0,0,0,0,0,0,,0,0,0,0,2,2,6,Matches
1885,Enock Mwepu,zm,FW,MF,Brighton,Premier League,24,1998,2.4,10,5,1,6,3,3,4,75.0,1,3,1,2,1,11,1,Matches
1886,Francisco Mwepu,zm,FW,,Cádiz,La Liga,22,2000,0.2,1,0,0,1,0,0,0,,0,0,0,0,0,1,0,Matches
1887,Vitaliy Mykolenko,ua,DF,,Everton,Premier League,23,1999,29.5,58,34,36,19,3,28,51,54.9,23,50,16,34,46,104,99,Matches
1888,Joakim Mæhle,dk,DF,MF,Atalanta,it Serie A,25,1997,24.5,32,18,12,7,13,22,39,56.4,17,29,6,23,24,56,26,Matches
1889,Obite N'Dicka,ci,DF,,Eint Frankfurt,Bundesliga,22,1999,29.9,25,18,10,11,4,18,32,56.3,14,47,19,28,31,56,150,Matches
1890,Nathan N'Goumou,fr,FW,,Toulouse,Ligue 1,22,2000,1.0,3,2,2,1,0,1,1,100.0,0,2,0,2,2,5,0,Matches
1891,Nathan N'Goumou,fr,FW,,Gladbach,Bundesliga,22,2000,7.7,11,5,5,5,1,7,13,53.8,6,9,0,9,1,12,4,Matches
1892,Stanley N'Soki,fr,DF,,Hoffenheim,Bundesliga,23,1999,14.3,22,13,14,7,1,12,22,54.5,10,22,5,17,24,46,34,Matches
1893,Herculano Nabian,pt,MF,,Empoli,it Serie A,18,2004,0.0,0,0,0,0,0,0,0,,0,0,0,0,0,0,0,Matches
1894,Nacho,es,DF,,Real Madrid,La Liga,32,1990,18.2,24,16,17,5,2,12,29,41.4,17,11,6,5,18,42,37,Matches
1895,Nikolas Nartey,dk,DF,MF,Stuttgart,Bundesliga,22,2000,5.3,11,6,7,3,1,5,9,55.6,4,9,0,9,4,15,12,Matches
1896,Juanjo Narváez,co,MF,FW,Valladolid,La Liga,27,1995,1.6,1,1,1,0,0,1,1,100.0,0,2,0,2,0,1,0,Matches
1897,Matija Nastasić,rs,DF,,Mallorca,La Liga,29,1993,10.1,10,8,7,1,2,3,6,50.0,3,11,4,7,18,28,43,Matches
1898,Roberto Navarro,es,MF,FW,Real Sociedad,La Liga,20,2002,3.9,5,4,4,0,1,1,2,50.0,1,7,0,7,2,7,2,Matches
1899,Jesús Navas,es,DF,FW,Sevilla,La Liga,36,1985,22.0,19,12,8,3,8,11,22,50.0,11,18,7,11,22,41,52,Matches
1900,Keylor Navas,cr,GK,,Nott'ham Forest,Premier League,35,1986,17.0,0,0,0,0,0,0,0,,0,0,0,0,1,1,11,Matches
1901,Michel Ndary Adopo,fr,MF,DF,Torino,it Serie A,22,2000,2.9,7,2,4,2,1,1,3,33.3,2,2,2,0,1,8,4,Matches
1902,Youssouf Ndayishimiye,bi,MF,DF,Nice,Ligue 1,23,1998,6.3,13,9,8,5,0,6,11,54.5,5,8,5,3,12,25,22,Matches
1903,Papa Ndiaga Yade,mr,DF,MF,Troyes,Ligue 1,22,2000,6.3,10,6,6,2,2,7,22,31.8,15,10,2,8,8,18,10,Matches
1904,Wilfred Ndidi,ng,MF,,Leicester City,Premier League,25,1996,18.7,61,42,34,24,3,17,43,39.5,26,32,14,18,38,99,48,Matches
1905,Tanguy Ndombele,fr,MF,,Napoli,it Serie A,25,1996,9.0,14,8,4,8,2,4,7,57.1,3,10,1,9,7,21,7,Matches
1906,Álvaro Negredo,es,FW,,Cádiz,La Liga,36,1985,8.4,5,4,1,2,2,2,2,100.0,0,4,1,3,0,5,8,Matches
1907,Reiss Nelson,eng,FW,,Arsenal,Premier League,22,1999,2.4,4,1,2,1,1,2,4,50.0,2,3,0,3,0,4,4,Matches
1908,Ilija Nestorovski,mk,FW,MF,Udinese,it Serie A,32,1990,7.1,7,3,2,1,4,5,11,45.5,6,6,1,5,2,9,10,Matches
1909,Neto,br,GK,,Bournemouth,Premier League,33,1989,26.5,3,1,3,0,0,3,3,100.0,0,0,0,0,0,3,10,Matches
1910,Pedro Neto,pt,FW,MF,Wolves,Premier League,22,2000,10.7,11,6,4,2,5,7,17,41.2,10,5,1,4,4,15,4,Matches
1911,Luca Netz,de,DF,,Gladbach,Bundesliga,19,2003,7.8,25,13,19,3,3,19,32,59.4,13,5,1,4,6,31,27,Matches
1912,Manuel Neuer,de,GK,,Bayern Munich,Bundesliga,36,1986,12.0,0,0,0,0,0,0,0,,0,0,0,0,0,0,4,Matches
1913,Florian Neuhaus,de,MF,,Gladbach,Bundesliga,25,1997,15.6,19,9,9,5,5,8,27,29.6,19,20,3,17,12,31,5,Matches
1914,Rúben Neves,pt,MF,,Wolves,Premier League,25,1997,33.5,79,43,31,33,15,32,76,42.1,44,59,22,37,50,129,85,Matches
1915,Neymar,br,MF,FW,Paris S-G,Ligue 1,30,1992,17.2,22,14,6,9,7,9,19,47.4,10,7,1,6,4,26,1,Matches
1916,Jessic Ngankam,de,FW,MF,Hertha BSC,Bundesliga,22,2000,9.2,14,9,7,4,3,6,14,42.9,8,6,1,5,1,15,4,Matches
1917,Cyril Ngonge,be,MF,FW,Hellas Verona,it Serie A,22,2000,8.3,7,3,2,2,3,3,11,27.3,8,7,0,7,6,13,4,Matches
1918,Moussa Niakhate,sn,DF,,Nott'ham Forest,Premier League,26,1996,12.9,18,9,15,3,0,11,22,50.0,11,18,8,10,19,37,60,Matches
1919,Ibrahima Niane,sn,FW,,Angers,Ligue 1,23,1999,12.6,6,2,1,4,1,1,6,16.7,5,8,2,6,1,7,9,Matches
1920,M'Baye Niang,sn,FW,,Auxerre,Ligue 1,27,1994,16.5,13,7,1,8,4,3,13,23.1,10,22,1,21,1,14,20,Matches
1921,Tanguy Nianzou,fr,DF,,Sevilla,La Liga,20,2002,15.2,20,15,10,9,1,8,11,72.7,3,8,5,3,16,36,44,Matches
1922,Rasmus Nicolaisen,dk,DF,,Toulouse,Ligue 1,25,1997,33.3,48,21,34,14,0,29,46,63.0,17,58,45,13,50,98,152,Matches
1923,Hans Nicolussi Caviglia,it,MF,,Salernitana,it Serie A,22,2000,6.5,15,6,5,8,2,9,15,60.0,6,9,0,9,7,22,7,Matches
1924,Florian Niederlechner,de,FW,MF,Augsburg,Bundesliga,31,1990,10.1,10,5,5,4,1,4,7,57.1,3,16,2,14,1,11,9,Matches
1925,Florian Niederlechner,de,FW,,Hertha BSC,Bundesliga,31,1990,8.7,9,7,2,4,3,2,8,25.0,6,7,0,7,3,12,10,Matches
1926,Saúl Ñíguez,es,MF,DF,Atlético Madrid,La Liga,27,1994,12.2,42,27,18,18,6,22,37,59.5,15,27,5,22,15,57,29,Matches
1927,Dimitris Nikolaou,gr,DF,,Spezia,it Serie A,23,1998,32.9,45,32,31,10,4,25,37,67.6,12,41,26,15,27,72,82,Matches
1928,Fernando Niño,es,MF,FW,Villarreal,La Liga,21,2000,0.2,0,0,0,0,0,0,0,,0,0,0,0,0,0,0,Matches
1929,Justin Njinmah,de,FW,,Dortmund,Bundesliga,21,2000,0.2,0,0,0,0,0,0,0,,0,0,0,0,0,0,0,Matches
1930,Eddie Nketiah,eng,FW,,Arsenal,Premier League,23,1999,12.1,13,9,6,2,5,2,10,20.0,8,7,1,6,1,14,7,Matches
1931,Christopher Nkunku,fr,FW,MF,RB Leipzig,Bundesliga,24,1997,21.1,6,4,2,1,3,1,6,16.7,5,8,3,5,8,14,11,Matches
1932,Felix Nmecha,de,MF,,Wolfsburg,Bundesliga,21,2000,20.4,41,24,11,23,7,16,34,47.1,18,26,10,16,25,66,31,Matches
1933,Lukas Nmecha,de,FW,,Wolfsburg,Bundesliga,23,1998,10.0,5,3,0,2,3,3,3,100.0,0,5,1,4,3,8,4,Matches
1934,Arnaud Nordin,fr,FW,,Montpellier,Ligue 1,24,1998,26.7,26,14,10,12,4,12,28,42.9,16,19,1,18,14,40,7,Matches
1935,Riad Nouri,fr,MF,FW,Ajaccio,Ligue 1,37,1985,18.8,21,12,7,10,4,12,29,41.4,17,8,1,7,15,36,11,Matches
1936,Hugo Novoa,es,DF,FW,RB Leipzig,Bundesliga,19,2003,2.0,8,2,1,3,4,4,7,57.1,3,4,0,4,1,9,0,Matches
1937,Samuel Ntanda,be,MF,,Sampdoria,it Serie A,17,2005,0.0,0,0,0,0,0,0,0,,0,0,0,0,0,0,0,Matches
1938,Randy Nteka,ao,FW,MF,Elche,La Liga,24,1997,8.1,15,10,7,6,2,2,11,18.2,9,15,3,12,4,19,9,Matches
1939,Randy Nteka,ao,FW,MF,Rayo Vallecano,La Liga,24,1997,1.3,4,2,2,2,0,1,1,100.0,0,2,0,2,2,6,3,Matches
1940,Alexander Nübel,de,GK,,Monaco,Ligue 1,25,1996,38.0,0,0,0,0,0,0,1,0.0,1,0,0,0,1,1,10,Matches
1941,Matheus Nunes,pt,MF,,Wolves,Premier League,23,1998,27.4,67,43,36,22,9,28,61,45.9,33,35,4,31,16,83,35,Matches
1942,Darwin Núñez,uy,FW,,Liverpool,Premier League,23,1999,18.8,11,5,2,4,5,4,17,23.5,13,10,0,10,3,14,13,Matches
1943,Unai Núñez,es,DF,,Celta Vigo,La Liga,25,1997,35.0,47,35,29,15,3,18,34,52.9,16,27,17,10,72,119,135,Matches
1944,Bram Nuytinck,nl,DF,,Udinese,it Serie A,32,1990,4.3,7,4,3,4,0,4,8,50.0,4,6,6,0,5,12,22,Matches
1945,Bram Nuytinck,nl,DF,,Sampdoria,it Serie A,32,1990,16.6,54,38,33,21,0,23,34,67.6,11,36,21,15,23,77,84,Matches
1946,Ethan Nwaneri,eng,FW,,Arsenal,Premier League,15,2007,0.0,0,0,0,0,0,0,0,,0,1,0,1,0,0,0,Matches
1947,Gerzino Nyamsi,fr,DF,,Strasbourg,Ligue 1,25,1997,17.5,28,20,14,12,2,10,12,83.3,2,19,11,8,10,38,63,Matches
1948,Ørjan Nyland,no,GK,,RB Leipzig,Bundesliga,31,1990,2.0,0,0,0,0,0,0,0,,0,0,0,0,0,0,0,Matches
1949,M'Bala Nzola,ao,FW,,Spezia,it Serie A,25,1996,29.5,12,5,0,6,6,3,9,33.3,6,20,6,14,7,19,21,Matches
1950,Christian Nørgaard,dk,MF,,Brentford,Premier League,28,1994,19.6,52,30,21,29,2,18,48,37.5,30,32,9,23,34,86,41,Matches
1951,Lewis O'Brien,eng,MF,,Nott'ham Forest,Premier League,23,1998,6.5,16,9,4,11,1,6,12,50.0,6,13,2,11,5,21,9,Matches
1952,Pedro Obiang,gq,MF,,Sassuolo,it Serie A,30,1992,9.7,26,17,12,12,2,10,18,55.6,8,12,2,10,8,34,15,Matches
1953,Jan Oblak,si,GK,,Atlético Madrid,La Liga,29,1993,27.7,0,0,0,0,0,0,0,,0,0,0,0,1,1,8,Matches
1954,Brian Ocampo,uy,MF,FW,Cádiz,La Liga,23,1999,12.4,18,15,12,5,1,8,21,38.1,13,13,0,13,3,21,3,Matches
1955,Lucas Ocampos,ar,FW,MF,Sevilla,La Liga,28,1994,12.9,22,14,9,9,4,8,31,25.8,23,17,2,15,8,30,5,Matches
1956,Guillermo Ochoa,mx,GK,,Salernitana,it Serie A,37,1985,20.0,0,0,0,0,0,0,2,0.0,2,0,0,0,0,0,9,Matches
1957,Wilson Odobert,fr,MF,FW,Troyes,Ligue 1,17,2004,19.6,20,14,10,7,3,9,25,36.0,16,11,0,11,15,35,5,Matches
1958,Álvaro Odriozola,es,DF,,Real Madrid,La Liga,26,1995,0.4,0,0,0,0,0,0,0,,0,0,0,0,0,0,0,Matches
1959,Tim Oermann,de,DF,,Bochum,Bundesliga,18,2003,2.2,2,1,2,0,0,1,1,100.0,0,3,2,1,1,3,8,Matches
1960,Odeluga Offiah,eng,DF,,Brighton,Premier League,19,2002,0.3,1,1,1,0,0,0,2,0.0,2,0,0,0,0,1,1,Matches
1961,Angelo Ogbonna,it,DF,,West Ham,Premier League,34,1988,13.7,11,4,7,4,0,5,10,50.0,5,11,7,4,17,28,74,Matches
1962,Florent Ogier,fr,DF,,Clermont Foot,Ligue 1,33,1989,18.9,33,16,20,12,1,22,39,56.4,17,22,13,9,18,51,64,Matches
1963,Marios Oikonomou,gr,DF,,Sampdoria,it Serie A,29,1992,2.4,3,2,3,0,0,1,3,33.3,2,5,4,1,4,7,13,Matches
1964,David Okereke,ng,FW,MF,Cremonese,it Serie A,24,1997,25.2,12,8,4,5,3,3,16,18.8,13,23,3,20,10,22,12,Matches
1965,Caleb Okoli,it,DF,,Atalanta,it Serie A,21,2001,10.7,21,17,14,6,1,10,25,40.0,15,10,5,5,30,51,44,Matches
1966,Olasagasti,es,MF,DF,Real Sociedad,La Liga,21,2000,0.7,4,4,1,2,1,1,2,50.0,1,2,0,2,0,4,1,Matches
1967,Lucas Olaza,uy,DF,,Valladolid,La Liga,28,1994,16.6,24,14,12,10,2,17,26,65.4,9,20,8,12,14,38,34,Matches
1968,Finn Ole Becker,de,MF,,Hoffenheim,Bundesliga,22,2000,5.7,10,2,4,6,0,4,7,57.1,3,4,0,4,5,15,8,Matches
1969,Mathias Olesen,lu,MF,,Köln,Bundesliga,21,2001,5.3,10,5,4,4,2,5,8,62.5,3,6,1,5,2,12,3,Matches
1970,Michael Olise,fr,FW,MF,Crystal Palace,Premier League,20,2001,30.5,58,34,28,26,4,25,60,41.7,35,46,1,45,26,84,17,Matches
1971,Brian Oliván,es,DF,,Espanyol,La Liga,28,1994,26.7,47,27,30,12,5,17,26,65.4,9,26,6,20,22,69,67,Matches
1972,Lucas Oliveira Rosa,br,DF,,Valladolid,La Liga,22,2000,10.3,39,18,23,10,6,12,20,60.0,8,12,2,10,15,54,24,Matches
1973,Mathías Olivera,uy,DF,,Napoli,it Serie A,24,1997,18.3,39,23,16,16,7,22,43,51.2,21,28,2,26,22,61,26,Matches
1974,Dani Olmo,es,MF,FW,RB Leipzig,Bundesliga,24,1998,14.2,15,9,1,10,4,6,14,42.9,8,15,0,15,6,21,6,Matches
1975,Jan Olschowsky,de,GK,,Gladbach,Bundesliga,20,2001,4.0,0,0,0,0,0,0,1,0.0,1,1,0,1,0,0,1,Matches
1976,Robin Olsen,se,GK,,Aston Villa,Premier League,32,1990,3.1,0,0,0,0,0,0,2,0.0,2,0,0,0,0,0,1,Matches
1977,Warmed Omari,km,DF,,Rennes,Ligue 1,22,2000,15.1,20,11,14,6,0,14,28,50.0,14,13,7,6,17,37,43,Matches
1978,Jonas Omlin,ch,GK,,Montpellier,Ligue 1,28,1994,13.0,1,0,1,0,0,0,0,,0,0,0,0,0,1,8,Matches
1979,Jonas Omlin,ch,GK,,Gladbach,Bundesliga,28,1994,14.3,1,1,1,0,0,1,3,33.3,2,1,0,1,0,1,9,Matches
1980,Ado Onaiwu,jp,FW,,Toulouse,Ligue 1,26,1995,12.0,11,6,4,4,3,5,13,38.5,8,5,1,4,2,13,5,Matches
1981,Amadou Onana,be,MF,,Everton,Premier League,20,2001,27.6,72,43,24,42,6,30,42,71.4,12,25,6,19,37,109,39,Matches
1982,André Onana,cm,GK,,Inter,it Serie A,26,1996,24.0,0,0,0,0,0,0,1,0.0,1,0,0,0,0,0,5,Matches
1983,Jean Onana,cm,MF,DF,Lens,Ligue 1,22,2000,9.0,28,17,8,17,3,10,22,45.5,12,15,5,10,18,46,20,Matches
1984,Karim Onisiwo,at,FW,MF,Mainz 05,Bundesliga,30,1992,28.2,19,12,3,10,6,4,21,19.0,17,19,0,19,2,21,7,Matches
1985,Josh Onomah,eng,MF,,Fulham,Premier League,25,1997,0.2,1,0,1,0,0,0,0,,0,1,0,1,0,1,0,Matches
1986,Paul Onuachu,ng,FW,,Southampton,Premier League,28,1994,4.5,3,2,1,1,1,1,3,33.3,2,4,1,3,0,3,4,Matches
1987,Frank Onyeka,ng,MF,,Brentford,Premier League,24,1998,9.4,19,14,11,7,1,10,24,41.7,14,16,3,13,10,29,16,Matches
1988,Loïs Openda,be,FW,,Lens,Ligue 1,22,2000,28.0,11,9,2,6,3,2,13,15.4,11,9,0,9,2,13,6,Matches
1989,Willi Orban,hu,DF,,RB Leipzig,Bundesliga,29,1992,32.8,51,30,33,18,0,26,43,60.5,17,42,24,18,39,90,129,Matches
1990,Ivan Ordets,ua,DF,,Bochum,Bundesliga,30,1992,27.2,31,19,21,9,1,16,28,57.1,12,34,17,17,57,88,139,Matches
1991,Divock Origi,be,FW,,Milan,it Serie A,27,1995,11.4,10,5,4,3,3,5,10,50.0,5,6,2,4,0,10,13,Matches
1992,Aimar Oroz,es,MF,FW,Osasuna,La Liga,20,2001,22.4,26,14,8,10,8,8,30,26.7,22,24,1,23,24,50,6,Matches
1993,Mislav Oršić,hr,MF,,Southampton,Premier League,29,1992,0.1,1,1,1,0,0,0,0,,0,0,0,0,0,1,0,Matches
1994,Riccardo Orsolini,it,FW,,Bologna,it Serie A,25,1997,23.6,30,19,15,10,5,17,41,41.5,24,29,3,26,8,38,18,Matches
1995,Stefan Ortega,de,GK,,Manchester City,Premier League,29,1992,3.0,0,0,0,0,0,0,0,,0,0,0,0,0,0,0,Matches
1996,Pedro Ortiz,es,MF,,Sevilla,La Liga,21,2000,0.0,0,0,0,0,0,0,0,,0,0,0,0,0,0,0,Matches
1997,Jordi Osei-Tutu,eng,DF,FW,Bochum,Bundesliga,23,1998,8.3,23,18,13,5,5,12,23,52.2,11,12,5,7,10,33,8,Matches
1998,Victor Osimhen,ng,FW,,Napoli,it Serie A,23,1998,28.5,10,6,1,2,7,0,7,0.0,7,6,1,5,6,16,29,Matches
1999,Patrick Osterhage,de,MF,,Bochum,Bundesliga,22,2000,11.4,20,17,8,10,2,11,16,68.8,5,17,6,11,12,32,25,Matches
2000,Paulo Otávio,br,DF,,Wolfsburg,Bundesliga,27,1994,22.7,72,46,46,17,9,44,66,66.7,22,42,6,36,30,102,70,Matches
2001,Dango Ouattara,bf,MF,FW,Bournemouth,Premier League,20,2002,13.8,28,15,20,6,2,13,32,40.6,19,20,3,17,13,41,29,Matches
2002,Dango Ouattara,bf,FW,MF,Lorient,Ligue 1,20,2002,17.2,41,26,20,11,10,15,28,53.6,13,24,6,18,19,60,21,Matches
2003,Remi Oudin,fr,FW,MF,Lecce,it Serie A,25,1996,14.7,25,13,9,12,4,10,23,43.5,13,16,2,14,29,54,23,Matches
2004,Zinédine Ould Khaled,fr,MF,FW,Angers,Ligue 1,22,2000,0.6,1,1,0,1,0,0,1,0.0,1,0,0,0,2,3,0,Matches
2005,Azzedine Ounahi,ma,MF,FW,Marseille,Ligue 1,22,2000,1.3,2,1,1,1,0,0,2,0.0,2,1,0,1,0,2,0,Matches
2006,Azzedine Ounahi,ma,MF,FW,Angers,Ligue 1,22,2000,12.5,19,8,5,13,1,10,20,50.0,10,8,0,8,15,34,4,Matches
2007,Adam Ounas,dz,FW,,Napoli,it Serie A,25,1996,0.2,0,0,0,0,0,0,0,,0,0,0,0,1,1,0,Matches
2008,Adam Ounas,dz,FW,MF,Lille,Ligue 1,25,1996,11.8,20,11,4,10,6,8,13,61.5,5,16,0,16,7,27,5,Matches
2009,Thomas Ouwejan,nl,DF,,Schalke 04,Bundesliga,25,1996,10.0,20,8,13,5,2,6,10,60.0,4,17,4,13,13,33,27,Matches
2010,Reece Oxford,eng,DF,,Augsburg,Bundesliga,23,1998,1.0,1,1,1,0,0,0,0,,0,4,3,1,1,2,5,Matches
2011,Alex Oxlade-Chamberlain,eng,FW,MF,Liverpool,Premier League,28,1993,3.7,5,4,1,2,2,1,5,20.0,4,5,2,3,1,6,4,Matches
2012,Mikel Oyarzabal,es,FW,MF,Real Sociedad,La Liga,25,1997,13.5,13,7,5,3,5,5,19,26.3,14,14,4,10,3,16,5,Matches
2013,Salih Özcan,tr,MF,,Dortmund,Bundesliga,24,1998,17.5,31,18,10,16,5,16,39,41.0,23,24,2,22,28,59,19,Matches
2014,Cenk Özkacar,tr,DF,,Valencia,La Liga,21,2000,15.2,27,20,17,10,0,14,19,73.7,5,14,2,12,12,39,47,Matches
2015,David Ozoh,eng,FW,,Crystal Palace,Premier League,17,2005,0.0,0,0,0,0,0,0,0,,0,0,0,0,0,0,0,Matches
2016,Levin Öztunalı,de,MF,,Union Berlin,Bundesliga,26,1996,0.1,0,0,0,0,0,0,1,0.0,1,0,0,0,0,0,0,Matches
2017,Fernando Pacheco,es,GK,,Almería,La Liga,30,1992,1.0,0,0,0,0,0,0,0,,0,0,0,0,0,0,1,Matches
2018,Fernando Pacheco,es,GK,,Espanyol,La Liga,30,1992,16.0,0,0,0,0,0,0,1,0.0,1,0,0,0,1,1,11,Matches
2019,Jon Pacheco,es,DF,,Real Sociedad,La Liga,21,2001,13.3,16,10,10,6,0,6,10,60.0,4,9,6,3,12,28,37,Matches
2020,Gonçalo Paciência,pt,FW,MF,Celta Vigo,La Liga,27,1994,7.4,8,5,0,5,3,2,7,28.6,5,9,1,8,0,8,4,Matches
2021,Simone Pafundi,it,MF,FW,Udinese,it Serie A,16,2006,0.9,8,5,1,5,2,2,4,50.0,2,0,0,0,1,9,0,Matches
2022,Exequiel Palacios,ar,MF,,Leverkusen,Bundesliga,23,1998,18.4,59,36,20,33,6,29,48,60.4,19,29,2,27,33,92,28,Matches
2023,Helibelton Palacios,co,DF,,Elche,La Liga,29,1993,21.3,38,20,21,15,2,19,26,73.1,7,26,12,14,20,58,55,Matches
2024,Ante Palaversa,hr,MF,,Troyes,Ligue 1,22,2000,0.3,1,1,1,0,0,0,0,,0,0,0,0,1,2,0,Matches
2025,Isaac Palazón Camacho,es,FW,MF,Rayo Vallecano,La Liga,27,1994,32.9,45,30,11,23,11,24,66,36.4,42,42,3,39,17,62,30,Matches
2026,João Palhinha,pt,MF,,Fulham,Premier League,27,1995,34.5,148,83,59,65,24,71,135,52.6,64,48,5,43,46,194,61,Matches
2027,Nicolas Pallois,fr,DF,,Nantes,Ligue 1,34,1987,24.6,69,44,51,16,2,42,70,60.0,28,35,18,17,30,99,131,Matches
2028,Cole Palmer,eng,MF,FW,Manchester City,Premier League,20,2002,4.1,5,1,0,3,2,3,5,60.0,2,2,1,1,1,6,2,Matches
2029,Erik Palmer-Brown,us,DF,,Troyes,Ligue 1,25,1997,35.5,42,27,31,10,1,18,33,54.5,15,56,29,27,26,68,166,Matches
2030,Emerson Palmieri,it,DF,,West Ham,Premier League,27,1994,14.7,26,14,9,15,2,12,24,50.0,12,17,4,13,15,41,36,Matches
2031,Miloš Pantović,rs,MF,,Union Berlin,Bundesliga,26,1996,2.3,4,2,4,0,0,3,5,60.0,2,3,0,3,0,4,5,Matches
2032,Flavio Paoletti,it,MF,,Sampdoria,it Serie A,19,2003,3.2,2,2,0,2,0,1,5,20.0,4,1,0,1,5,7,9,Matches
2033,Antonios Papadopoulos,de,DF,,Dortmund,Bundesliga,22,1999,0.1,0,0,0,0,0,0,0,,0,0,0,0,1,1,0,Matches
2034,Lucas Paquetá,br,MF,,West Ham,Premier League,24,1997,23.9,71,53,23,36,12,27,68,39.7,41,41,4,37,16,87,31,Matches
2035,Lucas Paquetá,br,MF,,Lyon,Ligue 1,24,1997,1.8,5,4,0,5,0,1,3,33.3,2,2,0,2,1,6,3,Matches
2036,Aitor Paredes,es,DF,,Athletic Club,La Liga,22,2000,9.5,7,6,4,2,1,6,11,54.5,5,11,7,4,14,21,26,Matches
2037,Kevin Paredes,us,FW,MF,Wolfsburg,Bundesliga,19,2003,5.9,13,9,6,3,4,9,12,75.0,3,7,0,7,6,19,8,Matches
2038,Leandro Paredes,ar,MF,,Juventus,it Serie A,28,1994,10.9,19,13,7,11,1,10,22,45.5,12,8,0,8,17,36,22,Matches
2039,Leandro Paredes,ar,MF,,Paris S-G,Ligue 1,28,1994,0.6,1,1,1,0,0,1,1,100.0,0,2,1,1,1,2,0,Matches
2040,Daniel Parejo,es,MF,,Villarreal,La Liga,33,1989,36.5,71,40,32,23,16,30,75,40.0,45,40,12,28,29,100,31,Matches
2041,Fabiano Parisi,it,DF,,Empoli,it Serie A,21,2000,31.4,65,35,37,21,7,30,72,41.7,42,51,16,35,41,106,91,Matches
2042,Moises Parra Gutierrez,es,FW,,Getafe,La Liga,20,2002,0.1,1,0,0,1,0,0,0,,0,0,0,0,0,1,0,Matches
2043,Raúl Parra,es,DF,,Cádiz,La Liga,22,1999,3.4,4,2,4,0,0,4,9,44.4,5,5,3,2,1,5,9,Matches
2044,Thomas Partey,gh,MF,,Arsenal,Premier League,29,1993,27.6,70,40,20,35,15,25,52,48.1,27,26,5,21,28,98,41,Matches
2045,Marco Pašalić,hr,MF,,Dortmund,Bundesliga,21,2000,0.1,0,0,0,0,0,0,0,,0,0,0,0,0,0,0,Matches
2046,Mario Pašalić,hr,MF,FW,Atalanta,it Serie A,27,1995,19.7,22,10,6,14,2,6,23,26.1,17,22,4,18,21,43,13,Matches
2047,Pascu,es,DF,FW,Villarreal,La Liga,19,2003,0.1,0,0,0,0,0,0,0,,0,0,0,0,0,0,0,Matches
2048,Felix Passlack,de,DF,,Dortmund,Bundesliga,24,1998,0.7,4,3,0,4,0,1,1,100.0,0,1,1,0,0,4,1,Matches
2049,Javier Pastore,ar,MF,,Elche,La Liga,33,1989,0.1,0,0,0,0,0,0,0,,0,0,0,0,0,0,0,Matches
2050,Patric,es,DF,,Lazio,it Serie A,29,1993,15.7,17,11,12,3,2,11,16,68.8,5,17,12,5,11,28,53,Matches
2051,Rui Patrício,pt,GK,,Roma,it Serie A,34,1988,35.0,1,1,1,0,0,1,1,100.0,0,0,0,0,2,3,6,Matches
2052,Nathan Patterson,sct,DF,MF,Everton,Premier League,20,2001,14.2,49,24,32,13,4,29,54,53.7,25,24,4,20,15,64,45,Matches
2053,Paulinho,br,FW,,Leverkusen,Bundesliga,22,2000,0.9,0,0,0,0,0,0,0,,0,1,0,1,0,0,2,Matches
2054,Gabriel Paulista,br,DF,,Valencia,La Liga,31,1990,16.7,17,9,13,4,0,13,19,68.4,6,22,14,8,32,49,79,Matches
2055,Benjamin Pavard,fr,DF,,Bayern Munich,Bundesliga,26,1996,27.0,70,41,36,26,8,36,48,75.0,12,35,16,19,44,114,83,Matches
2056,Jiří Pavlenka,cz,GK,,Werder Bremen,Bundesliga,30,1992,32.3,1,0,1,0,0,1,5,20.0,4,1,0,1,3,4,21,Matches
2057,Dimitri Payet,fr,MF,FW,Marseille,Ligue 1,35,1987,9.3,6,4,2,2,2,3,11,27.3,8,4,0,4,0,6,4,Matches
2058,Ben Pearson,eng,MF,,Bournemouth,Premier League,27,1995,3.2,7,3,3,3,1,1,3,33.3,2,4,0,4,2,9,6,Matches
2059,Kristian Pedersen,dk,DF,,Köln,Bundesliga,27,1994,3.1,5,4,4,1,0,0,2,0.0,2,3,0,3,6,11,17,Matches
2060,Mads Pedersen,dk,DF,MF,Augsburg,Bundesliga,25,1996,20.4,44,23,31,11,2,22,33,66.7,11,32,9,23,20,64,41,Matches
2061,Alfonso Pedraza,es,DF,,Villarreal,La Liga,26,1996,18.1,35,26,20,10,5,19,29,65.5,10,19,1,18,18,53,31,Matches
2062,Pedri,es,MF,,Barcelona,La Liga,19,2002,22.0,39,22,15,17,7,13,45,28.9,32,27,0,27,13,52,8,Matches
2063,Pedro,es,FW,,Lazio,it Serie A,35,1987,21.1,35,24,14,10,11,11,30,36.7,19,18,2,16,6,41,4,Matches
2064,Adrià Pedrosa,es,DF,MF,Espanyol,La Liga,24,1998,2.5,5,1,5,0,0,4,7,57.1,3,1,1,0,5,10,3,Matches
2065,Jordan Pefok,us,FW,,Union Berlin,Bundesliga,26,1996,15.1,15,7,3,4,8,2,17,11.8,15,17,5,12,4,19,15,Matches
2066,Gianluca Pegolo,it,GK,,Sassuolo,it Serie A,41,1981,2.0,0,0,0,0,0,0,1,0.0,1,0,0,0,0,0,1,Matches
2067,Dženan Pejčinović,de,FW,,Wolfsburg,Bundesliga,17,2005,0.1,0,0,0,0,0,0,0,,0,0,0,0,0,0,0,Matches
2068,Peter Pekarík,sk,DF,,Hertha BSC,Bundesliga,35,1986,2.3,4,3,4,0,0,4,6,66.7,2,6,2,4,4,8,7,Matches
2069,Pietro Pellegri,it,FW,,Torino,it Serie A,21,2001,5.2,6,2,1,3,2,2,3,66.7,1,5,1,4,0,6,4,Matches
2070,Lorenzo Pellegrini,it,MF,,Roma,it Serie A,26,1996,28.3,52,29,24,24,4,22,48,45.8,26,27,4,23,26,78,22,Matches
2071,Luca Pellegrini,it,DF,,Lazio,it Serie A,23,1999,2.0,1,0,0,1,0,1,4,25.0,3,3,0,3,7,8,4,Matches
2072,Luca Pellegrini,it,DF,,Eint Frankfurt,Bundesliga,23,1999,6.2,13,8,10,3,0,8,8,100.0,0,8,2,6,7,20,11,Matches
2073,Théo Pellenard,fr,DF,,Auxerre,Ligue 1,28,1994,1.1,1,0,1,0,0,1,1,100.0,0,3,1,2,2,3,2,Matches
2074,Facundo Pellistri,uy,FW,MF,Manchester Utd,Premier League,20,2001,0.7,1,1,0,1,0,0,0,,0,0,0,0,0,1,3,Matches
2075,Timothee Pembele,fr,DF,,Paris S-G,Ligue 1,19,2002,2.9,5,5,3,1,1,2,4,50.0,2,2,0,2,4,9,2,Matches
2076,Iñaki Peña,es,GK,,Barcelona,La Liga,23,1999,0.8,0,0,0,0,0,0,0,,0,0,0,0,0,0,0,Matches
2077,Rubén Peña,es,DF,MF,Osasuna,La Liga,31,1991,14.2,32,18,10,18,4,20,41,48.8,21,23,8,15,17,49,31,Matches
2078,Patrick Pentz,at,GK,,Reims,Ligue 1,25,1997,7.0,0,0,0,0,0,0,0,,0,0,0,0,0,0,1,Matches
2079,Nicolas Pépé,ci,FW,MF,Nice,Ligue 1,27,1995,16.6,25,13,14,5,6,11,25,44.0,14,17,0,17,3,28,1,Matches
2080,Ricardo Pepi,us,FW,,Augsburg,Bundesliga,19,2003,1.1,1,1,1,0,0,1,1,100.0,0,1,0,1,0,1,1,Matches
2081,Pepín,gq,MF,,Monza,it Serie A,25,1996,12.5,28,19,10,11,7,9,27,33.3,18,14,3,11,13,41,17,Matches
2082,Alberto Perea,es,MF,,Cádiz,La Liga,31,1990,0.5,2,0,2,0,0,0,0,,0,2,0,2,0,2,0,Matches
2083,Juan Perea,co,FW,,Stuttgart,Bundesliga,22,2000,4.6,5,4,0,2,3,2,4,50.0,2,2,1,1,1,6,3,Matches
2084,Andreas Pereira,br,MF,,Fulham,Premier League,26,1996,29.9,18,9,3,6,9,8,34,23.5,26,21,3,18,6,24,8,Matches
2085,Brayann Pereira,fr,DF,,Auxerre,Ligue 1,19,2003,2.0,6,5,5,1,0,1,5,20.0,4,2,2,0,2,8,8,Matches
2086,Danilo Pereira,pt,DF,MF,Paris S-G,Ligue 1,30,1991,26.8,32,17,15,14,3,19,26,73.1,7,26,19,7,36,68,59,Matches
2087,Mathias Pereira Lage,pt,MF,FW,Brest,Ligue 1,25,1996,14.0,20,7,5,14,1,11,29,37.9,18,10,1,9,14,34,12,Matches
2088,Ricardo Pereira,pt,DF,MF,Leicester City,Premier League,28,1993,5.0,11,7,8,3,0,7,17,41.2,10,8,2,6,4,15,20,Matches
2089,Roberto Pereyra,ar,DF,MF,Udinese,it Serie A,31,1991,31.3,36,20,21,12,3,16,44,36.4,28,20,5,15,16,52,28,Matches
2090,Ayoze Pérez,es,MF,FW,Leicester City,Premier League,29,1993,4.2,11,8,5,4,2,8,19,42.1,11,6,0,6,2,13,3,Matches
2091,Ayoze Pérez,es,FW,MF,Betis,La Liga,29,1993,15.4,31,15,9,16,6,10,40,25.0,30,22,0,22,13,44,5,Matches
2092,Carles Pérez,es,MF,FW,Celta Vigo,La Liga,24,1998,23.8,39,23,12,17,10,22,66,33.3,44,29,3,26,6,45,9,Matches
2093,Francisco Perez,es,FW,MF,Valencia,La Liga,19,2002,1.6,1,1,1,0,0,0,3,0.0,3,0,0,0,0,1,1,Matches
2094,Kike Pérez,es,MF,,Valladolid,La Liga,25,1997,25.6,67,33,30,32,5,25,68,36.8,43,26,7,19,20,87,28,Matches
2095,Lucas Pérez,es,FW,,Cádiz,La Liga,33,1988,7.0,3,2,2,1,0,1,3,33.3,2,2,0,2,1,4,3,Matches
2096,Luis Pérez,es,DF,,Valladolid,La Liga,27,1995,13.5,44,24,26,12,6,27,38,71.1,11,13,4,9,16,60,29,Matches
2097,Nehuén Pérez,ar,DF,,Udinese,it Serie A,22,2000,31.3,77,40,54,20,3,39,55,70.9,16,53,23,30,35,112,106,Matches
2098,Simone Perilli,it,GK,,Hellas Verona,it Serie A,27,1995,1.0,0,0,0,0,0,0,0,,0,0,0,0,0,0,0,Matches
2099,Mattia Perin,it,GK,,Juventus,it Serie A,29,1992,10.5,0,0,0,0,0,0,0,,0,0,0,0,0,0,0,Matches
2100,Samuele Perisan,it,GK,,Empoli,it Serie A,24,1997,7.0,0,0,0,0,0,0,0,,0,0,0,0,0,0,2,Matches
2101,Ivan Perišić,hr,DF,MF,Tottenham,Premier League,33,1989,23.4,42,24,25,10,7,27,47,57.4,20,29,7,22,22,64,49,Matches
2102,Romain Perraud,fr,DF,,Southampton,Premier League,24,1997,20.4,54,33,23,23,8,28,52,53.8,24,24,6,18,20,74,42,Matches
2103,Gaëtan Perrin,fr,MF,FW,Auxerre,Ligue 1,26,1996,15.5,17,8,5,6,6,8,30,26.7,22,15,0,15,10,27,9,Matches
2104,Lucas Perrin,fr,DF,,Strasbourg,Ligue 1,23,1998,19.6,44,27,28,14,2,25,49,51.0,24,13,5,8,36,80,53,Matches
2105,Máximo Perrone,ar,MF,,Manchester City,Premier League,19,2003,0.2,0,0,0,0,0,0,0,,0,1,0,1,0,0,0,Matches
2106,Matteo Pessina,it,MF,,Monza,it Serie A,25,1997,32.6,57,36,28,21,8,26,62,41.9,36,50,15,35,37,94,33,Matches
2107,Andrea Petagna,it,FW,,Monza,it Serie A,27,1995,18.5,7,5,2,3,2,3,6,50.0,3,16,4,12,3,10,18,Matches
2108,Nils Petersen,de,FW,,Freiburg,Bundesliga,33,1988,3.1,6,4,0,3,3,2,5,40.0,3,11,2,9,1,7,6,Matches
2109,Lukas Petkov,bg,MF,FW,Augsburg,Bundesliga,21,2000,1.6,5,1,4,1,0,2,3,66.7,1,4,1,3,1,6,0,Matches
2110,Cameron Peupion,au,MF,,Brighton,Premier League,19,2002,0.1,0,0,0,0,0,0,0,,0,0,0,0,0,0,0,Matches
2111,Germán Pezzella,ar,DF,,Betis,La Liga,31,1991,27.9,41,28,32,9,0,26,38,68.4,12,32,15,17,50,91,129,Matches
2112,Giuseppe Pezzella,it,DF,,Lecce,it Serie A,24,1997,10.2,21,9,16,2,3,9,16,56.3,7,11,3,8,8,29,31,Matches
2113,Luca Pfeiffer,de,FW,,Stuttgart,Bundesliga,25,1996,7.8,1,1,1,0,0,0,1,0.0,1,4,0,4,1,2,5,Matches
2114,Maximilian Philipp,de,FW,,Wolfsburg,Bundesliga,28,1994,1.3,2,1,1,1,0,1,1,100.0,0,1,0,1,0,2,0,Matches
2115,Maximilian Philipp,de,FW,MF,Werder Bremen,Bundesliga,28,1994,4.9,6,5,3,2,1,1,9,11.1,8,7,1,6,3,9,4,Matches
2116,Kalvin Phillips,eng,MF,,Manchester City,Premier League,26,1995,3.3,6,4,3,3,0,2,10,20.0,8,7,3,4,5,11,10,Matches
2117,Nathaniel Phillips,eng,DF,,Liverpool,Premier League,25,1997,0.7,2,1,0,2,0,2,2,100.0,0,0,0,0,2,4,1,Matches
2118,Krzysztof Piątek,pl,FW,,Salernitana,it Serie A,27,1995,23.8,18,11,3,9,6,5,21,23.8,16,17,4,13,2,20,39,Matches
2119,Roberto Piccoli,it,FW,,Hellas Verona,it Serie A,21,2001,2.1,1,0,1,0,0,0,2,0.0,2,2,0,2,0,1,2,Matches
2120,Roberto Piccoli,it,FW,,Empoli,it Serie A,21,2001,5.7,1,1,1,0,0,0,3,0.0,3,4,1,3,1,2,9,Matches
2121,Charles Pickel,cd,MF,,Cremonese,it Serie A,25,1997,27.6,55,23,25,26,4,32,57,56.1,25,37,5,32,24,79,36,Matches
2122,Jordan Pickford,eng,GK,,Everton,Premier League,28,1994,37.0,0,0,0,0,0,0,1,0.0,1,0,0,0,4,4,15,Matches
2123,Amos Pieper,de,DF,,Werder Bremen,Bundesliga,24,1998,21.7,46,28,25,19,2,24,40,60.0,16,23,11,12,30,76,94,Matches
2124,Ronaël Pierre-Gabriel,fr,DF,,Espanyol,La Liga,24,1998,2.6,17,9,12,4,1,5,11,45.5,6,5,2,3,9,26,11,Matches
2125,Ronaël Pierre-Gabriel,fr,DF,,Strasbourg,Ligue 1,24,1998,7.3,25,18,11,12,2,15,17,88.2,2,16,3,13,9,34,22,Matches
2126,Andrea Pinamonti,it,FW,,Sassuolo,it Serie A,23,1999,24.0,10,7,0,5,5,3,7,42.9,4,19,2,17,2,12,11,Matches
2127,Ethan Pinnock,jm,DF,,Brentford,Premier League,29,1993,30.0,52,28,33,12,7,18,24,75.0,6,41,31,10,35,87,215,Matches
2128,Yeremi Pino,es,FW,MF,Villarreal,La Liga,19,2002,27.2,62,38,25,20,17,21,56,37.5,35,41,4,37,15,77,36,Matches
2129,Gerard Piqué,es,DF,,Barcelona,La Liga,35,1987,4.3,5,4,1,4,0,4,4,100.0,0,2,1,1,2,7,19,Matches
2130,Lorenzo Pirola,it,DF,,Salernitana,it Serie A,20,2002,21.6,33,29,18,14,1,19,27,70.4,8,50,35,15,30,63,85,Matches
2131,Niccolò Pisilli,it,MF,,Roma,it Serie A,17,2004,0.0,0,0,0,0,0,0,0,,0,0,0,0,0,0,0,Matches
2132,Marko Pjaca,hr,MF,FW,Empoli,it Serie A,27,1995,5.8,4,3,3,1,0,3,5,60.0,2,3,0,3,3,7,3,Matches
2133,Óscar Plano,es,FW,MF,Valladolid,La Liga,31,1991,22.6,40,25,9,17,14,12,37,32.4,25,26,2,24,29,69,23,Matches
2134,Gonzalo Plata,ec,FW,,Valladolid,La Liga,21,2000,25.6,66,35,31,24,11,23,70,32.9,47,40,0,40,12,78,10,Matches
2135,Marvin Plattenhardt,de,DF,,Hertha BSC,Bundesliga,30,1992,26.7,43,33,24,15,4,29,47,61.7,18,25,11,14,15,58,82,Matches
2136,Alassane Pléa,fr,FW,,Gladbach,Bundesliga,29,1993,19.7,16,8,5,7,4,8,26,30.8,18,23,3,20,12,28,14,Matches
2137,Tommaso Pobega,it,MF,,Milan,it Serie A,23,1999,9.8,27,16,8,15,4,13,20,65.0,7,12,4,8,9,36,11,Matches
2138,Daniel Podence,pt,FW,MF,Wolves,Premier League,26,1995,19.7,27,17,13,9,5,6,32,18.8,26,19,0,19,7,34,6,Matches
2139,Paul Pogba,fr,MF,FW,Juventus,it Serie A,29,1993,1.2,0,0,0,0,0,0,1,0.0,1,0,0,0,0,0,2,Matches
2140,Joel Pohjanpalo,fi,FW,MF,Leverkusen,Bundesliga,27,1994,0.0,0,0,0,0,0,0,0,,0,0,0,0,0,0,0,Matches
2141,Matteo Politano,it,FW,,Napoli,it Serie A,28,1993,13.0,18,9,9,5,4,11,25,44.0,14,6,0,6,7,25,7,Matches
2142,Sebastian Polter,de,FW,,Schalke 04,Bundesliga,31,1991,7.0,4,3,0,4,0,1,4,25.0,3,4,0,4,1,5,6,Matches
2143,Ezequiel Ponce,ar,FW,MF,Elche,La Liga,25,1997,12.5,9,7,0,6,3,0,7,0.0,7,6,1,5,1,10,13,Matches
2144,Julien Ponceau,fr,MF,,Lorient,Ligue 1,21,2000,18.4,28,19,10,14,4,10,32,31.3,22,27,3,24,14,42,12,Matches
2145,Marin Pongračić,hr,DF,,Lecce,it Serie A,24,1997,8.8,16,14,8,7,1,5,7,71.4,2,4,3,1,16,32,31,Matches
2146,Nick Pope,eng,GK,,Newcastle Utd,Premier League,30,1992,36.2,1,0,1,0,0,1,3,33.3,2,0,0,0,0,1,27,Matches
2147,Łukasz Poręba,pl,MF,,Lens,Ligue 1,22,2000,2.9,5,4,2,1,2,2,3,66.7,1,3,0,3,4,9,2,Matches
2148,Jackson Porozo,ec,DF,,Troyes,Ligue 1,21,2000,18.0,32,20,24,7,1,13,31,41.9,18,24,17,7,33,65,75,Matches
2149,Pedro Porro,es,DF,MF,Tottenham,Premier League,22,1999,12.6,25,16,8,15,2,14,39,35.9,25,25,2,23,15,40,24,Matches
2150,Francisco Portillo,es,MF,FW,Almería,La Liga,32,1990,8.0,13,6,4,5,4,3,16,18.8,13,7,1,6,7,20,8,Matches
2151,Portu,es,MF,DF,Getafe,La Liga,30,1992,19.7,28,21,14,10,4,18,42,42.9,24,23,3,20,17,45,20,Matches
2152,Stefan Posch,at,DF,,Bologna,it Serie A,25,1997,28.1,81,43,41,29,11,44,75,58.7,31,44,15,29,35,116,69,Matches
2153,Stefan Posch,at,DF,,Hoffenheim,Bundesliga,25,1997,0.2,0,0,0,0,0,0,0,,0,0,0,0,0,0,0,Matches
2154,Yussuf Poulsen,dk,FW,,RB Leipzig,Bundesliga,28,1994,4.6,6,4,1,4,1,2,5,40.0,3,3,1,2,0,6,5,Matches
2155,José Pozo,es,MF,FW,Rayo Vallecano,La Liga,26,1996,1.0,2,2,0,2,0,0,0,,0,0,0,0,1,3,1,Matches
2156,Manuel Pozo,es,FW,,Valladolid,La Liga,20,2001,0.2,0,0,0,0,0,0,0,,0,2,0,2,2,2,0,Matches
2157,Alejandro Pozo Pozo,es,DF,,Almería,La Liga,23,1999,20.9,37,19,17,17,3,27,53,50.9,26,30,5,25,26,63,45,Matches
2158,Dennis Praet,be,MF,FW,Leicester City,Premier League,28,1994,7.2,12,9,5,6,1,6,11,54.5,5,12,2,10,5,17,6,Matches
2159,Abdón Prats,es,FW,MF,Mallorca,La Liga,29,1992,4.6,1,0,1,0,0,0,0,,0,5,0,5,0,1,2,Matches
2160,Sanjin Prcić,ba,MF,,Strasbourg,Ligue 1,28,1993,18.1,27,12,6,16,5,19,31,61.3,12,22,7,15,25,52,22,Matches
2161,Isaac Price,nir,MF,,Everton,Premier League,18,2003,0.4,0,0,0,0,0,0,1,0.0,1,1,1,0,0,0,0,Matches
2162,Grischa Prömel,de,MF,,Hoffenheim,Bundesliga,27,1995,16.2,27,19,14,11,2,9,25,36.0,16,22,4,18,8,35,23,Matches
2163,Ivan Provedel,it,GK,,Lazio,it Serie A,28,1994,37.9,1,0,1,0,0,0,0,,0,0,0,0,0,1,15,Matches
2164,Javi Puado,es,FW,MF,Espanyol,La Liga,24,1998,26.0,20,11,12,5,3,12,28,42.9,16,12,2,10,10,30,14,Matches
2165,Mehdi Puch-Herrantz,fr,MF,,Ajaccio,Ligue 1,18,2004,0.5,2,2,0,1,1,1,2,50.0,1,1,0,1,3,5,0,Matches
2166,Tymoteusz Puchacz,pl,DF,,Union Berlin,Bundesliga,23,1999,0.6,1,0,1,0,0,0,0,,0,0,0,0,0,1,1,Matches
2167,Arnau Puigmal,es,MF,FW,Almería,La Liga,21,2001,8.5,22,14,10,7,5,12,17,70.6,5,7,0,7,11,33,6,Matches
2168,Christian Pulisic,us,FW,DF,Chelsea,Premier League,23,1998,9.1,11,6,3,6,2,3,5,60.0,2,8,1,7,4,15,4,Matches
2169,Ignacio Pussetto,ar,MF,DF,Sampdoria,it Serie A,26,1995,1.7,6,3,2,3,1,3,4,75.0,1,4,0,4,0,6,3,Matches
2170,Niklas Pyyhtiä,fi,MF,,Bologna,it Serie A,18,2003,1.2,1,0,0,1,0,0,1,0.0,1,1,1,0,1,2,4,Matches
2171,Fabio Quagliarella,it,FW,,Sampdoria,it Serie A,39,1983,8.9,2,1,1,1,0,1,7,14.3,6,5,1,4,0,2,9,Matches
2172,Giacomo Quagliata,it,DF,,Cremonese,it Serie A,22,2000,7.8,10,8,7,1,2,5,11,45.5,6,7,2,5,11,21,8,Matches
2173,Eduardo Quaresma,pt,DF,,Hoffenheim,Bundesliga,20,2002,1.0,5,3,3,2,0,1,3,33.3,2,3,2,1,0,5,3,Matches
2174,Joshua Quarshie,de,MF,,Hoffenheim,Bundesliga,18,2004,0.0,0,0,0,0,0,0,0,,0,0,0,0,0,0,0,Matches
2175,Ghjuvanni Quilichini,fr,GK,,Ajaccio,Ligue 1,19,2002,0.9,0,0,0,0,0,0,0,,0,0,0,0,0,0,1,Matches
2176,Domingos Quina,pt,MF,,Elche,La Liga,22,1999,3.1,3,2,2,1,0,1,3,33.3,2,5,0,5,3,6,1,Matches
2177,Rubén Quintanilla,es,DF,,Mallorca,La Liga,20,2002,0.0,0,0,0,0,0,0,0,,0,1,0,1,0,0,0,Matches
2178,Adrien Rabiot,fr,MF,,Juventus,it Serie A,27,1995,30.5,65,35,31,23,11,30,57,52.6,27,37,7,30,26,91,44,Matches
2179,Nemanja Radonjić,rs,MF,FW,Torino,it Serie A,26,1996,16.2,2,1,2,0,0,0,4,0.0,4,3,0,3,2,4,4,Matches
2180,Ivan Radovanović,rs,MF,DF,Salernitana,it Serie A,33,1988,7.5,12,4,8,4,0,4,10,40.0,6,9,3,6,7,19,9,Matches
2181,Ionuț Radu,ro,GK,,Cremonese,it Serie A,25,1997,9.0,0,0,0,0,0,0,0,,0,0,0,0,0,0,1,Matches
2182,Ionuț Radu,ro,GK,,Auxerre,Ligue 1,25,1997,17.0,0,0,0,0,0,0,0,,0,0,0,0,0,0,3,Matches
2183,Ștefan Radu,ro,FW,,Lazio,it Serie A,35,1986,0.0,0,0,0,0,0,0,0,,0,0,0,0,0,0,0,Matches
2184,Antonio Raillo,es,DF,,Mallorca,La Liga,30,1991,30.7,34,21,23,11,0,10,15,66.7,5,38,29,9,31,65,158,Matches
2185,Antonio Raimondo,it,FW,,Bologna,it Serie A,18,2004,0.2,0,0,0,0,0,0,0,,0,0,0,0,0,0,1,Matches
2186,Predrag Rajković,rs,GK,,Mallorca,La Liga,26,1995,36.0,0,0,0,0,0,0,2,0.0,2,0,0,0,0,0,16,Matches
2187,Ivan Rakitić,hr,MF,,Sevilla,La Liga,34,1988,19.9,37,26,10,18,9,19,40,47.5,21,21,1,20,27,64,20,Matches
2188,Diant Ramaj,de,GK,,Eint Frankfurt,Bundesliga,20,2001,1.0,0,0,0,0,0,0,0,,0,0,0,0,0,0,1,Matches
2189,Largie Ramazani,be,FW,MF,Almería,La Liga,21,2001,15.6,15,9,6,3,6,8,27,29.6,19,11,0,11,15,30,10,Matches
2190,Simon Ramet,fr,DF,,Lille,Ligue 1,19,2003,0.0,0,0,0,0,0,0,0,,0,0,0,0,0,0,0,Matches
2191,Adil Rami,fr,DF,,Troyes,Ligue 1,36,1985,17.7,19,14,13,5,1,17,32,53.1,15,23,16,7,25,44,75,Matches
2192,Chris Ramos,es,FW,,Cádiz,La Liga,25,1997,7.9,12,9,2,7,3,4,11,36.4,7,8,3,5,1,13,19,Matches
2193,Sergio Ramos,es,DF,,Paris S-G,Ligue 1,36,1986,30.0,34,26,14,18,2,23,44,52.3,21,29,13,16,34,68,93,Matches
2194,Aaron Ramsdale,eng,GK,,Arsenal,Premier League,24,1998,38.0,1,1,1,0,0,1,1,100.0,0,0,0,0,0,1,20,Matches
2195,Aaron Ramsey,wls,MF,,Nice,Ligue 1,31,1990,17.6,47,25,18,19,10,16,39,41.0,23,25,4,21,17,64,18,Matches
2196,Jacob Ramsey,eng,MF,FW,Aston Villa,Premier League,21,2001,29.3,69,39,23,35,11,32,69,46.4,37,48,8,40,23,92,34,Matches
2197,Luca Ranieri,it,DF,,Fiorentina,it Serie A,23,1999,5.6,9,4,6,3,0,6,9,66.7,3,5,3,2,11,20,15,Matches
2198,Andrea Ranocchia,it,DF,,Monza,it Serie A,34,1988,0.5,3,1,1,2,0,3,4,75.0,1,5,5,0,0,3,7,Matches
2199,Filippo Ranocchia,it,MF,,Monza,it Serie A,21,2001,5.9,11,6,5,4,2,4,12,33.3,8,5,1,4,4,15,7,Matches
2200,Lilian Raolisoa,fr,DF,MF,Angers,Ligue 1,22,2000,1.9,11,9,6,3,2,7,10,70.0,3,3,1,2,3,14,5,Matches
2201,Raphinha,br,FW,,Barcelona,La Liga,25,1996,23.0,29,19,10,7,12,11,31,35.5,20,33,1,32,14,43,11,Matches
2202,Nicolai Rapp,de,MF,DF,Werder Bremen,Bundesliga,25,1996,0.8,3,1,3,0,0,0,3,0.0,3,0,0,0,0,3,1,Matches
2203,Elba Rashani,xk,MF,FW,Clermont Foot,Ligue 1,29,1993,24.0,39,26,13,19,7,13,39,33.3,26,27,2,25,21,60,19,Matches
2204,Marcus Rashford,eng,FW,,Manchester Utd,Premier League,24,1997,32.0,20,10,7,8,5,9,24,37.5,15,31,4,27,7,27,14,Matches
2205,Giacomo Raspadori,it,FW,,Sassuolo,it Serie A,22,2000,0.5,0,0,0,0,0,0,0,,0,0,0,0,0,0,0,Matches
2206,Giacomo Raspadori,it,FW,MF,Napoli,it Serie A,22,2000,10.1,10,8,0,6,4,4,10,40.0,6,9,0,9,4,14,4,Matches
2207,Rafael Ratão,br,FW,MF,Toulouse,Ligue 1,26,1995,20.6,52,36,29,16,7,27,73,37.0,46,34,0,34,21,73,7,Matches
2208,David Raum,de,DF,MF,RB Leipzig,Bundesliga,24,1998,18.7,39,25,23,12,4,17,29,58.6,12,24,6,18,16,55,26,Matches
2209,Nicola Ravaglia,it,GK,,Sampdoria,it Serie A,33,1988,9.0,0,0,0,0,0,0,1,0.0,1,0,0,0,0,0,7,Matches
2210,Rayan Raveloson,mg,DF,MF,Auxerre,Ligue 1,25,1997,27.0,38,23,21,16,1,23,33,69.7,10,43,12,31,39,77,70,Matches
2211,David Raya,es,GK,,Brentford,Premier League,26,1995,38.0,0,0,0,0,0,0,2,0.0,2,1,0,1,1,1,10,Matches
2212,Tim Ream,us,DF,,Fulham,Premier League,34,1987,32.2,30,16,15,12,3,13,26,50.0,13,45,24,21,41,71,116,Matches
2213,Ante Rebić,hr,FW,MF,Milan,it Serie A,28,1993,10.9,10,8,1,3,6,3,11,27.3,8,6,1,5,1,11,5,Matches
2214,Arkadiusz Reca,pl,DF,,Spezia,it Serie A,27,1995,24.1,44,28,22,12,10,19,32,59.4,13,21,5,16,24,68,54,Matches
2215,Nathan Redmond,eng,DF,,Southampton,Premier League,28,1994,0.0,0,0,0,0,0,0,0,,0,0,0,0,0,0,0,Matches
2216,Harrison Reed,eng,MF,,Fulham,Premier League,27,1995,31.8,44,27,17,21,6,16,51,31.4,35,54,12,42,19,63,36,Matches
2217,Sergio Reguilón,es,DF,,Atlético Madrid,La Liga,25,1996,3.4,7,5,5,2,0,5,7,71.4,2,3,0,3,2,9,4,Matches
2218,Bobby Reid,jm,FW,DF,Fulham,Premier League,29,1993,27.5,42,24,14,14,14,16,36,44.4,20,25,3,22,20,62,28,Matches
2219,Pepe Reina,es,GK,,Villarreal,La Liga,39,1982,22.0,0,0,0,0,0,0,1,0.0,1,0,0,0,1,1,4,Matches
2220,Jeff Reine-Adélaïde,fr,MF,,Troyes,Ligue 1,24,1998,2.6,3,2,2,1,0,1,2,50.0,1,2,0,2,2,5,1,Matches
2221,Jeff Reine-Adélaïde,fr,MF,,Lyon,Ligue 1,24,1998,3.7,8,5,1,5,2,5,9,55.6,4,4,0,4,6,14,0,Matches
2222,Reinier,br,MF,FW,Girona,La Liga,20,2002,7.2,12,10,7,3,2,2,8,25.0,6,6,0,6,5,17,4,Matches
2223,Rocco Reitz,de,MF,,Gladbach,Bundesliga,20,2002,0.0,0,0,0,0,0,0,0,,0,0,0,0,0,0,0,Matches
2224,Karim Rekik,nl,DF,,Sevilla,La Liga,27,1994,13.1,11,5,8,3,0,4,5,80.0,1,12,5,7,10,21,24,Matches
2225,Álex Remiro,es,GK,,Real Sociedad,La Liga,27,1995,38.0,1,1,1,0,0,1,3,33.3,2,0,0,0,0,1,17,Matches
2226,Panagiotis Retsos,gr,DF,,Hellas Verona,it Serie A,23,1998,1.4,5,4,2,2,1,3,3,100.0,0,4,1,3,2,7,3,Matches
2227,Marco Reus,de,MF,FW,Dortmund,Bundesliga,33,1989,15.0,30,17,12,14,4,7,24,29.2,17,12,4,8,8,38,8,Matches
2228,Alejandro Revuelta Montero,es,DF,,Getafe,La Liga,22,2000,0.0,0,0,0,0,0,0,0,,0,0,0,0,0,0,1,Matches
2229,Elvis Rexhbeçaj,xk,MF,,Augsburg,Bundesliga,24,1997,28.0,51,30,18,24,9,29,59,49.2,30,39,12,27,17,68,40,Matches
2230,Gio Reyna,us,FW,MF,Dortmund,Bundesliga,19,2002,6.9,14,7,2,5,7,5,10,50.0,5,8,2,6,3,17,5,Matches
2231,Chadi Riad,ma,MF,,Barcelona,La Liga,19,2003,0.0,0,0,0,0,0,0,0,,0,0,0,0,0,0,0,Matches
2232,Nico Ribaudo,es,MF,FW,Espanyol,La Liga,21,2001,13.9,18,13,5,9,4,11,30,36.7,19,19,1,18,5,23,1,Matches
2233,Alexsandro Ribeiro,br,DF,,Lille,Ligue 1,22,1999,17.9,32,18,24,7,1,19,28,67.9,9,11,2,9,25,57,59,Matches
2234,Franck Ribéry,fr,MF,,Salernitana,it Serie A,39,1983,0.4,0,0,0,0,0,0,0,,0,1,0,1,0,0,0,Matches
2235,Samuele Ricci,it,MF,,Torino,it Serie A,20,2001,23.0,32,21,17,10,5,18,23,78.3,5,20,5,15,17,49,29,Matches
2236,Declan Rice,eng,MF,,West Ham,Premier League,23,1999,36.4,79,38,44,31,4,31,50,62.0,19,45,15,30,63,142,58,Matches
2237,Chris Richards,us,DF,,Crystal Palace,Premier League,22,2000,5.0,9,6,8,1,0,5,7,71.4,2,10,1,9,8,17,31,Matches
2238,Richarlison,br,MF,FW,Tottenham,Premier League,25,1997,11.2,21,16,13,5,3,12,27,44.4,15,14,1,13,5,26,10,Matches
2239,Marco Richter,de,MF,FW,Hertha BSC,Bundesliga,24,1997,20.4,43,23,18,17,8,19,48,39.6,29,29,2,27,24,67,25,Matches
2240,Diego Rico,es,DF,,Real Sociedad,La Liga,29,1993,18.3,35,21,17,11,7,12,27,44.4,15,18,5,13,20,55,51,Matches
2241,Jaïro Riedewald,nl,DF,MF,Crystal Palace,Premier League,25,1996,0.7,2,1,2,0,0,0,1,0.0,1,2,0,2,0,2,4,Matches
2242,Manuel Riemann,de,GK,,Bochum,Bundesliga,33,1988,34.0,3,2,3,0,0,3,5,60.0,2,1,0,1,5,8,23,Matches
2243,Tomás Rincón,ve,MF,,Sampdoria,it Serie A,34,1988,28.4,56,27,22,26,8,29,61,47.5,32,37,7,30,30,86,18,Matches
2244,Rémy Riou,fr,GK,,Lyon,Ligue 1,34,1987,6.7,1,0,1,0,0,1,1,100.0,0,0,0,0,0,1,3,Matches
2245,Renaud Ripart,fr,FW,MF,Troyes,Ligue 1,29,1993,14.7,40,23,14,20,6,19,52,36.5,33,29,2,27,7,47,5,Matches
2246,Rodrigo Riquelme,es,MF,FW,Girona,La Liga,22,2000,24.2,20,8,8,8,4,9,35,25.7,26,16,0,16,11,31,5,Matches
2247,Matt Ritchie,sct,FW,MF,Newcastle Utd,Premier League,32,1989,0.4,1,1,0,1,0,1,3,33.3,2,0,0,0,1,2,0,Matches
2248,Sergi Roberto,es,DF,MF,Barcelona,La Liga,30,1992,14.5,22,15,12,6,4,7,18,38.9,11,15,7,8,11,33,16,Matches
2249,Lucas Robertone,ar,MF,,Almería,La Liga,25,1997,31.6,50,28,20,21,9,28,64,43.8,36,45,7,38,46,96,46,Matches
2250,Andrew Robertson,sct,DF,,Liverpool,Premier League,28,1994,28.7,38,21,12,16,10,21,41,51.2,20,32,5,27,18,56,50,Matches
2251,Antonee Robinson,us,DF,,Fulham,Premier League,24,1997,34.3,62,38,43,15,4,44,65,67.7,21,49,13,36,53,115,83,Matches
2252,Joel Robles,es,GK,,Leeds United,Premier League,32,1990,4.0,0,0,0,0,0,0,1,0.0,1,0,0,0,0,0,2,Matches
2253,Joel Roca,es,MF,FW,Girona,La Liga,17,2005,0.9,2,2,2,0,0,2,5,40.0,3,1,1,0,0,2,1,Matches
2254,Marc Roca,es,MF,,Leeds United,Premier League,25,1996,25.7,66,40,27,34,5,20,65,30.8,45,34,10,24,23,89,24,Matches
2255,Enzo Roco,cl,DF,,Elche,La Liga,29,1992,18.4,33,13,23,10,0,15,24,62.5,9,22,15,7,17,50,63,Matches
2256,Marek Rodák,sk,GK,,Fulham,Premier League,25,1996,2.0,0,0,0,0,0,0,0,,0,0,0,0,0,0,1,Matches
2257,Sebastian Rode,de,MF,,Eint Frankfurt,Bundesliga,31,1990,15.7,38,24,7,28,3,14,45,31.1,31,18,2,16,16,54,12,Matches
2258,Joe Rodon,wls,DF,,Rennes,Ligue 1,24,1997,15.7,11,7,9,2,0,4,10,40.0,6,16,12,4,9,20,54,Matches
2259,Rodri,es,MF,,Manchester City,Premier League,26,1996,32.3,67,41,28,28,11,26,53,49.1,27,40,14,26,33,100,43,Matches
2260,Rodri,es,FW,MF,Betis,La Liga,22,2000,17.8,16,11,5,9,2,8,17,47.1,9,10,0,10,13,29,2,Matches
2261,Rodrigo,es,FW,MF,Leeds United,Premier League,31,1991,21.5,24,10,2,15,7,8,19,42.1,11,16,4,12,6,30,21,Matches
2262,Álvaro Rodríguez,uy,FW,,Real Madrid,La Liga,18,2004,0.9,2,1,1,0,1,1,1,100.0,0,0,0,0,0,2,1,Matches
2263,Ángel Rodríguez,es,FW,MF,Mallorca,La Liga,35,1987,4.4,1,1,0,1,0,0,2,0.0,2,3,0,3,1,2,1,Matches
2264,Óscar Rodríguez Arnaiz,es,MF,,Celta Vigo,La Liga,24,1998,19.7,32,25,12,15,5,13,28,46.4,15,16,2,14,24,56,15,Matches
2265,Dani Rodríguez,es,MF,,Mallorca,La Liga,34,1988,23.3,42,23,18,22,2,21,46,45.7,25,31,8,23,21,63,14,Matches
2266,Guido Rodríguez,ar,MF,,Betis,La Liga,28,1994,31.9,115,75,59,50,6,54,101,53.5,47,58,14,44,42,157,76,Matches
2267,Miguel Rodríguez,es,MF,FW,Celta Vigo,La Liga,19,2003,2.8,7,5,4,3,0,4,11,36.4,7,6,0,6,1,8,3,Matches
2268,Pablo Rodríguez,es,FW,MF,Lecce,it Serie A,20,2001,0.6,2,1,2,0,0,0,2,0.0,2,3,0,3,0,2,0,Matches
2269,Ricardo Rodríguez,ch,DF,,Torino,it Serie A,29,1992,29.7,54,33,30,17,7,28,42,66.7,14,30,15,15,38,92,61,Matches
2270,Rodrygo,br,FW,MF,Real Madrid,La Liga,21,2001,26.4,17,10,3,7,7,4,23,17.4,19,23,0,23,8,25,5,Matches
2271,Mads Roerslev,dk,DF,,Brentford,Premier League,23,1999,12.3,22,12,19,3,0,16,33,48.5,17,14,5,9,9,31,38,Matches
2272,Agustín Rogel,uy,DF,,Hertha BSC,Bundesliga,24,1997,15.8,18,9,13,5,0,11,17,64.7,6,15,8,7,11,29,74,Matches
2273,Rogério,br,DF,,Sassuolo,it Serie A,24,1998,33.3,37,21,22,8,7,17,35,48.6,18,32,9,23,37,74,70,Matches
2274,Merlin Röhl,de,MF,FW,Freiburg,Bundesliga,20,2002,0.6,1,0,1,0,0,0,0,,0,0,0,0,0,1,1,Matches
2275,Tony Rölke,de,FW,,Hertha BSC,Bundesliga,19,2003,0.2,0,0,0,0,0,0,0,,0,1,0,1,0,0,1,Matches
2276,Filippo Romagna,it,DF,,Sassuolo,it Serie A,25,1997,0.5,0,0,0,0,0,0,0,,0,1,1,0,0,0,2,Matches
2277,Alessio Romagnoli,it,DF,,Lazio,it Serie A,27,1995,32.5,33,15,19,14,0,11,22,50.0,11,33,26,7,38,71,108,Matches
2278,Simone Romagnoli,it,DF,,Lecce,it Serie A,32,1990,1.9,6,5,3,3,0,2,2,100.0,0,4,1,3,1,7,11,Matches
2279,Leo Román,es,GK,,Mallorca,La Liga,22,2000,1.0,0,0,0,0,0,0,0,,0,0,0,0,0,0,0,Matches
2280,Cristian Romero,ar,DF,,Tottenham,Premier League,24,1998,26.3,68,36,42,24,2,29,46,63.0,17,40,18,22,44,112,102,Matches
2281,Iván Romero,es,MF,,Sevilla,La Liga,21,2001,0.1,0,0,0,0,0,0,0,,0,0,0,0,0,0,0,Matches
2282,Luka Romero,ar,FW,,Lazio,it Serie A,17,2004,1.7,0,0,0,0,0,0,3,0.0,3,4,0,4,3,3,1,Matches
2283,Oriol Romeu,es,MF,,Southampton,Premier League,30,1991,0.8,1,0,0,1,0,0,0,,0,1,0,1,1,2,1,Matches
2284,Oriol Romeu,es,MF,,Girona,La Liga,30,1991,32.8,70,38,36,26,8,26,51,51.0,25,48,10,38,37,107,54,Matches
2285,Cristiano Ronaldo,pt,FW,,Manchester Utd,Premier League,37,1985,5.8,2,2,1,0,1,1,2,50.0,1,0,0,0,1,3,9,Matches
2286,Connor Ronan,ie,MF,,Wolves,Premier League,24,1998,0.0,0,0,0,0,0,0,0,,0,0,0,0,0,0,0,Matches
2287,Salomón Rondón,ve,FW,,Everton,Premier League,32,1989,1.2,0,0,0,0,0,0,0,,0,1,1,0,0,0,0,Matches
2288,Valentin Rongier,fr,MF,,Marseille,Ligue 1,27,1994,33.7,93,59,33,47,13,41,77,53.2,36,50,11,39,54,147,38,Matches
2289,Marten de Roon,nl,MF,,Atalanta,it Serie A,31,1991,32.9,77,39,37,35,5,37,81,45.7,44,37,4,33,36,113,58,Matches
2290,Pablo Rosario,nl,MF,DF,Nice,Ligue 1,25,1997,19.6,46,26,22,20,4,18,34,52.9,16,15,5,10,23,69,32,Matches
2291,Francesco Rossi,it,GK,,Atalanta,it Serie A,31,1991,0.0,0,0,0,0,0,0,0,,0,0,0,0,0,0,0,Matches
2292,Tom Rothe,de,DF,,Dortmund,Bundesliga,17,2004,0.3,1,1,0,1,0,1,1,100.0,0,0,0,0,1,2,2,Matches
2293,Joe Rothwell,eng,MF,,Bournemouth,Premier League,27,1995,11.3,20,13,7,12,1,7,21,33.3,14,14,3,11,9,29,7,Matches
2294,Anthony Rouault,fr,DF,,Toulouse,Ligue 1,21,2001,36.8,66,37,54,10,2,30,58,51.7,28,52,26,26,56,122,126,Matches
2295,Jérôme Roussillon,fr,MF,DF,Wolfsburg,Bundesliga,29,1993,0.2,0,0,0,0,0,0,0,,0,0,0,0,0,0,0,Matches
2296,Jérôme Roussillon,fr,DF,,Union Berlin,Bundesliga,29,1993,10.6,16,9,6,8,2,8,12,66.7,4,7,2,5,4,20,22,Matches
2297,Nicolò Rovella,it,MF,,Monza,it Serie A,20,2001,19.3,45,29,22,21,2,13,36,36.1,23,20,1,19,40,85,17,Matches
2298,Nicolò Rovella,it,MF,,Juventus,it Serie A,20,2001,0.3,1,1,0,1,0,1,1,100.0,0,0,0,0,0,1,0,Matches
2299,Amir Rrahmani,xk,DF,,Napoli,it Serie A,28,1994,27.2,33,18,20,13,0,17,26,65.4,9,36,20,16,14,47,79,Matches
2300,Ruan,br,DF,,Sassuolo,it Serie A,23,1999,19.0,38,26,25,12,1,19,29,65.5,10,29,17,12,24,62,80,Matches
2301,Rubén,es,DF,MF,Espanyol,La Liga,21,2001,9.9,30,15,18,9,3,20,29,69.0,9,14,4,10,18,48,18,Matches
2302,Antonio Rüdiger,de,DF,,Real Madrid,La Liga,29,1993,26.8,18,16,12,5,1,14,23,60.9,9,23,13,10,19,37,74,Matches
2303,Sebastian Rudy,de,MF,,Hoffenheim,Bundesliga,32,1990,8.8,26,12,10,16,0,13,27,48.1,14,27,7,20,11,37,13,Matches
2304,Daniele Rugani,it,DF,,Juventus,it Serie A,28,1994,6.3,7,0,6,1,0,4,4,100.0,0,7,5,2,7,14,32,Matches
2305,Matteo Ruggeri,it,DF,MF,Atalanta,it Serie A,20,2002,9.2,17,12,5,9,3,8,16,50.0,8,14,3,11,12,29,16,Matches
2306,Mário Rui,pt,DF,,Napoli,it Serie A,31,1991,19.4,34,22,17,13,4,20,41,48.8,21,17,4,13,15,49,24,Matches
2307,Aitor Ruibal,es,DF,FW,Betis,La Liga,26,1996,16.2,47,29,35,9,3,31,58,53.4,27,17,2,15,24,71,41,Matches
2308,Kays Ruiz,fr,MF,,Auxerre,Ligue 1,19,2002,0.7,1,1,1,0,0,0,1,0.0,1,2,1,1,3,4,0,Matches
2309,Fabián Ruiz Peña,es,MF,,Paris S-G,Ligue 1,26,1996,21.0,62,28,25,30,7,43,79,54.4,36,24,1,23,18,80,23,Matches
2310,Víctor Ruiz,es,DF,,Betis,La Liga,33,1989,6.2,5,3,3,2,0,3,3,100.0,0,10,7,3,6,11,34,Matches
2311,Gerónimo Rulli,ar,GK,,Villarreal,La Liga,30,1992,14.0,0,0,0,0,0,0,0,,0,1,0,1,1,1,6,Matches
2312,Alessandro Russo,it,GK,,Sassuolo,it Serie A,21,2001,1.0,0,0,0,0,0,0,0,,0,0,0,0,0,0,1,Matches
2313,Franco Russo,ar,DF,,Mallorca,La Liga,27,1994,1.6,2,1,2,0,0,0,1,0.0,1,5,0,5,3,5,5,Matches
2314,Georginio Rutter,fr,FW,MF,Leeds United,Premier League,20,2002,3.0,10,9,5,3,2,5,8,62.5,3,5,0,5,3,13,3,Matches
2315,Georginio Rutter,fr,FW,,Hoffenheim,Bundesliga,20,2002,11.2,7,4,1,4,2,1,3,33.3,2,10,2,8,5,12,6,Matches
2316,Julian Ryerson,no,DF,,Union Berlin,Bundesliga,24,1997,11.5,28,17,17,10,1,15,25,60.0,10,15,3,12,12,40,19,Matches
2317,Julian Ryerson,no,DF,,Dortmund,Bundesliga,24,1997,15.7,27,15,17,7,3,19,37,51.4,18,13,2,11,8,35,28,Matches
2318,Frederik Rønnow,dk,GK,,Union Berlin,Bundesliga,29,1992,29.0,0,0,0,0,0,0,5,0.0,5,0,0,0,0,0,9,Matches
2319,José Sá,pt,GK,,Wolves,Premier League,29,1993,36.0,1,0,1,0,0,1,1,100.0,0,0,0,0,0,1,10,Matches
2320,Youssouf Sabaly,sn,DF,,Betis,La Liga,29,1993,18.7,45,23,29,14,2,22,33,66.7,11,35,8,27,19,64,52,Matches
2321,Halid Šabanović,ba,DF,,Angers,Ligue 1,22,1999,7.1,8,6,7,1,0,6,8,75.0,2,8,2,6,8,16,12,Matches
2322,Abdelhamid Sabiri,ma,MF,FW,Sampdoria,it Serie A,25,1996,11.9,18,7,5,9,4,4,13,30.8,9,18,4,14,2,20,5,Matches
2323,Marcel Sabitzer,at,MF,,Manchester Utd,Premier League,28,1994,7.0,12,8,3,8,1,2,11,18.2,9,6,2,4,8,20,11,Matches
2324,Marcel Sabitzer,at,MF,,Bayern Munich,Bundesliga,28,1994,7.0,27,14,11,10,6,10,17,58.8,7,3,0,3,10,37,9,Matches
2325,Falaye Sacko,ml,DF,,Montpellier,Ligue 1,27,1995,28.7,46,25,25,15,6,32,51,62.7,19,43,14,29,33,79,75,Matches
2326,Umar Sadiq,ng,FW,,Almería,La Liga,25,1997,2.7,0,0,0,0,0,0,1,0.0,1,2,0,2,0,0,3,Matches
2327,Umar Sadiq,ng,FW,,Real Sociedad,La Liga,25,1997,0.9,1,1,0,0,1,0,1,0.0,1,2,0,2,0,1,0,Matches
2328,Alexis Saelemaekers,be,FW,DF,Milan,it Serie A,23,1999,15.6,31,20,12,16,3,19,41,46.3,22,13,1,12,19,50,11,Matches
2329,Wesley Saïd,fr,FW,MF,Lens,Ligue 1,27,1995,7.2,4,1,1,2,1,2,6,33.3,4,4,0,4,1,5,2,Matches
2330,Allan Saint-Maximin,fr,FW,,Newcastle Utd,Premier League,25,1997,12.4,10,3,3,6,1,2,11,18.2,9,4,0,4,5,15,2,Matches
2331,Théo Sainte-Luce,fr,DF,,Montpellier,Ligue 1,23,1998,5.9,13,11,8,5,0,7,14,50.0,7,7,2,5,10,23,11,Matches
2332,Samuel Sáiz,es,MF,,Girona,La Liga,31,1991,2.7,2,2,0,2,0,1,2,50.0,1,3,0,3,0,2,1,Matches
2333,Bukayo Saka,eng,FW,,Arsenal,Premier League,20,2001,35.3,63,34,22,15,26,20,44,45.5,24,38,0,38,14,77,19,Matches
2334,Hamza Sakhi,fr,MF,,Auxerre,Ligue 1,26,1996,18.4,44,22,22,17,5,22,42,52.4,20,16,1,15,25,69,9,Matches
2335,Mamadou Sakho,fr,DF,,Montpellier,Ligue 1,32,1990,8.5,9,5,4,5,0,3,5,60.0,2,17,12,5,8,17,35,Matches
2336,Jacopo Sala,it,MF,,Spezia,it Serie A,30,1991,1.2,1,0,1,0,0,0,2,0.0,2,2,0,2,1,2,2,Matches
2337,Ibrahim Salah,ma,FW,MF,Rennes,Ligue 1,20,2001,2.5,8,1,5,3,0,2,15,13.3,13,3,0,3,2,10,0,Matches
2338,Mohamed Salah,eg,FW,,Liverpool,Premier League,30,1992,36.6,21,12,4,5,12,10,26,38.5,16,21,0,21,6,27,4,Matches
2339,Amine Salama,fr,FW,MF,Angers,Ligue 1,22,2000,13.9,11,9,3,7,1,2,12,16.7,10,8,2,6,10,21,2,Matches
2340,Kike Salas,es,DF,,Sevilla,La Liga,20,2002,4.1,1,1,1,0,0,0,0,,0,4,3,1,5,6,23,Matches
2341,William Saliba,fr,DF,,Arsenal,Premier League,21,2001,26.8,34,20,23,9,2,15,18,83.3,3,13,10,3,19,53,85,Matches
2342,Dikeni-Rafid Salifou,tg,MF,,Werder Bremen,Bundesliga,19,2003,0.0,0,0,0,0,0,0,0,,0,0,0,0,0,0,0,Matches
2343,Mohammed Salisu,gh,DF,,Southampton,Premier League,23,1999,21.9,52,29,34,16,2,24,34,70.6,10,56,25,31,30,82,122,Matches
2344,Roland Sallai,hu,MF,FW,Freiburg,Bundesliga,25,1997,11.1,11,8,4,3,4,4,10,40.0,6,7,1,6,2,13,11,Matches
2345,Yoann Salmier,gf,DF,,Troyes,Ligue 1,29,1992,29.4,51,29,34,12,5,21,35,60.0,14,34,19,15,39,90,124,Matches
2346,Salvi,es,FW,MF,Rayo Vallecano,La Liga,31,1991,5.4,13,8,5,5,3,2,8,25.0,6,0,0,0,2,15,2,Matches
2347,Lazar Samardzic,rs,MF,,Udinese,it Serie A,20,2002,20.5,33,16,9,20,4,17,43,39.5,26,13,0,13,11,44,16,Matches
2348,Diadie Samassékou,ml,MF,FW,Hoffenheim,Bundesliga,26,1996,0.4,1,0,0,1,0,0,1,0.0,1,0,0,0,0,1,0,Matches
2349,Mama Samba Baldé,gw,FW,,Troyes,Ligue 1,26,1995,29.6,46,21,14,21,11,13,28,46.4,15,30,3,27,10,56,13,Matches
2350,Brice Samba,fr,GK,,Lens,Ligue 1,28,1994,37.0,1,0,1,0,0,1,2,50.0,1,1,0,1,0,1,12,Matches
2351,Albert Sambi Lokonga,be,MF,,Arsenal,Premier League,22,1999,2.2,1,1,0,0,1,0,2,0.0,2,1,0,1,5,6,2,Matches
2352,Albert Sambi Lokonga,be,MF,,Crystal Palace,Premier League,22,1999,6.0,13,10,7,4,2,8,12,66.7,4,8,3,5,7,20,10,Matches
2353,Junior Sambia,fr,DF,,Salernitana,it Serie A,25,1996,7.7,12,5,7,4,1,6,10,60.0,4,9,3,6,8,20,16,Matches
2354,Fede San Emeterio,es,MF,,Cádiz,La Liga,25,1997,20.5,41,22,23,16,2,22,46,47.8,24,34,14,20,17,58,28,Matches
2355,Antonio Sanabria,py,FW,,Torino,it Serie A,26,1996,27.0,11,5,3,3,5,1,7,14.3,6,9,2,7,4,15,7,Matches
2356,Leandro Sanca,gw,FW,MF,Spezia,it Serie A,22,2000,0.4,1,1,0,0,1,1,1,100.0,0,0,0,0,0,1,0,Matches
2357,Oihan Sancet,es,MF,,Athletic Club,La Liga,22,2000,28.1,27,16,2,19,6,11,37,29.7,26,10,0,10,4,31,9,Matches
2358,Renato Sanches,pt,MF,,Paris S-G,Ligue 1,24,1997,8.0,8,1,1,3,4,5,14,35.7,9,13,3,10,9,17,4,Matches
2359,Alexis Sánchez,cl,FW,MF,Marseille,Ligue 1,33,1988,29.8,27,17,5,16,6,3,24,12.5,21,14,0,14,5,32,6,Matches
2360,Antonio Sánchez,es,MF,DF,Mallorca,La Liga,25,1997,12.0,19,8,13,4,2,10,34,29.4,24,18,0,18,22,41,14,Matches
2361,Davinson Sánchez,co,DF,,Tottenham,Premier League,26,1996,9.5,24,11,17,6,1,14,20,70.0,6,16,10,6,12,36,41,Matches
2362,Iván Sánchez,es,MF,FW,Valladolid,La Liga,29,1992,12.8,20,14,8,8,4,10,27,37.0,17,14,1,13,8,28,4,Matches
2363,Javi Sánchez,es,DF,,Valladolid,La Liga,25,1997,26.6,43,26,27,15,1,17,26,65.4,9,32,22,10,46,89,116,Matches
2364,Manu Sánchez,es,DF,,Osasuna,La Liga,21,2000,23.6,51,35,35,9,7,33,63,52.4,30,33,5,28,14,65,51,Matches
2365,Robert Sánchez,es,GK,,Brighton,Premier League,24,1997,23.0,1,0,1,0,0,0,0,,0,0,0,0,3,4,9,Matches
2366,Jadon Sancho,eng,FW,MF,Manchester Utd,Premier League,22,2000,18.7,16,10,7,5,4,8,28,28.6,20,25,2,23,7,23,6,Matches
2367,Alex Sandro,br,DF,,Juventus,it Serie A,31,1991,19.9,35,20,16,16,3,15,22,68.2,7,27,10,17,15,50,64,Matches
2368,Leroy Sané,de,MF,FW,Bayern Munich,Bundesliga,26,1996,22.3,38,30,11,19,8,18,36,50.0,18,11,1,10,3,41,1,Matches
2369,Sidi Sané,de,FW,,Schalke 04,Bundesliga,19,2003,0.3,1,1,1,0,0,1,1,100.0,0,0,0,0,0,1,0,Matches
2370,Morgan Sanson,fr,MF,,Aston Villa,Premier League,27,1994,0.1,2,1,1,1,0,1,1,100.0,0,0,0,0,0,2,0,Matches
2371,Morgan Sanson,fr,MF,,Strasbourg,Ligue 1,27,1994,15.8,36,25,10,16,10,17,56,30.4,39,21,1,20,22,58,9,Matches
2372,Nicola Sansone,it,FW,,Bologna,it Serie A,30,1991,8.2,12,4,6,4,2,5,10,50.0,5,0,0,0,0,12,4,Matches
2373,Baptiste Santamaria,fr,MF,,Rennes,Ligue 1,27,1995,20.1,41,22,13,23,5,21,41,51.2,20,21,5,16,21,62,23,Matches
2374,Riccardo Saponara,it,FW,,Fiorentina,it Serie A,30,1991,13.4,10,5,3,6,1,5,9,55.6,4,7,1,6,5,15,9,Matches
2375,Pablo Sarabia,es,FW,MF,Wolves,Premier League,30,1992,8.5,12,6,4,5,3,6,15,40.0,9,7,0,7,2,14,4,Matches
2376,Pablo Sarabia,es,FW,MF,Paris S-G,Ligue 1,30,1992,4.1,5,4,2,2,1,1,7,14.3,6,3,0,3,2,7,0,Matches
2377,Jeremy Sarmiento,ec,MF,,Brighton,Premier League,20,2002,2.0,6,3,4,1,1,2,5,40.0,3,2,0,2,1,7,0,Matches
2378,Amin Sarr,se,FW,,Lyon,Ligue 1,21,2001,6.0,9,6,1,4,4,1,4,25.0,3,2,0,2,0,9,4,Matches
2379,Bouna Sarr,sn,FW,,Bayern Munich,Bundesliga,30,1992,0.0,0,0,0,0,0,0,0,,0,0,0,0,0,0,0,Matches
2380,Malang Sarr,fr,DF,,Monaco,Ligue 1,23,1999,8.0,6,3,5,1,0,1,5,20.0,4,11,7,4,15,21,29,Matches
2381,Mamadou Sarr,fr,MF,,Lyon,Ligue 1,16,2005,0.1,0,0,0,0,0,0,0,,0,0,0,0,0,0,0,Matches
2382,Mouhamadou Sarr,sn,GK,,Cremonese,it Serie A,25,1997,2.0,0,0,0,0,0,0,0,,0,0,0,0,0,0,2,Matches
2383,Martin Satriano,uy,FW,,Empoli,it Serie A,21,2001,18.9,13,8,5,6,2,6,14,42.9,8,5,0,5,3,16,22,Matches
2384,Téji Savanier,fr,MF,,Montpellier,Ligue 1,30,1991,28.3,46,30,16,19,11,23,70,32.9,47,30,2,28,30,76,12,Matches
2385,Esteban Saveljich,me,FW,,Rayo Vallecano,La Liga,31,1991,0.0,0,0,0,0,0,0,0,,0,0,0,0,0,0,0,Matches
2386,Stefan Savić,me,DF,,Atlético Madrid,La Liga,31,1991,21.6,39,26,29,7,3,26,39,66.7,13,17,8,9,33,72,67,Matches
2387,Joe Scally,us,DF,,Gladbach,Bundesliga,19,2002,24.5,31,20,25,5,1,24,31,77.4,7,17,6,11,8,39,61,Matches
2388,Giorgio Scalvini,it,DF,,Atalanta,it Serie A,18,2003,25.9,54,29,30,18,6,29,55,52.7,26,36,13,23,56,110,57,Matches
2389,Gianluca Scamacca,it,FW,,West Ham,Premier League,23,1999,10.3,10,5,1,3,6,2,2,100.0,0,3,0,3,4,14,5,Matches
2390,Gustavo Scarpa,br,MF,FW,Nott'ham Forest,Premier League,28,1994,2.0,5,2,3,1,1,2,5,40.0,3,4,0,4,0,5,3,Matches
2391,Kevin Schade,de,FW,,Brentford,Premier League,20,2001,8.1,12,8,7,2,3,5,10,50.0,5,7,0,7,4,16,6,Matches
2392,Kevin Schade,de,FW,MF,Freiburg,Bundesliga,20,2001,2.0,6,4,3,2,1,3,5,60.0,2,0,0,0,0,6,2,Matches
2393,András Schäfer,hu,MF,,Union Berlin,Bundesliga,23,1999,9.6,21,9,7,12,2,6,14,42.9,8,12,2,10,4,25,11,Matches
2394,Fabian Schär,ch,DF,,Newcastle Utd,Premier League,30,1991,35.6,47,22,31,13,3,24,39,61.5,15,34,19,15,52,99,139,Matches
2395,Derry Scherhant,de,FW,MF,Hertha BSC,Bundesliga,19,2002,3.2,7,6,3,3,1,4,8,50.0,4,3,0,3,0,7,5,Matches
2396,Patrik Schick,cz,FW,,Leverkusen,Bundesliga,26,1996,10.5,0,0,0,0,0,0,1,0.0,1,4,1,3,1,1,7,Matches
2397,Kingsley Schindler,gh,DF,MF,Köln,Bundesliga,29,1993,12.1,23,12,13,8,2,18,28,64.3,10,14,2,12,15,38,24,Matches
2398,Xaver Schlager,at,MF,,RB Leipzig,Bundesliga,24,1997,16.7,41,24,13,26,2,20,43,46.5,23,19,2,17,17,58,23,Matches
2399,Keven Schlotterbeck,de,DF,,Freiburg,Bundesliga,25,1997,0.2,0,0,0,0,0,0,0,,0,1,1,0,2,2,2,Matches
2400,Keven Schlotterbeck,de,DF,,Bochum,Bundesliga,25,1997,8.2,17,9,12,5,0,9,11,81.8,2,11,5,6,14,31,49,Matches
2401,Nico Schlotterbeck,de,DF,,Dortmund,Bundesliga,22,1999,25.0,59,34,34,24,1,37,53,69.8,16,38,21,17,32,91,71,Matches
2402,Jeffrey Schlupp,gh,MF,FW,Crystal Palace,Premier League,29,1992,28.1,66,46,28,29,9,22,43,51.2,21,39,8,31,23,89,38,Matches
2403,Kasper Schmeichel,dk,GK,,Nice,Ligue 1,35,1986,36.0,1,0,1,0,0,1,4,25.0,3,1,0,1,1,2,11,Matches
2404,Jonathan Schmid,fr,DF,,Freiburg,Bundesliga,32,1990,0.5,1,1,1,0,0,0,0,,0,1,0,1,1,2,1,Matches
2405,Romano Schmid,at,MF,FW,Werder Bremen,Bundesliga,22,2000,16.9,24,15,5,13,6,10,22,45.5,12,21,3,18,7,31,12,Matches
2406,Kenneth Schmidt,de,DF,,Freiburg,Bundesliga,20,2002,2.8,6,3,4,2,0,5,6,83.3,1,4,2,2,0,6,2,Matches
2407,Niklas Schmidt,de,MF,,Werder Bremen,Bundesliga,24,1998,12.1,25,10,12,11,2,13,28,46.4,15,10,0,10,5,30,12,Matches
2408,Benno Schmitz,de,DF,,Köln,Bundesliga,27,1994,26.9,64,42,31,28,5,42,82,51.2,40,34,4,30,26,90,57,Matches
2409,Jerdy Schouten,nl,MF,,Bologna,it Serie A,25,1997,27.9,63,38,28,33,2,27,49,55.1,22,40,17,23,40,103,43,Matches
2410,Perr Schuurs,nl,DF,,Torino,it Serie A,22,1999,25.8,51,25,29,17,5,14,26,53.8,12,28,16,12,28,79,102,Matches
2411,Marvin Schwäbe,de,GK,,Köln,Bundesliga,27,1995,34.0,1,0,1,0,0,1,1,100.0,0,0,0,0,2,3,8,Matches
2412,Alexander Schwolow,de,GK,,Schalke 04,Bundesliga,30,1992,22.6,0,0,0,0,0,0,2,0.0,2,0,0,0,1,1,6,Matches
2413,Demba Seck,sn,MF,FW,Torino,it Serie A,21,2001,5.8,5,2,3,2,0,2,3,66.7,1,3,1,2,1,6,1,Matches
2414,Haris Seferović,ch,FW,,Celta Vigo,La Liga,30,1992,9.9,6,3,1,4,1,3,8,37.5,5,7,1,6,1,7,6,Matches
2415,Telasco Segovia,ve,MF,,Sampdoria,it Serie A,19,2003,0.0,0,0,0,0,0,0,0,,0,0,0,0,0,0,0,Matches
2416,Jacopo Segre,it,DF,,Torino,it Serie A,25,1997,0.2,0,0,0,0,0,0,0,,0,0,0,0,0,0,0,Matches
2417,Paul Seguin,de,MF,,Union Berlin,Bundesliga,27,1995,7.7,17,8,9,4,4,8,18,44.4,10,6,0,6,6,23,7,Matches
2418,Alidu Seidu,gh,DF,,Clermont Foot,Ligue 1,22,2000,27.3,52,31,35,14,3,31,51,60.8,20,28,14,14,52,104,50,Matches
2419,Davie Selke,de,FW,,Hertha BSC,Bundesliga,27,1995,3.1,2,1,1,1,0,0,1,0.0,1,3,1,2,1,3,5,Matches
2420,Davie Selke,de,FW,,Köln,Bundesliga,27,1995,9.7,0,0,0,0,0,0,4,0.0,4,4,1,3,0,0,11,Matches
2421,Matz Sels,be,GK,,Strasbourg,Ligue 1,30,1992,38.0,4,3,4,0,0,4,4,100.0,0,0,0,0,4,8,23,Matches
2422,Nélson Semedo,pt,DF,,Wolves,Premier League,28,1993,29.2,71,42,48,19,4,33,64,51.6,31,42,15,27,29,100,83,Matches
2423,Vivaldo Semedo,pt,FW,MF,Udinese,it Serie A,17,2005,0.4,0,0,0,0,0,0,0,,0,1,0,1,0,0,1,Matches
2424,Antoine Semenyo,gh,FW,MF,Bournemouth,Premier League,22,2000,2.9,1,0,0,0,1,1,6,16.7,5,10,1,9,2,3,4,Matches
2425,Marvin Senaya,tg,DF,,Strasbourg,Ligue 1,21,2001,0.1,0,0,0,0,0,0,1,0.0,1,1,0,1,0,0,1,Matches
2426,Marcos Senesi,ar,DF,,Bournemouth,Premier League,25,1997,27.7,50,35,28,22,0,23,44,52.3,21,38,20,18,43,93,146,Matches
2427,Stefano Sensi,it,MF,,Monza,it Serie A,26,1995,18.0,41,26,25,13,3,18,48,37.5,30,13,3,10,20,61,4,Matches
2428,Jaime Seoane,es,MF,FW,Getafe,La Liga,25,1997,3.6,10,4,3,4,3,2,8,25.0,6,7,3,4,1,11,2,Matches
2429,Luigi Sepe,it,GK,,Salernitana,it Serie A,31,1991,17.0,0,0,0,0,0,0,1,0.0,1,0,0,0,0,0,0,Matches
2430,Suat Serdar,de,MF,,Hertha BSC,Bundesliga,25,1997,22.5,51,23,14,30,7,20,41,48.8,21,48,12,36,29,80,24,Matches
2431,Leonardo Sernicola,it,DF,,Cremonese,it Serie A,25,1997,25.7,45,33,25,13,7,29,43,67.4,14,23,6,17,38,83,55,Matches
2432,Ryan Sessegnon,eng,DF,,Tottenham,Premier League,22,2000,9.0,16,11,9,7,0,6,12,50.0,6,8,1,7,6,22,17,Matches
2433,Stephan El Shaarawy,it,DF,MF,Roma,it Serie A,29,1992,16.9,21,9,8,10,3,6,22,27.3,16,11,1,10,15,36,11,Matches
2434,Eniss Shabani,al,MF,,Mainz 05,Bundesliga,19,2003,0.1,0,0,0,0,0,0,0,,0,0,0,0,0,0,0,Matches
2435,Luke Shaw,eng,DF,,Manchester Utd,Premier League,27,1995,28.4,55,36,31,22,2,32,46,69.6,14,51,17,34,36,91,55,Matches
2436,Jonjo Shelvey,eng,MF,,Newcastle Utd,Premier League,30,1992,0.4,1,0,1,0,0,0,1,0.0,1,1,0,1,0,1,0,Matches
2437,Jonjo Shelvey,eng,MF,,Nott'ham Forest,Premier League,30,1992,6.0,2,1,0,1,1,1,9,11.1,8,7,2,5,5,7,10,Matches
2438,Eldor Shomurodov,uz,FW,,Spezia,it Serie A,27,1995,9.0,5,5,3,1,1,2,11,18.2,9,5,1,4,3,8,4,Matches
2439,Eldor Shomurodov,uz,FW,,Roma,it Serie A,27,1995,1.3,1,0,1,0,0,0,2,0.0,2,1,0,1,1,2,0,Matches
2440,Kaj Sierhuis,nl,FW,MF,Reims,Ligue 1,24,1998,2.4,3,3,1,0,2,0,5,0.0,5,3,1,2,1,4,2,Matches
2441,Vincent Sierro,ch,MF,,Toulouse,Ligue 1,26,1995,7.4,19,11,9,9,1,11,29,37.9,18,12,3,9,4,23,11,Matches
2442,Kiliann Sildillia,fr,DF,MF,Freiburg,Bundesliga,20,2002,22.0,33,20,10,19,4,18,30,60.0,12,24,9,15,21,54,47,Matches
2443,André Silva,pt,FW,,RB Leipzig,Bundesliga,26,1995,19.3,12,6,2,5,5,3,8,37.5,5,11,1,10,3,15,3,Matches
2444,Bernardo Silva,pt,MF,FW,Manchester City,Premier League,27,1994,24.5,44,23,11,25,8,18,45,40.0,27,23,6,17,16,60,6,Matches
2445,Caio Henrique Oliveira Silva,br,DF,,Monaco,Ligue 1,25,1997,32.2,74,51,42,28,4,44,76,57.9,32,28,8,20,26,100,68,Matches
2446,David Silva,es,MF,,Real Sociedad,La Liga,36,1986,21.5,36,21,11,18,7,11,19,57.9,8,17,2,15,15,51,16,Matches
2447,Rui Silva,pt,GK,,Betis,La Liga,28,1994,26.0,4,1,4,0,0,4,4,100.0,0,0,0,0,0,4,12,Matches
2448,Thiago Silva,br,DF,,Chelsea,Premier League,37,1984,26.1,41,27,24,17,0,21,31,67.7,10,38,29,9,34,75,111,Matches
2449,Marco Silvestri,it,GK,,Udinese,it Serie A,31,1991,38.0,2,1,2,0,0,2,3,66.7,1,0,0,0,1,3,15,Matches
2450,Abdallah Sima,sn,FW,,Angers,Ligue 1,21,2001,20.4,22,13,4,15,3,7,19,36.8,12,8,0,8,4,26,19,Matches
2451,Mohamed Simakan,fr,DF,,RB Leipzig,Bundesliga,22,2000,16.2,21,14,12,5,4,14,21,66.7,7,21,4,17,16,37,55,Matches
2452,Giovanni Simeone,ar,FW,,Napoli,it Serie A,27,1995,4.5,12,3,3,5,4,3,8,37.5,5,2,1,1,1,13,4,Matches
2453,Ellis Simms,eng,FW,,Everton,Premier League,21,2001,2.5,0,0,0,0,0,0,0,,0,0,0,0,0,0,1,Matches
2454,Simo,es,DF,,Espanyol,La Liga,17,2005,1.6,3,1,3,0,0,2,3,66.7,1,5,4,1,0,3,3,Matches
2455,Moses Simon,ng,FW,MF,Nantes,Ligue 1,27,1995,26.1,18,9,6,7,5,7,15,46.7,8,14,1,13,11,29,3,Matches
2456,Unai Simón,es,GK,,Athletic Club,La Liga,25,1997,30.5,2,0,2,0,0,1,1,100.0,0,1,0,1,0,2,9,Matches
2457,Lassine Sinayoko,ml,MF,FW,Auxerre,Ligue 1,22,1999,17.4,33,15,14,12,7,21,40,52.5,19,12,0,12,18,51,17,Matches
2458,Wilfried Singo,ci,DF,,Torino,it Serie A,21,2000,22.7,27,17,14,10,3,12,19,63.2,7,15,2,13,12,39,33,Matches
2459,Luis Sinisterra,co,FW,,Leeds United,Premier League,23,1999,9.6,21,14,8,9,4,11,18,61.1,7,11,1,10,8,29,2,Matches
2460,Daley Sinkgraven,nl,DF,MF,Leverkusen,Bundesliga,27,1995,3.8,10,7,7,3,0,7,9,77.8,2,8,4,4,5,15,7,Matches
2461,Tobias Sippel,de,GK,,Gladbach,Bundesliga,34,1988,5.7,0,0,0,0,0,0,0,,0,0,0,0,0,0,1,Matches
2462,Hugo Siquet,be,DF,,Freiburg,Bundesliga,20,2002,0.2,2,2,2,0,0,2,2,100.0,0,1,0,1,0,2,0,Matches
2463,Salvatore Sirigu,it,GK,,Fiorentina,it Serie A,35,1987,1.0,0,0,0,0,0,0,0,,0,0,0,0,0,0,1,Matches
2464,Ibrahima Sissoko,ml,MF,,Strasbourg,Ligue 1,24,1997,14.6,40,22,18,17,5,22,42,52.4,20,20,6,14,10,50,19,Matches
2465,Moussa Sissoko,fr,MF,,Nantes,Ligue 1,32,1989,21.3,26,16,16,7,3,12,18,66.7,6,22,5,17,16,42,17,Matches
2466,Tim Skarke,de,DF,MF,Union Berlin,Bundesliga,25,1996,0.6,1,1,0,0,1,0,0,,0,1,0,1,0,1,0,Matches
2467,Tim Skarke,de,FW,MF,Schalke 04,Bundesliga,25,1996,4.9,13,7,3,8,2,8,11,72.7,3,5,0,5,0,13,4,Matches
2468,Ellyes Skhiri,tn,MF,,Köln,Bundesliga,27,1995,31.7,79,44,29,42,8,26,66,39.4,40,52,12,40,56,135,48,Matches
2469,Oliver Skipp,eng,MF,,Tottenham,Premier League,21,2000,16.6,34,17,18,15,1,16,33,48.5,17,17,8,9,17,51,19,Matches
2470,Leo Skiri Østigård,no,DF,,Napoli,it Serie A,22,1999,4.7,4,1,3,1,0,1,1,100.0,0,3,3,0,6,10,18,Matches
2471,Łukasz Skorupski,pl,GK,,Bologna,it Serie A,31,1991,37.0,2,1,2,0,0,1,2,50.0,1,0,0,0,0,2,19,Matches
2472,Robert Skov,dk,DF,,Hoffenheim,Bundesliga,26,1996,15.0,22,11,14,7,1,10,26,38.5,16,22,8,14,8,30,20,Matches
2473,Milan Škriniar,sk,DF,,Inter,it Serie A,27,1995,19.7,29,18,14,11,4,18,32,56.3,14,18,13,5,13,42,46,Matches
2474,Naatan Skyttä,fi,MF,,Toulouse,Ligue 1,20,2002,0.3,0,0,0,0,0,0,0,,0,0,0,0,1,1,0,Matches
2475,Islam Slimani,dz,FW,,Brest,Ligue 1,34,1988,11.0,5,3,2,2,1,0,3,0.0,3,2,0,2,1,6,11,Matches
2476,Chris Smalling,eng,DF,,Roma,it Serie A,32,1989,31.2,26,15,16,10,0,13,21,61.9,8,51,36,15,43,69,123,Matches
2477,Adam Smith,eng,DF,,Bournemouth,Premier League,31,1991,32.7,49,29,27,19,3,29,60,48.3,31,30,13,17,25,74,81,Matches
2478,Emile Smith Rowe,eng,MF,FW,Arsenal,Premier League,22,2000,1.9,1,1,1,0,0,1,3,33.3,2,1,0,1,0,1,2,Matches
2479,Hrvoje Smolčić,hr,DF,,Eint Frankfurt,Bundesliga,21,2000,5.2,8,7,6,2,0,5,10,50.0,5,11,4,7,6,14,38,Matches
2480,Cédric Soares,pt,DF,,Arsenal,Premier League,30,1991,0.3,0,0,0,0,0,0,1,0.0,1,1,0,1,0,0,1,Matches
2481,Cédric Soares,pt,DF,,Fulham,Premier League,30,1991,2.2,8,5,4,3,1,3,3,100.0,0,3,1,2,1,9,5,Matches
2482,Danilo Soares,br,DF,,Bochum,Bundesliga,30,1991,19.6,72,46,42,23,7,43,72,59.7,29,29,6,23,30,102,56,Matches
2483,Eduard Sobol,ua,DF,,Strasbourg,Ligue 1,27,1995,9.7,19,10,10,6,3,9,13,69.2,4,10,1,9,8,27,19,Matches
2484,Rubén Sobrino,es,MF,FW,Cádiz,La Liga,30,1992,27.4,55,37,29,17,9,23,56,41.1,33,33,3,30,24,79,20,Matches
2485,Alex Sola,es,DF,,Real Sociedad,La Liga,23,1999,3.9,18,9,14,3,1,7,10,70.0,3,7,2,5,7,25,10,Matches
2486,Dominic Solanke,eng,FW,MF,Bournemouth,Premier League,24,1997,31.8,15,9,8,3,4,5,22,22.7,17,26,7,19,6,21,46,Matches
2487,Augusto Solari,ar,MF,,Celta Vigo,La Liga,30,1992,2.9,10,6,6,3,1,3,11,27.3,8,5,0,5,4,14,3,Matches
2488,Ola Solbakken,no,MF,FW,Roma,it Serie A,23,1998,5.6,2,2,1,1,0,2,7,28.6,5,2,0,2,2,4,8,Matches
2489,Nikola Soldo,hr,DF,,Köln,Bundesliga,21,2001,6.6,15,9,8,7,0,7,11,63.6,4,7,6,1,7,22,28,Matches
2490,Carlos Soler,es,MF,,Valencia,La Liga,25,1997,2.7,2,0,0,1,1,2,3,66.7,1,1,0,1,0,2,2,Matches
2491,Carlos Soler,es,MF,,Paris S-G,Ligue 1,25,1997,13.2,20,12,6,10,4,10,19,52.6,9,12,4,8,4,24,6,Matches
2492,François-Joseph Sollacaro,fr,GK,,Ajaccio,Ligue 1,28,1994,6.0,0,0,0,0,0,0,0,,0,0,0,0,0,0,2,Matches
2493,Manor Solomon,il,FW,,Fulham,Premier League,23,1999,6.4,20,12,12,6,2,9,16,56.3,7,8,0,8,5,25,3,Matches
2494,Yann Sommer,ch,GK,,Gladbach,Bundesliga,33,1988,10.0,1,0,1,0,0,1,1,100.0,0,0,0,0,0,1,8,Matches
2495,Yann Sommer,ch,GK,,Bayern Munich,Bundesliga,33,1988,19.0,0,0,0,0,0,0,0,,0,0,0,0,1,1,5,Matches
2496,Brandon Soppy,fr,DF,,Udinese,it Serie A,20,2002,1.0,1,1,0,1,0,0,0,,0,4,0,4,1,2,1,Matches
2497,Brandon Soppy,fr,DF,,Atalanta,it Serie A,20,2002,7.1,8,5,4,4,0,3,9,33.3,6,10,0,10,3,11,7,Matches
2498,David Soria,es,GK,,Getafe,La Liga,29,1993,38.0,0,0,0,0,0,0,1,0.0,1,0,0,0,1,1,20,Matches
2499,Roberto Soriano,it,FW,MF,Bologna,it Serie A,31,1991,14.7,31,16,9,16,6,13,25,52.0,12,23,2,21,6,37,14,Matches
2500,Borna Sosa,hr,DF,,Stuttgart,Bundesliga,24,1998,21.7,27,21,18,8,1,21,32,65.6,11,20,5,15,19,46,37,Matches
2501,Joaquin Sosa,uy,DF,,Bologna,it Serie A,20,2002,7.6,6,2,5,1,0,4,18,22.2,14,5,3,2,6,12,31,Matches
2502,Hugo Sotelo,es,MF,,Celta Vigo,La Liga,18,2003,0.2,0,0,0,0,0,0,0,,0,0,0,0,0,0,0,Matches
2503,Florian Sotoca,fr,MF,FW,Lens,Ligue 1,31,1990,33.9,39,19,11,17,11,15,40,37.5,25,41,2,39,29,68,51,Matches
2504,Riccardo Sottil,it,FW,,Fiorentina,it Serie A,23,1999,9.3,4,3,2,0,2,2,5,40.0,3,2,0,2,0,4,0,Matches
2505,Tomáš Souček,cz,MF,,West Ham,Premier League,27,1995,31.3,77,37,41,29,7,28,58,48.3,30,42,17,25,53,130,71,Matches
2506,Matìas Soulé,ar,MF,FW,Juventus,it Serie A,19,2003,4.7,7,4,3,2,2,5,7,71.4,2,7,1,6,3,10,3,Matches
2507,Moussa Soumano,fr,FW,,Ajaccio,Ligue 1,17,2005,5.5,2,2,0,1,1,0,6,0.0,6,2,0,2,0,2,0,Matches
2508,Adama Soumaoro,fr,DF,,Bologna,it Serie A,30,1992,20.7,25,17,11,12,2,5,7,71.4,2,18,13,5,15,40,75,Matches
2509,Boubakary Soumaré,fr,MF,,Leicester City,Premier League,23,1999,18.1,57,34,29,26,2,23,44,52.3,21,15,4,11,33,90,27,Matches
2510,Arnaud Souquet,fr,DF,FW,Montpellier,Ligue 1,30,1992,4.0,22,16,13,7,2,11,14,78.6,3,8,3,5,4,26,4,Matches
2511,Dyego Sousa,pt,FW,,Almería,La Liga,32,1989,5.9,10,6,5,4,1,4,5,80.0,1,4,2,2,1,11,14,Matches
2512,Harry Souttar,au,DF,,Leicester City,Premier League,23,1998,11.0,15,9,10,5,0,7,18,38.9,11,16,12,4,12,27,45,Matches
2513,Vinicius Souza,br,MF,,Espanyol,La Liga,23,1999,27.0,99,66,41,45,13,33,59,55.9,26,31,14,17,48,147,50,Matches
2514,Djibril Sow,ch,MF,,Eint Frankfurt,Bundesliga,25,1997,29.4,41,25,13,25,3,22,44,50.0,22,22,4,18,28,69,23,Matches
2515,Çağlar Söyüncü,tr,DF,,Leicester City,Premier League,26,1996,5.9,14,9,10,4,0,7,10,70.0,3,9,8,1,7,21,30,Matches
2516,Kevin Spadanuda,ch,MF,FW,Ajaccio,Ligue 1,25,1997,11.8,29,18,15,9,5,12,33,36.4,21,18,0,18,11,40,5,Matches
2517,Djed Spence,eng,FW,DF,Tottenham,Premier League,21,2000,0.1,0,0,0,0,0,0,0,,0,0,0,0,0,0,0,Matches
2518,Djed Spence,eng,DF,,Rennes,Ligue 1,21,2000,6.4,14,6,8,2,4,11,18,61.1,7,10,3,7,4,18,15,Matches
2519,Stijn Spierings,nl,MF,,Toulouse,Ligue 1,26,1996,34.7,95,67,37,49,9,43,101,42.6,58,49,11,38,53,148,44,Matches
2520,Leonardo Spinazzola,it,DF,,Roma,it Serie A,29,1993,18.4,15,8,7,6,2,8,23,34.8,15,13,3,10,9,24,25,Matches
2521,Marco Sportiello,it,GK,,Atalanta,it Serie A,30,1992,14.9,1,0,1,0,0,1,3,33.3,2,0,0,0,0,1,2,Matches
2522,Jack Stacey,eng,DF,,Bournemouth,Premier League,26,1996,3.3,5,4,3,1,1,2,5,40.0,3,3,1,2,5,10,15,Matches
2523,Anton Stach,de,MF,,Mainz 05,Bundesliga,23,1998,23.0,27,21,10,15,2,16,38,42.1,22,28,2,26,41,68,25,Matches
2524,Kostas Stafylidis,gr,DF,MF,Bochum,Bundesliga,28,1993,11.6,27,16,13,8,6,10,24,41.7,14,21,8,13,20,47,31,Matches
2525,Jens Stage,dk,MF,,Werder Bremen,Bundesliga,25,1996,20.6,34,17,15,18,1,10,37,27.0,27,34,11,23,16,50,37,Matches
2526,Veit Stange,de,MF,,Hertha BSC,Bundesliga,18,2004,0.1,1,1,1,0,0,1,1,100.0,0,0,0,0,0,1,0,Matches
2527,Josip Stanišić,hr,DF,,Bayern Munich,Bundesliga,22,2000,6.4,19,11,14,2,3,12,17,70.6,5,9,1,8,7,26,11,Matches
2528,Junior Stanislas,eng,MF,,Bournemouth,Premier League,32,1989,0.7,0,0,0,0,0,0,0,,0,2,1,1,0,0,0,Matches
2529,Jay Stansfield,eng,FW,,Fulham,Premier League,19,2002,1.0,0,0,0,0,0,0,2,0.0,2,4,1,3,1,1,1,Matches
2530,Niklas Stark,de,DF,,Werder Bremen,Bundesliga,27,1995,23.1,56,36,29,24,3,27,42,64.3,15,24,13,11,37,93,110,Matches
2531,Jason Steele,eng,GK,,Brighton,Premier League,31,1990,15.0,0,0,0,0,0,0,1,0.0,1,0,0,0,0,0,6,Matches
2532,Calvin Stengs,nl,FW,,Nice,Ligue 1,23,1998,2.4,2,2,1,0,1,1,2,50.0,1,0,0,0,0,2,0,Matches
2533,Pascal Stenzel,de,DF,,Stuttgart,Bundesliga,26,1996,3.7,12,8,8,4,0,5,9,55.6,4,9,2,7,5,17,6,Matches
2534,Jack Stephens,eng,DF,,Southampton,Premier League,28,1994,0.5,2,2,2,0,0,1,1,100.0,0,1,1,0,1,3,2,Matches
2535,Jack Stephens,eng,DF,,Bournemouth,Premier League,28,1994,13.0,15,11,10,4,1,6,10,60.0,4,23,16,7,16,31,53,Matches
2536,Raheem Sterling,eng,FW,MF,Chelsea,Premier League,27,1994,21.0,18,10,5,4,9,8,14,57.1,6,17,0,17,2,20,5,Matches
2537,Angelo Stiller,de,MF,,Hoffenheim,Bundesliga,21,2001,7.8,26,12,9,13,4,8,12,66.7,4,12,2,10,10,36,14,Matches
2538,Lars Stindl,de,FW,MF,Gladbach,Bundesliga,33,1988,19.3,24,14,4,17,3,10,28,35.7,18,24,5,19,11,35,19,Matches
2539,Kevin Stöger,at,MF,,Bochum,Bundesliga,28,1993,28.9,84,45,38,32,14,31,94,33.0,63,27,4,23,26,110,21,Matches
2540,Petar Stojanović,si,DF,,Empoli,it Serie A,26,1995,17.0,42,22,28,10,4,26,43,60.5,17,17,5,12,11,53,55,Matches
2541,John Stones,eng,DF,MF,Manchester City,Premier League,28,1994,20.5,23,13,11,8,4,7,10,70.0,3,17,10,7,9,32,40,Matches
2542,Jørgen Strand Larsen,no,FW,,Celta Vigo,La Liga,22,2000,18.9,15,7,3,5,7,7,30,23.3,23,14,5,9,3,18,24,Matches
2543,Tony Strata,ro,MF,DF,Ajaccio,Ligue 1,17,2004,1.5,4,3,4,0,0,4,5,80.0,1,2,0,2,1,5,7,Matches
2544,Gabriel Strefezza,br,FW,MF,Lecce,it Serie A,25,1997,27.1,50,24,18,20,12,27,53,50.9,26,36,3,33,16,66,15,Matches
2545,Dávid Strelec,sk,FW,,Spezia,it Serie A,21,2001,1.9,2,2,0,1,1,2,2,100.0,0,0,0,0,0,2,0,Matches
2546,Pascal Struijk,nl,DF,,Leeds United,Premier League,22,1999,24.4,84,57,43,31,10,49,75,65.3,26,32,12,20,32,116,70,Matches
2547,Cristhian Stuani,uy,FW,,Girona,La Liga,35,1986,12.1,13,6,2,7,4,5,14,35.7,9,10,0,10,2,15,5,Matches
2548,Damián Suárez,uy,DF,MF,Getafe,La Liga,34,1988,21.6,49,33,23,19,7,26,48,54.2,22,40,0,40,15,64,36,Matches
2549,Denis Suárez,es,MF,FW,Espanyol,La Liga,28,1994,10.5,26,20,12,12,2,13,45,28.9,32,11,1,10,5,31,4,Matches
2550,Mario Suárez,es,MF,DF,Rayo Vallecano,La Liga,35,1987,0.1,0,0,0,0,0,0,0,,0,1,0,1,0,0,0,Matches
2551,Gabriel Suazo,cl,DF,,Toulouse,Ligue 1,24,1997,14.0,38,22,20,15,3,29,63,46.0,34,21,5,16,22,60,24,Matches
2552,Isaac Success,ng,FW,,Udinese,it Serie A,26,1996,20.2,8,4,2,5,1,3,8,37.5,5,13,2,11,4,12,18,Matches
2553,Niklas Süle,de,DF,,Dortmund,Bundesliga,26,1995,23.5,25,19,18,3,4,14,23,60.9,9,28,19,9,17,42,53,Matches
2554,Ibrahim Sulemana,gh,MF,,Hellas Verona,it Serie A,19,2003,7.2,19,13,10,7,2,6,12,50.0,6,8,2,6,14,33,15,Matches
2555,Kamaldeen Sulemana,gh,FW,MF,Southampton,Premier League,20,2002,10.7,15,9,4,7,4,4,14,28.6,10,16,0,16,6,21,6,Matches
2556,Kamaldeen Sulemana,gh,FW,MF,Rennes,Ligue 1,20,2002,3.6,6,3,1,4,1,1,5,20.0,4,2,0,2,4,10,2,Matches
2557,Crysencio Summerville,nl,FW,,Leeds United,Premier League,20,2001,15.8,30,20,14,14,2,11,23,47.8,12,20,2,18,13,43,11,Matches
2558,Ivan Šunjić,ba,MF,,Hertha BSC,Bundesliga,25,1996,11.0,38,20,16,21,1,16,24,66.7,8,17,5,12,13,51,19,Matches
2559,Sam Surridge,eng,FW,,Nott'ham Forest,Premier League,24,1998,3.6,5,0,1,3,1,1,4,25.0,3,5,2,3,0,5,7,Matches
2560,Suso,es,MF,FW,Sevilla,La Liga,28,1993,11.8,16,10,5,7,4,10,22,45.5,12,7,1,6,2,18,3,Matches
2561,Yuito Suzuki,jp,FW,MF,Strasbourg,Ligue 1,20,2001,0.4,0,0,0,0,0,0,0,,0,3,0,3,0,0,0,Matches
2562,Mattias Svanberg,se,MF,FW,Wolfsburg,Bundesliga,23,1999,20.4,25,16,8,16,1,10,30,33.3,20,27,5,22,21,46,25,Matches
2563,Mile Svilar,rs,GK,,Roma,it Serie A,22,1999,3.0,0,0,0,0,0,0,0,,0,0,0,0,0,0,1,Matches
2564,Williot Swedberg,se,MF,,Celta Vigo,La Liga,18,2004,0.6,3,1,1,0,2,0,0,,0,2,0,2,0,3,1,Matches
2565,Issiaga Sylla,gn,DF,,Montpellier,Ligue 1,28,1994,14.5,28,16,19,8,1,15,31,48.4,16,19,3,16,32,60,35,Matches
2566,Issiaga Sylla,gn,DF,,Toulouse,Ligue 1,28,1994,15.2,28,15,14,9,5,15,34,44.1,19,15,5,10,38,66,38,Matches
2567,Wojciech Szczęsny,pl,GK,,Juventus,it Serie A,32,1990,27.5,1,0,1,0,0,0,1,0.0,1,0,0,0,0,1,7,Matches
2568,Dominik Szoboszlai,hu,MF,FW,RB Leipzig,Bundesliga,21,2000,27.2,45,28,12,20,13,17,42,40.5,25,43,2,41,17,62,27,Matches
2569,Alexander Sørloth,no,FW,,Real Sociedad,La Liga,26,1995,26.5,18,9,3,6,9,7,14,50.0,7,15,1,14,2,20,26,Matches
2570,Alexander Sørloth,no,FW,,RB Leipzig,Bundesliga,26,1995,0.1,0,0,0,0,0,0,0,,0,0,0,0,0,0,0,Matches
2571,Nicolás Tagliafico,ar,DF,,Lyon,Ligue 1,29,1992,33.2,91,53,36,41,14,50,78,64.1,28,45,11,34,57,148,47,Matches
2572,Jonathan Tah,de,DF,,Leverkusen,Bundesliga,26,1996,27.6,25,12,21,4,0,12,18,66.7,6,30,18,12,40,65,118,Matches
2573,Benjamin Tahirovic,ba,MF,,Roma,it Serie A,19,2003,3.9,8,5,5,2,1,4,12,33.3,8,9,4,5,3,11,3,Matches
2574,Waniss Taibi,fr,MF,,Angers,Ligue 1,20,2002,2.1,9,5,4,4,1,2,4,50.0,2,1,0,1,2,11,2,Matches
2575,Flavien Tait,fr,MF,,Rennes,Ligue 1,29,1993,18.7,30,15,8,17,5,19,42,45.2,23,16,4,12,20,50,12,Matches
2576,Montassar Talbi,tn,DF,,Lorient,Ligue 1,24,1998,38.0,53,25,40,13,0,22,35,62.9,13,55,34,21,40,93,190,Matches
2577,Thibault Tamas,fr,DF,,Montpellier,Ligue 1,21,2001,0.1,0,0,0,0,0,0,0,,0,0,0,0,1,1,0,Matches
2578,Adrien Tameze,cm,MF,,Hellas Verona,it Serie A,28,1994,33.7,51,30,21,26,4,28,63,44.4,35,51,14,37,37,88,55,Matches
2579,Japhet Tanganga,eng,DF,,Tottenham,Premier League,23,1999,1.6,3,2,3,0,0,1,5,20.0,4,1,0,1,2,5,8,Matches
2580,Renato Tapia,pe,MF,DF,Celta Vigo,La Liga,27,1995,16.1,47,25,21,21,5,18,37,48.6,19,29,11,18,19,66,37,Matches
2581,Edmond Tapsoba,bf,DF,,Leverkusen,Bundesliga,23,1999,31.9,51,30,35,12,4,30,42,71.4,12,40,17,23,36,87,109,Matches
2582,Florian Tardieu,fr,MF,,Troyes,Ligue 1,30,1992,11.2,31,20,19,12,0,12,31,38.7,19,19,4,15,23,54,15,Matches
2583,Matt Targett,eng,DF,,Newcastle Utd,Premier League,26,1995,6.8,13,10,8,3,2,9,24,37.5,15,8,3,5,9,22,16,Matches
2584,James Tarkowski,eng,DF,,Everton,Premier League,29,1992,38.0,51,26,36,13,2,20,39,51.3,19,99,78,21,51,102,201,Matches
2585,Ciprian Tătărușanu,ro,GK,,Milan,it Serie A,36,1986,16.0,0,0,0,0,0,0,0,,0,0,0,0,1,1,2,Matches
2586,Niklas Tauer,de,DF,MF,Mainz 05,Bundesliga,21,2001,1.0,2,1,2,0,0,1,3,33.3,2,2,1,1,2,4,4,Matches
2587,Nuno Tavares,pt,DF,MF,Marseille,Ligue 1,22,2000,26.1,56,30,19,24,13,28,56,50.0,28,32,4,28,15,71,25,Matches
2588,Marcus Tavernier,eng,MF,FW,Bournemouth,Premier League,23,1999,19.4,33,22,19,11,3,11,33,33.3,22,25,4,21,9,42,23,Matches
2589,Enzo Tchato,cm,DF,,Montpellier,Ligue 1,19,2002,12.2,26,17,14,11,1,13,22,59.1,9,17,2,15,7,33,33,Matches
2590,Aurélien Tchouaméni,fr,MF,,Real Madrid,La Liga,22,2000,23.5,64,40,23,36,5,23,38,60.5,15,20,6,14,49,113,50,Matches
2591,Mathys Tel,fr,FW,,Bayern Munich,Bundesliga,17,2005,4.6,2,2,0,1,1,1,1,100.0,0,5,1,4,0,2,2,Matches
2592,Semir Telalovic,de,MF,FW,Gladbach,Bundesliga,22,1999,0.1,0,0,0,0,0,0,0,,0,0,0,0,0,0,0,Matches
2593,Alex Telles,br,DF,,Sevilla,La Liga,29,1992,15.9,21,13,15,6,0,13,25,52.0,12,17,5,12,20,41,38,Matches
2594,Marc-André ter Stegen,de,GK,,Barcelona,La Liga,30,1992,37.2,0,0,0,0,0,0,0,,0,0,0,0,1,1,7,Matches
2595,Simon Terodde,de,FW,,Schalke 04,Bundesliga,34,1988,20.3,15,8,4,7,4,3,14,21.4,11,6,2,4,6,21,9,Matches
2596,Filippo Terracciano,it,DF,MF,Hellas Verona,it Serie A,19,2003,9.1,20,13,11,7,2,15,20,75.0,5,7,4,3,10,30,14,Matches
2597,Pietro Terracciano,it,GK,,Fiorentina,it Serie A,32,1990,29.0,2,1,2,0,0,2,3,66.7,1,0,0,0,1,3,14,Matches
2598,Ramón Terrats,es,MF,,Villarreal,La Liga,21,2000,9.1,15,10,3,8,4,9,17,52.9,8,11,4,7,8,23,6,Matches
2599,Ramón Terrats,es,MF,,Girona,La Liga,21,2000,2.4,4,2,1,3,0,2,6,33.3,4,6,2,4,3,7,3,Matches
2600,Martin Terrier,fr,FW,MF,Rennes,Ligue 1,25,1997,14.7,25,11,7,9,9,13,24,54.2,11,15,2,13,14,39,6,Matches
2601,Aleksa Terzić,rs,DF,,Fiorentina,it Serie A,22,1999,10.4,16,9,9,4,3,11,21,52.4,10,13,4,9,5,21,16,Matches
2602,Tetê,br,FW,,Leicester City,Premier League,22,2000,8.2,14,8,5,7,2,6,21,28.6,15,9,0,9,2,16,3,Matches
2603,Tetê,br,FW,MF,Lyon,Ligue 1,22,2000,12.3,21,10,8,5,8,10,19,52.6,9,9,0,9,13,34,2,Matches
2604,Kenny Tete,nl,DF,,Fulham,Premier League,26,1995,28.5,83,46,41,29,13,38,51,74.5,13,48,17,31,52,135,81,Matches
2605,Florian Thauvin,fr,FW,MF,Udinese,it Serie A,29,1993,6.1,2,1,0,2,0,2,13,15.4,11,5,0,5,2,4,2,Matches
2606,Arthur Theate,be,DF,,Rennes,Ligue 1,22,2000,34.7,29,19,17,8,4,17,30,56.7,13,26,14,12,30,59,114,Matches
2607,Malick Thiaw,de,DF,,Milan,it Serie A,20,2001,15.1,31,26,22,9,0,11,20,55.0,9,11,5,6,12,43,65,Matches
2608,Malick Thiaw,de,DF,,Schalke 04,Bundesliga,20,2001,3.0,3,1,2,1,0,1,2,50.0,1,4,3,1,9,12,24,Matches
2609,Jan Thielmann,de,FW,,Köln,Bundesliga,20,2002,9.7,9,8,3,4,2,2,11,18.2,9,16,3,13,9,18,7,Matches
2610,Sada Thioub,sn,DF,FW,Angers,Ligue 1,27,1995,11.8,19,10,9,8,2,8,17,47.1,9,13,0,13,7,26,5,Matches
2611,Luke Thomas,eng,DF,,Leicester City,Premier League,21,2001,11.9,23,19,15,5,3,15,32,46.9,17,20,4,16,27,50,35,Matches
2612,Adrien Thomasson,fr,MF,,Strasbourg,Ligue 1,28,1993,10.4,19,9,8,6,5,9,30,30.0,21,18,0,18,3,22,2,Matches
2613,Adrien Thomasson,fr,MF,FW,Lens,Ligue 1,28,1993,14.2,24,17,8,11,5,12,45,26.7,33,25,2,23,4,28,17,Matches
2614,Morten Thorsby,no,MF,,Union Berlin,Bundesliga,26,1996,9.3,22,10,9,11,2,13,21,61.9,8,11,5,6,3,25,20,Matches
2615,Kristian Thorstvedt,no,MF,,Sassuolo,it Serie A,23,1999,12.6,16,7,4,9,3,6,17,35.3,11,19,5,14,14,30,13,Matches
2616,Khéphren Thuram,fr,MF,,Nice,Ligue 1,21,2001,28.3,51,25,22,23,6,19,43,44.2,24,33,13,20,38,89,34,Matches
2617,Marcus Thuram,fr,FW,,Gladbach,Bundesliga,24,1997,27.9,14,7,3,6,5,6,13,46.2,7,20,3,17,6,20,22,Matches
2618,Alexis Tibidi,fr,FW,MF,Troyes,Ligue 1,18,2003,0.8,1,1,1,0,0,0,0,,0,0,0,0,0,1,0,Matches
2619,Youri Tielemans,be,MF,,Leicester City,Premier League,25,1997,26.0,66,39,27,30,9,23,62,37.1,39,35,8,27,28,94,24,Matches
2620,Kieran Tierney,sct,DF,,Arsenal,Premier League,25,1997,8.8,20,11,9,9,2,12,16,75.0,4,8,2,6,11,31,25,Matches
2621,Steffen Tigges,de,FW,,Köln,Bundesliga,24,1998,17.7,12,7,1,8,3,4,14,28.6,10,13,2,11,8,20,17,Matches
2622,Jean-Clair Todibo,fr,DF,,Nice,Ligue 1,22,1999,31.9,76,48,54,19,3,41,56,73.2,15,41,19,22,41,117,110,Matches
2623,Harry Toffolo,eng,DF,,Nott'ham Forest,Premier League,26,1995,10.4,17,8,10,4,3,10,14,71.4,4,16,8,8,10,27,33,Matches
2624,Umut Tohumcu,de,MF,DF,Hoffenheim,Bundesliga,17,2004,3.0,10,5,4,5,1,3,9,33.3,6,4,0,4,2,12,8,Matches
2625,Karl Toko Ekambi,cm,FW,MF,Rennes,Ligue 1,29,1992,10.8,3,1,1,1,1,3,9,33.3,6,5,0,5,9,12,3,Matches
2626,Karl Toko Ekambi,cm,FW,MF,Lyon,Ligue 1,29,1992,15.0,9,9,2,4,3,4,15,26.7,11,12,2,10,9,18,6,Matches
2627,Corentin Tolisso,fr,MF,,Lyon,Ligue 1,27,1994,22.6,44,27,16,23,5,25,66,37.9,41,25,5,20,24,68,23,Matches
2628,Jeremy Toljan,de,DF,,Sassuolo,it Serie A,27,1994,29.7,36,23,17,14,5,22,33,66.7,11,31,14,17,18,54,60,Matches
2629,Rafael Tolói,it,DF,,Atalanta,it Serie A,31,1990,30.9,69,44,37,32,0,35,64,54.7,29,42,18,24,57,126,88,Matches
2630,Raúl de Tomás,es,FW,,Rayo Vallecano,La Liga,27,1994,8.9,3,2,0,1,2,2,6,33.3,4,4,0,4,0,3,6,Matches
2631,Tiago Tomás,pt,FW,MF,Stuttgart,Bundesliga,20,2002,14.3,10,4,2,4,4,8,13,61.5,5,9,2,7,1,11,5,Matches
2632,Takehiro Tomiyasu,jp,DF,,Arsenal,Premier League,23,1998,7.4,27,18,12,10,5,13,18,72.2,5,7,0,7,14,41,15,Matches
2633,James Tomkins,eng,DF,,Crystal Palace,Premier League,33,1989,3.8,4,2,2,1,1,1,3,33.3,2,3,2,1,5,9,19,Matches
2634,Fikayo Tomori,eng,DF,,Milan,it Serie A,24,1997,30.7,70,34,44,25,1,22,34,64.7,12,46,25,21,29,99,88,Matches
2635,Sandro Tonali,it,MF,,Milan,it Serie A,22,2000,30.1,64,41,35,24,5,27,44,61.4,17,34,9,25,25,89,26,Matches
2636,Lorenzo Tonelli,it,DF,,Empoli,it Serie A,32,1990,0.2,0,0,0,0,0,0,1,0.0,1,0,0,0,0,0,0,Matches
2637,Ivan Toney,eng,FW,,Brentford,Premier League,26,1996,32.8,23,13,4,9,10,7,23,30.4,16,24,9,15,14,37,36,Matches
2638,Pablo Torre,es,FW,MF,Barcelona,La Liga,19,2003,1.6,2,1,0,1,1,2,4,50.0,2,1,0,1,2,4,1,Matches
2639,David Torres,es,DF,,Valladolid,La Liga,19,2003,4.3,1,1,0,1,0,1,1,100.0,0,4,2,2,3,4,8,Matches
2640,Ferrán Torres,es,FW,MF,Barcelona,La Liga,22,2000,15.5,13,7,4,5,4,5,20,25.0,15,11,2,9,3,16,5,Matches
2641,Óliver Torres,es,MF,FW,Sevilla,La Liga,27,1994,23.7,39,23,12,13,14,18,59,30.5,41,26,5,21,10,49,10,Matches
2642,Pau Torres,es,DF,,Villarreal,La Liga,25,1997,33.9,43,25,25,13,5,23,36,63.9,13,36,27,9,13,56,146,Matches
2643,Roberto Torres,es,FW,MF,Osasuna,La Liga,33,1989,0.1,0,0,0,0,0,0,0,,0,0,0,0,0,0,0,Matches
2644,Lucas Torró,es,MF,,Osasuna,La Liga,28,1994,27.5,48,32,28,15,5,18,42,42.9,24,24,3,21,42,90,64,Matches
2645,Nabil Touaizi,ma,MF,,Espanyol,La Liga,21,2001,0.0,0,0,0,0,0,0,0,,0,0,0,0,0,0,0,Matches
2646,Almamy Touré,ml,DF,,Eint Frankfurt,Bundesliga,26,1996,4.4,13,7,7,5,1,5,9,55.6,4,9,2,7,10,23,8,Matches
2647,Birama Touré,ml,MF,,Auxerre,Ligue 1,30,1992,37.8,80,47,35,35,10,34,93,36.6,59,54,9,45,67,147,49,Matches
2648,Mohamed Toure,au,FW,MF,Reims,Ligue 1,18,2004,0.3,0,0,0,0,0,0,0,,0,0,0,0,0,0,0,Matches
2649,Souleymane Touré,fr,DF,,Marseille,Ligue 1,19,2003,0.8,2,1,1,1,0,1,2,50.0,1,1,0,1,0,2,5,Matches
2650,Souleymane Touré,fr,DF,,Auxerre,Ligue 1,19,2003,17.6,29,13,19,9,1,16,20,80.0,4,32,12,20,26,55,56,Matches
2651,Lucas Tousart,fr,MF,,Hertha BSC,Bundesliga,25,1997,32.7,73,38,35,28,10,27,60,45.0,33,42,6,36,48,121,75,Matches
2652,Yoann Touzghar,tn,FW,,Ajaccio,Ligue 1,35,1986,5.0,3,2,0,2,1,0,1,0.0,1,0,0,0,0,3,1,Matches
2653,Adama Traoré,es,FW,MF,Wolves,Premier League,26,1996,16.6,14,7,7,4,3,4,9,44.4,5,8,1,7,3,17,17,Matches
2654,Bertrand Traoré,bf,FW,MF,Aston Villa,Premier League,26,1995,2.6,1,1,1,0,0,1,4,25.0,3,5,0,5,2,3,0,Matches
2655,Boubacar Traoré,ml,MF,,Wolves,Premier League,20,2001,4.6,12,5,4,5,3,3,7,42.9,4,4,2,2,7,19,1,Matches
2656,Charles Traore,ml,DF,,Nantes,Ligue 1,30,1992,5.4,8,5,5,2,1,5,7,71.4,2,9,2,7,10,18,12,Matches
2657,Hamari Traoré,ml,DF,,Rennes,Ligue 1,30,1992,28.1,48,32,26,15,7,28,52,53.8,24,33,7,26,38,86,64,Matches
2658,Kevin Trapp,de,GK,,Eint Frankfurt,Bundesliga,32,1990,33.0,1,1,1,0,0,0,2,0.0,2,2,0,2,0,1,10,Matches
2659,Mark Travers,ie,GK,,Bournemouth,Premier League,23,1999,11.5,0,0,0,0,0,0,0,,0,1,0,1,0,0,6,Matches
2660,Óscar Trejo,ar,MF,FW,Rayo Vallecano,La Liga,34,1988,23.8,48,32,12,23,13,9,44,20.5,35,31,3,28,8,56,8,Matches
2661,Manu Trigueros,es,MF,,Villarreal,La Liga,30,1991,9.2,20,14,9,5,6,9,22,40.9,13,9,2,7,5,25,4,Matches
2662,Christopher Trimmel,at,DF,,Union Berlin,Bundesliga,35,1987,20.1,31,16,16,12,3,20,31,64.5,11,14,1,13,25,56,48,Matches
2663,Théo Trinker,fr,MF,,Nice,Ligue 1,21,2001,0.0,0,0,0,0,0,0,0,,0,0,0,0,0,0,0,Matches
2664,Kieran Trippier,eng,DF,,Newcastle Utd,Premier League,31,1990,37.1,71,49,36,27,8,46,90,51.1,44,45,15,30,43,114,84,Matches
2665,William Troost-Ekong,ng,DF,,Salernitana,it Serie A,28,1993,4.9,11,3,7,4,0,6,7,85.7,1,7,4,3,6,17,10,Matches
2666,Leandro Trossard,be,FW,,Arsenal,Premier League,27,1994,10.3,12,7,4,2,6,6,18,33.3,12,18,0,18,6,18,3,Matches
2667,Leandro Trossard,be,FW,MF,Brighton,Premier League,27,1994,14.6,10,6,7,1,2,1,8,12.5,7,17,0,17,6,16,1,Matches
2668,Adrien Truffert,fr,DF,,Rennes,Ligue 1,20,2001,21.7,62,32,36,17,9,31,46,67.4,15,32,8,24,22,84,55,Matches
2669,Frank Tsadjout,it,FW,,Cremonese,it Serie A,23,1999,11.7,10,8,3,6,1,3,9,33.3,6,7,1,6,8,18,9,Matches
2670,Kostas Tsimikas,gr,DF,,Liverpool,Premier League,26,1996,8.6,14,9,10,2,2,10,16,62.5,6,8,1,7,12,26,15,Matches
2671,Theocharis Tsingaras,gr,MF,,Toulouse,Ligue 1,21,2000,0.1,0,0,0,0,0,0,0,,0,0,0,0,0,0,0,Matches
2672,Viktor Tsyhankov,ua,MF,,Girona,La Liga,24,1997,16.5,8,8,5,1,2,1,14,7.1,13,13,2,11,7,15,12,Matches
2673,Alessandro Tuia,it,DF,,Lecce,it Serie A,32,1990,5.7,10,6,6,4,0,3,9,33.3,6,3,1,2,15,25,29,Matches
2674,Martin Turk,si,GK,,Sampdoria,it Serie A,18,2003,4.0,0,0,0,0,0,0,0,,0,0,0,0,0,0,1,Matches
2675,Beñat Turrientes,es,MF,FW,Real Sociedad,La Liga,20,2002,1.2,3,3,3,0,0,1,5,20.0,4,2,0,2,0,3,3,Matches
2676,Tuta,br,DF,,Eint Frankfurt,Bundesliga,23,1999,30.2,53,35,27,19,7,33,57,57.9,24,47,14,33,49,102,134,Matches
2677,Destiny Udogie,it,DF,,Udinese,it Serie A,19,2002,30.0,71,45,42,24,5,34,59,57.6,25,34,6,28,36,107,25,Matches
2678,Ike Ugbo,ca,FW,MF,Troyes,Ligue 1,23,1998,9.9,5,2,2,2,1,3,11,27.3,8,8,2,6,2,7,4,Matches
2679,Lesley Ugochukwu,fr,MF,,Rennes,Ligue 1,18,2004,14.8,36,19,13,20,3,16,24,66.7,8,24,10,14,21,57,16,Matches
2680,Samir Ujkani,xk,GK,,Empoli,it Serie A,34,1988,0.1,0,0,0,0,0,0,0,,0,0,0,0,0,0,0,Matches
2681,Sven Ulreich,de,GK,,Bayern Munich,Bundesliga,33,1988,3.0,1,1,1,0,0,1,1,100.0,0,0,0,0,0,1,0,Matches
2682,Lauren Ulrich,de,MF,,Stuttgart,Bundesliga,17,2005,0.1,1,1,0,0,1,0,0,,0,0,0,0,0,1,0,Matches
2683,Samuel Umtiti,fr,DF,,Lecce,it Serie A,28,1993,23.5,52,34,25,25,2,18,26,69.2,8,26,14,12,26,78,79,Matches
2684,Enes Ünal,tr,FW,,Getafe,La Liga,25,1997,33.0,26,14,5,19,2,7,25,28.0,18,19,2,17,6,32,35,Matches
2685,Deniz Undav,de,FW,MF,Brighton,Premier League,26,1996,7.0,7,4,2,2,3,2,8,25.0,6,4,1,3,0,7,1,Matches
2686,Cengiz Ünder,tr,MF,DF,Marseille,Ligue 1,25,1997,27.7,37,19,15,13,9,13,34,38.2,21,18,2,16,18,55,13,Matches
2687,Dayot Upamecano,fr,DF,,Bayern Munich,Bundesliga,23,1998,26.1,65,37,43,22,0,28,45,62.2,17,26,6,20,27,92,71,Matches
2688,Filip Uremović,hr,DF,,Hertha BSC,Bundesliga,25,1997,19.2,38,23,29,8,1,14,22,63.6,8,18,13,5,36,74,88,Matches
2689,Oscar Ureña,do,MF,,Girona,La Liga,19,2003,1.1,4,2,2,2,0,2,3,66.7,1,2,0,2,1,5,0,Matches
2690,Jere Uronen,fi,DF,,Brest,Ligue 1,28,1994,3.3,8,5,4,4,0,7,12,58.3,5,6,2,4,7,15,5,Matches
2691,Jere Uronen,fi,DF,,Schalke 04,Bundesliga,28,1994,7.5,14,10,6,6,2,6,10,60.0,4,5,2,3,8,22,13,Matches
2692,Mark Uth,de,MF,FW,Köln,Bundesliga,30,1991,0.5,0,0,0,0,0,0,0,,0,0,0,0,0,0,0,Matches
2693,Josha Vagnoman,de,DF,,Stuttgart,Bundesliga,21,2000,16.4,26,15,12,11,3,15,27,55.6,12,20,2,18,8,34,29,Matches
2694,Diego Valencia,cl,MF,FW,Salernitana,it Serie A,22,2000,2.6,8,5,4,2,2,2,9,22.2,7,10,1,9,1,9,2,Matches
2695,Óscar Valentín,es,MF,,Rayo Vallecano,La Liga,27,1994,28.4,92,51,29,50,13,46,121,38.0,75,60,9,51,44,136,30,Matches
2696,Emanuele Valeri,it,DF,,Cremonese,it Serie A,23,1998,30.9,54,27,29,21,4,29,69,42.0,40,17,3,14,22,76,44,Matches
2697,Yan Valery,tn,DF,,Southampton,Premier League,23,1999,0.5,0,0,0,0,0,0,0,,0,1,0,1,0,0,3,Matches
2698,Yan Valery,tn,DF,,Angers,Ligue 1,23,1999,27.7,54,39,28,20,6,20,37,54.1,17,35,15,20,34,88,82,Matches
2699,Martin Valjent,sk,DF,,Mallorca,La Liga,26,1995,29.5,35,27,22,12,1,19,28,67.9,9,39,21,18,29,64,137,Matches
2700,Jesús Vallejo,es,DF,,Real Madrid,La Liga,25,1997,0.2,0,0,0,0,0,0,0,,0,0,0,0,0,0,0,Matches
2701,Manu Vallejo,es,FW,MF,Girona,La Liga,25,1997,2.3,4,1,1,2,1,1,6,16.7,5,2,0,2,1,5,3,Matches
2702,Mattia Valoti,it,MF,FW,Monza,it Serie A,28,1993,5.0,17,10,7,9,1,5,16,31.3,11,13,3,10,3,20,6,Matches
2703,Federico Valverde,uy,MF,FW,Real Madrid,La Liga,24,1998,27.8,31,20,14,11,6,13,26,50.0,13,31,4,27,17,48,15,Matches
2704,Virgil van Dijk,nl,DF,,Liverpool,Premier League,31,1991,31.5,27,14,13,11,3,8,19,42.1,11,24,16,8,31,58,138,Matches
2705,Vanderson,br,DF,MF,Monaco,Ligue 1,21,2001,24.6,84,48,36,34,14,44,75,58.7,31,36,9,27,48,132,36,Matches
2706,Raphaël Varane,fr,DF,,Manchester Utd,Premier League,29,1993,21.2,24,9,18,6,0,7,17,41.2,10,24,17,7,11,35,91,Matches
2707,Jamie Vardy,eng,FW,,Leicester City,Premier League,35,1987,20.6,9,5,4,2,3,1,8,12.5,7,17,3,14,2,11,30,Matches
2708,Ruben Vargas,ch,MF,FW,Augsburg,Bundesliga,23,1998,12.6,15,7,6,7,2,5,11,45.5,6,8,2,6,6,21,16,Matches
2709,Johan Vásquez,mx,DF,,Cremonese,it Serie A,23,1998,20.1,41,26,34,7,0,18,39,46.2,21,27,20,7,45,86,93,Matches
2710,Jesus Vazquez,es,DF,MF,Valencia,La Liga,19,2003,3.4,13,8,9,1,3,6,11,54.5,5,4,0,4,1,14,8,Matches
2711,Kevin Vázquez,es,DF,MF,Celta Vigo,La Liga,29,1993,4.9,13,8,5,7,1,8,12,66.7,4,4,1,3,2,15,8,Matches
2712,Lucas Vázquez,es,DF,,Real Madrid,La Liga,31,1991,12.7,34,23,22,10,2,20,28,71.4,8,10,0,10,7,41,13,Matches
2713,Matías Vecino,uy,MF,,Lazio,it Serie A,30,1991,18.8,47,27,13,23,11,23,48,47.9,25,33,10,23,16,63,39,Matches
2714,Gabriel Veiga,es,MF,,Celta Vigo,La Liga,20,2002,25.5,43,19,14,25,4,16,52,30.8,36,30,3,27,21,64,6,Matches
2715,Renato Veiga,pt,DF,,Augsburg,Bundesliga,19,2003,7.1,9,6,4,3,2,7,9,77.8,2,20,6,14,7,16,29,Matches
2716,Miloš Veljković,rs,DF,,Werder Bremen,Bundesliga,26,1995,25.2,30,19,17,13,0,18,29,62.1,11,32,16,16,33,63,103,Matches
2717,Miguel Veloso,pt,MF,,Hellas Verona,it Serie A,36,1986,12.9,33,10,20,12,1,16,26,61.5,10,26,6,20,6,39,14,Matches
2718,Joël Veltman,nl,DF,,Brighton,Premier League,30,1992,24.3,62,32,44,14,4,37,57,64.9,20,27,8,19,19,81,51,Matches
2719,Micky van de Ven,nl,DF,,Wolfsburg,Bundesliga,21,2001,33.0,45,30,26,18,1,28,39,71.8,11,42,24,18,26,71,108,Matches
2720,Unai Vencedor Paris,es,MF,,Athletic Club,La Liga,21,2000,2.1,3,1,0,3,0,1,6,16.7,5,5,0,5,1,4,1,Matches
2721,Lorenzo Venuti,it,DF,,Fiorentina,it Serie A,27,1995,10.3,18,7,6,11,1,11,18,61.1,7,7,2,5,5,23,17,Matches
2722,Daniele Verde,it,FW,MF,Spezia,it Serie A,26,1996,11.1,4,4,3,0,1,3,7,42.9,4,6,0,6,8,12,4,Matches
2723,Simone Verdi,it,MF,FW,Hellas Verona,it Serie A,30,1992,12.2,15,10,7,5,3,6,17,35.3,11,8,1,7,0,15,2,Matches
2724,Gonzalo Verdú,es,DF,,Elche,La Liga,33,1988,7.8,10,5,8,2,0,4,8,50.0,4,8,6,2,10,20,33,Matches
2725,Jordan Veretout,fr,MF,,Marseille,Ligue 1,29,1993,31.8,56,35,17,32,7,25,53,47.2,28,22,7,15,36,92,40,Matches
2726,Marco Verratti,it,MF,,Paris S-G,Ligue 1,29,1992,24.4,76,49,34,36,6,38,89,42.7,51,42,6,36,27,103,11,Matches
2727,Valerio Verre,it,MF,,Sampdoria,it Serie A,28,1994,7.5,14,7,6,5,3,8,17,47.1,9,9,1,8,9,23,3,Matches
2728,Mikel Vesga,es,MF,,Athletic Club,La Liga,29,1993,28.6,57,35,21,31,5,25,68,36.8,43,39,8,31,36,93,39,Matches
2729,Guglielmo Vicario,it,GK,,Empoli,it Serie A,25,1996,30.9,1,1,1,0,0,1,2,50.0,1,0,0,0,0,1,15,Matches
2730,João Victor,br,DF,,Nantes,Ligue 1,24,1998,9.4,19,11,9,7,3,12,22,54.5,10,11,1,10,15,34,30,Matches
2731,Aleix Vidal,es,MF,FW,Espanyol,La Liga,32,1989,11.4,11,5,6,3,2,4,22,18.2,18,21,2,19,15,26,14,Matches
2732,Clément Vidal,fr,DF,MF,Ajaccio,Ligue 1,22,2000,21.1,25,15,14,11,0,18,38,47.4,20,27,16,11,27,52,73,Matches
2733,Nacho Vidal,es,DF,,Osasuna,La Liga,27,1995,13.9,27,14,16,6,5,17,32,53.1,15,17,4,13,19,46,33,Matches
2734,Gabriel Vidovic,hr,FW,,Bayern Munich,Bundesliga,18,2003,0.2,0,0,0,0,0,0,0,,0,0,0,0,0,0,0,Matches
2735,Fabio Vieira,pt,MF,FW,Arsenal,Premier League,22,2000,5.7,6,4,3,0,3,3,5,60.0,2,5,0,5,4,10,2,Matches
2736,Ronaldo Vieira,eng,MF,,Torino,it Serie A,24,1998,0.2,1,0,0,1,0,1,1,100.0,0,0,0,0,0,1,2,Matches
2737,Ronaldo Vieira,eng,MF,,Sampdoria,it Serie A,24,1998,9.1,18,10,4,12,2,10,13,76.9,3,15,5,10,13,31,10,Matches
2738,Emanuel Vignato,it,MF,FW,Bologna,it Serie A,21,2000,2.7,4,4,2,2,0,2,4,50.0,2,2,0,2,3,7,0,Matches
2739,Emanuel Vignato,it,MF,FW,Empoli,it Serie A,21,2000,0.6,2,0,2,0,0,0,0,,0,0,0,0,0,2,1,Matches
2740,Samuele Vignato,it,MF,FW,Monza,it Serie A,18,2004,0.7,0,0,0,0,0,0,0,,0,1,0,1,0,0,0,Matches
2741,Tonny Vilhena,nl,MF,,Salernitana,it Serie A,27,1995,25.2,44,22,16,23,5,20,50,40.0,30,17,7,10,18,62,21,Matches
2742,Toni Villa,es,MF,,Valladolid,La Liga,27,1995,1.0,6,3,2,3,1,4,9,44.4,5,0,0,0,0,6,0,Matches
2743,Toni Villa,es,MF,FW,Girona,La Liga,27,1995,9.9,25,18,9,11,5,10,23,43.5,13,8,0,8,8,33,3,Matches
2744,Asier Villalibre,es,FW,,Athletic Club,La Liga,24,1997,1.1,0,0,0,0,0,0,0,,0,0,0,0,0,0,1,Matches
2745,Gonzalo Villar,es,MF,,Sampdoria,it Serie A,24,1998,7.7,13,7,4,8,1,7,15,46.7,8,11,3,8,4,17,9,Matches
2746,Gonzalo Villar,es,MF,,Getafe,La Liga,24,1998,5.1,10,5,1,6,3,6,14,42.9,8,9,2,7,6,16,5,Matches
2747,Iván Villar,es,GK,,Celta Vigo,La Liga,25,1997,19.0,0,0,0,0,0,0,1,0.0,1,0,0,0,0,0,7,Matches
2748,Matías Viña,uy,DF,,Bournemouth,Premier League,24,1997,5.1,19,11,9,8,2,14,30,46.7,16,13,1,12,4,23,22,Matches
2749,Matías Viña,uy,DF,,Roma,it Serie A,24,1997,0.6,3,1,1,1,1,1,3,33.3,2,5,1,4,2,5,5,Matches
2750,Rúben Vinagre,pt,DF,MF,Everton,Premier League,23,1999,0.3,2,2,1,1,0,1,2,50.0,1,0,0,0,0,2,1,Matches
2751,Carlos Vinícius,br,FW,,Fulham,Premier League,27,1995,12.3,4,1,0,2,2,0,4,0.0,4,7,0,7,0,4,10,Matches
2752,Alan Virginius,fr,FW,,Lille,Ligue 1,19,2003,2.9,3,2,1,1,1,0,4,0.0,4,0,0,0,2,5,1,Matches
2753,Mattia Viti,it,DF,,Nice,Ligue 1,20,2002,7.0,4,2,1,1,2,2,5,40.0,3,9,3,6,8,12,22,Matches
2754,Vitinha,pt,FW,,Marseille,Ligue 1,22,2000,5.2,15,7,0,6,9,3,11,27.3,8,3,0,3,2,17,6,Matches
2755,Vitinha,pt,MF,,Paris S-G,Ligue 1,22,2000,27.2,58,25,21,27,10,27,83,32.5,56,27,4,23,25,83,15,Matches
2756,Daniel Vivian,es,DF,,Athletic Club,La Liga,23,1999,26.4,57,32,36,16,5,36,45,80.0,9,27,14,13,24,81,90,Matches
2757,Dušan Vlahović,rs,FW,,Juventus,it Serie A,22,2000,21.4,11,6,0,7,4,4,10,40.0,6,10,3,7,3,14,8,Matches
2758,Nikola Vlašić,hr,MF,FW,Torino,it Serie A,24,1997,30.3,32,21,9,16,7,15,34,44.1,19,25,2,23,10,42,14,Matches
2759,Joel Voelkerling Persson,se,FW,MF,Lecce,it Serie A,19,2003,1.1,1,1,0,0,1,0,1,0.0,1,1,0,1,0,1,0,Matches
2760,Kevin Vogt,de,DF,,Hoffenheim,Bundesliga,30,1991,19.7,15,10,10,5,0,9,22,40.9,13,18,11,7,26,41,67,Matches
2761,Mërgim Vojvoda,xk,DF,,Torino,it Serie A,27,1995,19.1,22,12,15,6,1,12,24,50.0,12,14,2,12,10,32,31,Matches
2762,Kevin Volland,de,FW,MF,Monaco,Ligue 1,30,1992,7.1,8,4,1,5,2,2,8,25.0,6,8,0,8,2,10,0,Matches
2763,Cristian Volpato,it,MF,,Roma,it Serie A,18,2003,2.5,3,2,1,1,1,0,2,0.0,2,2,0,2,2,5,0,Matches
2764,Lukáš Vorlický,cz,MF,FW,Atalanta,it Serie A,20,2002,0.3,0,0,0,0,0,0,0,,0,0,0,0,1,1,0,Matches
2765,Aster Vranckx,be,MF,,Milan,it Serie A,19,2002,2.7,3,2,0,2,1,2,7,28.6,5,3,1,2,2,5,1,Matches
2766,Aster Vranckx,be,MF,,Wolfsburg,Bundesliga,19,2002,0.1,0,0,0,0,0,0,0,,0,0,0,0,0,0,1,Matches
2767,Stefan de Vrij,nl,DF,,Inter,it Serie A,30,1992,21.6,28,18,19,9,0,8,14,57.1,6,18,10,8,40,68,80,Matches
2768,Robert Wagner,de,MF,,Freiburg,Bundesliga,19,2003,0.4,0,0,0,0,0,0,0,,0,2,0,2,0,0,2,Matches
2769,Elye Wahi,fr,FW,,Montpellier,Ligue 1,19,2003,27.9,9,3,2,3,4,5,14,35.7,9,14,2,12,3,12,5,Matches
2770,Walace,br,MF,,Udinese,it Serie A,27,1995,35.4,82,39,42,31,9,41,90,45.6,49,47,12,35,51,133,51,Matches
2771,Theo Walcott,eng,FW,MF,Southampton,Premier League,33,1989,12.5,13,6,8,4,1,8,27,29.6,19,8,1,7,9,22,7,Matches
2772,Luca Waldschmidt,de,FW,MF,Wolfsburg,Bundesliga,26,1996,5.8,5,2,2,1,2,2,10,20.0,8,6,0,6,3,8,5,Matches
2773,Kyle Walker,eng,DF,,Manchester City,Premier League,32,1990,21.8,13,9,8,5,0,4,24,16.7,20,12,2,10,18,31,22,Matches
2774,Kyle Walker-Peters,eng,DF,,Southampton,Premier League,25,1997,29.4,61,32,34,24,3,22,43,51.2,21,47,8,39,27,88,52,Matches
2775,Sebastian Walukiewicz,pl,DF,,Empoli,it Serie A,22,2000,6.7,9,6,7,2,0,4,6,66.7,2,10,9,1,7,16,30,Matches
2776,Aaron Wan-Bissaka,eng,DF,,Manchester Utd,Premier League,24,1997,15.9,40,25,20,17,3,23,25,92.0,2,24,8,16,22,62,41,Matches
2777,Paul Wanner,de,MF,,Bayern Munich,Bundesliga,16,2005,0.3,3,1,1,2,0,1,1,100.0,0,0,0,0,0,3,1,Matches
2778,Danny Ward,wls,GK,,Leicester City,Premier League,29,1993,26.0,1,1,1,0,0,1,3,33.3,2,0,0,0,0,1,14,Matches
2779,Joel Ward,eng,DF,,Crystal Palace,Premier League,32,1989,25.1,50,36,30,11,9,30,41,73.2,11,32,16,16,25,75,80,Matches
2780,James Ward-Prowse,eng,MF,,Southampton,Premier League,27,1994,37.5,65,37,31,27,7,21,61,34.4,40,30,10,20,55,120,48,Matches
2781,Ollie Watkins,eng,FW,,Aston Villa,Premier League,26,1995,34.7,19,13,3,13,3,10,27,37.0,17,21,4,17,10,29,39,Matches
2782,Timothy Weah,us,DF,FW,Lille,Ligue 1,22,2000,19.4,24,14,13,9,2,16,29,55.2,13,17,3,14,23,47,18,Matches
2783,Adam Webster,eng,DF,,Brighton,Premier League,27,1995,22.1,22,12,10,9,3,11,19,57.9,8,30,19,11,19,41,55,Matches
2784,Wout Weghorst,nl,FW,MF,Manchester Utd,Premier League,29,1992,8.9,11,5,6,1,4,2,9,22.2,7,7,2,5,7,18,9,Matches
2785,Julian Weigl,de,MF,,Gladbach,Bundesliga,26,1995,21.0,43,16,21,21,1,23,41,56.1,18,23,2,21,18,61,32,Matches
2786,Nelson Weiper,de,FW,DF,Mainz 05,Bundesliga,17,2005,1.1,2,0,0,0,2,1,3,33.3,2,2,0,2,0,2,1,Matches
2787,Mitchell Weiser,de,DF,FW,Werder Bremen,Bundesliga,28,1994,28.0,71,43,38,24,9,38,75,50.7,37,50,7,43,28,99,38,Matches
2788,Noah Weißhaupt,de,MF,DF,Freiburg,Bundesliga,20,2001,4.7,11,6,3,7,1,2,7,28.6,5,4,0,4,6,17,8,Matches
2789,Shon Weissman,il,FW,,Valladolid,La Liga,26,1996,8.3,2,1,1,1,0,0,4,0.0,4,8,0,8,1,3,7,Matches
2790,Danny Welbeck,eng,FW,,Brighton,Premier League,31,1990,20.6,15,7,0,7,8,4,11,36.4,7,24,2,22,5,20,20,Matches
2791,Marcel Wenig,de,MF,,Eint Frankfurt,Bundesliga,18,2004,0.0,0,0,0,0,0,0,0,,0,0,0,0,0,0,0,Matches
2792,Axel Werner,ar,GK,,Elche,La Liga,26,1996,2.0,0,0,0,0,0,0,1,0.0,1,0,0,0,0,0,0,Matches
2793,Timo Werner,de,FW,MF,RB Leipzig,Bundesliga,26,1996,21.5,10,5,4,3,3,4,12,33.3,8,12,0,12,7,17,5,Matches
2794,Ben White,eng,DF,,Arsenal,Premier League,24,1997,33.9,60,31,23,30,7,42,70,60.0,28,47,11,36,22,82,79,Matches
2795,Harvey White,eng,MF,,Tottenham,Premier League,20,2001,0.1,0,0,0,0,0,0,1,0.0,1,0,0,0,0,0,0,Matches
2796,Joseph Whitworth,eng,GK,,Crystal Palace,Premier League,18,2004,2.0,0,0,0,0,0,0,0,,0,0,0,0,0,0,1,Matches
2797,Silvan Widmer,ch,DF,,Mainz 05,Bundesliga,29,1993,18.8,26,17,15,10,1,20,39,51.3,19,22,8,14,31,57,28,Matches
2798,Mateusz Wieteska,pl,DF,,Clermont Foot,Ligue 1,25,1997,34.6,41,23,28,13,0,19,33,57.6,14,44,28,16,56,97,97,Matches
2799,Georginio Wijnaldum,nl,MF,,Roma,it Serie A,31,1990,8.5,4,3,1,3,0,0,2,0.0,2,7,1,6,2,6,3,Matches
2800,Iñaki Williams,gh,FW,,Athletic Club,La Liga,28,1994,31.5,22,16,5,14,3,9,24,37.5,15,18,3,15,7,29,34,Matches
2801,Neco Williams,wls,DF,,Nott'ham Forest,Premier League,21,2001,20.9,72,47,49,17,6,38,71,53.5,33,33,8,25,33,105,48,Matches
2802,Nico Williams,es,FW,,Athletic Club,La Liga,20,2002,29.5,31,16,10,15,6,19,41,46.3,22,40,2,38,8,39,14,Matches
2803,Willian,br,FW,,Fulham,Premier League,33,1988,23.6,13,8,8,3,2,7,25,28.0,18,13,0,13,9,22,9,Matches
2804,Joe Willock,eng,MF,,Newcastle Utd,Premier League,22,1999,28.4,51,30,13,26,12,25,58,43.1,33,54,8,46,25,76,17,Matches
2805,Callum Wilson,eng,FW,,Newcastle Utd,Premier League,30,1992,20.9,9,3,0,8,1,0,3,0.0,3,8,0,8,1,10,5,Matches
2806,Harry Wilson,wls,FW,,Fulham,Premier League,25,1997,12.2,21,13,9,9,3,8,18,44.4,10,17,2,15,6,27,14,Matches
2807,Patrick Wimmer,at,FW,MF,Wolfsburg,Bundesliga,21,2001,18.3,39,26,18,11,10,12,38,31.6,26,27,2,25,15,54,15,Matches
2808,Jonas Wind,dk,FW,,Wolfsburg,Bundesliga,23,1999,14.3,14,6,2,7,5,5,10,50.0,5,14,4,10,1,15,10,Matches
2809,Harry Winks,eng,MF,,Sampdoria,it Serie A,26,1996,19.1,27,12,7,18,2,14,43,32.6,29,14,8,6,24,51,24,Matches
2810,Frederik Winther,dk,DF,,Augsburg,Bundesliga,21,2001,1.0,2,2,1,1,0,0,2,0.0,2,1,1,0,0,2,7,Matches
2811,Florian Wirtz,de,FW,MF,Leverkusen,Bundesliga,19,2003,12.1,18,10,9,7,2,8,16,50.0,8,15,1,14,1,19,6,Matches
2812,Przemysław Wiśniewski,pl,DF,,Spezia,it Serie A,24,1998,11.1,13,6,7,6,0,6,18,33.3,12,16,8,8,11,24,66,Matches
2813,Yoane Wissa,cd,FW,,Brentford,Premier League,25,1996,17.8,17,12,4,7,6,6,13,46.2,7,10,0,10,6,23,15,Matches
2814,Axel Witsel,be,DF,MF,Atlético Madrid,La Liga,33,1989,25.1,36,22,22,11,3,17,31,54.8,14,20,11,9,23,59,76,Matches
2815,Maximilian Wöber,at,DF,,Leeds United,Premier League,24,1998,14.1,25,18,9,15,1,16,24,66.7,8,32,14,18,27,52,67,Matches
2816,Hannes Wolf,at,FW,,Gladbach,Bundesliga,23,1999,5.0,11,8,4,5,2,5,13,38.5,8,3,0,3,3,14,9,Matches
2817,Marius Wolf,de,DF,,Dortmund,Bundesliga,27,1995,17.4,25,18,9,12,4,16,29,55.2,13,40,10,30,18,43,22,Matches
2818,Jeong Woo-yeong,kr,MF,FW,Freiburg,Bundesliga,22,1999,7.3,7,3,4,2,1,2,5,40.0,3,7,1,6,1,8,7,Matches
2819,Chris Wood,nz,FW,,Newcastle Utd,Premier League,30,1991,5.0,5,4,0,3,2,3,5,60.0,2,2,2,0,1,6,7,Matches
2820,Chris Wood,nz,FW,,Nott'ham Forest,Premier League,30,1991,4.1,0,0,0,0,0,0,1,0.0,1,2,1,1,1,1,2,Matches
2821,Christopher Wooh,cm,DF,,Rennes,Ligue 1,20,2001,11.2,16,7,8,8,0,9,11,81.8,2,11,5,6,6,22,49,Matches
2822,Christopher Wooh,cm,MF,,Lens,Ligue 1,20,2001,0.0,0,0,0,0,0,0,1,0.0,1,0,0,0,0,0,1,Matches
2823,Joe Worrall,eng,DF,,Nott'ham Forest,Premier League,25,1997,24.7,53,25,39,12,2,25,35,71.4,10,33,23,10,26,79,111,Matches
2824,Xeka,pt,MF,,Rennes,Ligue 1,27,1994,6.1,10,3,6,3,1,7,16,43.8,9,11,2,9,6,16,8,Matches
2825,Granit Xhaka,ch,MF,,Arsenal,Premier League,29,1992,33.3,34,27,11,18,5,16,41,39.0,25,28,10,18,15,49,45,Matches
2826,Lamine Yamal,es,FW,,Barcelona,La Liga,15,2007,0.1,0,0,0,0,0,0,0,,0,0,0,0,0,0,0,Matches
2827,Jawad El Yamiq,ma,DF,,Valladolid,La Liga,30,1992,17.9,17,11,10,7,0,6,11,54.5,5,27,19,8,37,54,101,Matches
2828,Ryan Yates,eng,MF,,Nott'ham Forest,Premier League,24,1997,20.4,38,19,19,16,3,14,22,63.6,8,26,8,18,10,48,44,Matches
2829,Yusuf Yazıcı,tr,MF,,Lille,Ligue 1,25,1997,2.2,0,0,0,0,0,0,0,,0,2,0,2,0,0,1,Matches
2830,Kelvin Yeboah,it,FW,MF,Augsburg,Bundesliga,22,2000,3.9,6,4,2,4,0,2,5,40.0,3,7,0,7,1,7,2,Matches
2831,Gerard Yepes,es,MF,,Sampdoria,it Serie A,19,2002,2.2,5,3,2,3,0,1,3,33.3,2,3,0,3,4,9,3,Matches
2832,Darlin Yongwa,cm,DF,,Lorient,Ligue 1,21,2000,8.7,13,11,7,5,1,4,15,26.7,11,13,1,12,5,18,11,Matches
2833,Leny Yoro,fr,DF,,Lille,Ligue 1,16,2005,8.5,11,5,8,3,0,4,9,44.4,5,6,1,5,18,29,27,Matches
2834,Maya Yoshida,jp,DF,,Schalke 04,Bundesliga,33,1988,28.4,34,22,19,13,2,18,29,62.1,11,40,29,11,46,80,132,Matches
2835,Ashley Young,eng,DF,,Aston Villa,Premier League,37,1985,22.6,50,27,34,15,1,37,50,74.0,13,25,11,14,21,71,65,Matches
2836,Mohamed Youssouf,km,DF,,Ajaccio,Ligue 1,34,1988,27.3,72,44,41,24,7,38,61,62.3,23,32,8,24,65,137,70,Matches
2837,Illia Zabarnyi,ua,DF,,Bournemouth,Premier League,19,2002,3.3,4,2,4,0,0,3,7,42.9,4,7,2,5,3,7,14,Matches
2838,Mattia Zaccagni,it,FW,,Lazio,it Serie A,27,1995,30.8,42,28,16,18,8,14,38,36.8,24,37,3,34,21,63,10,Matches
2839,Dan-Axel Zagadou,fr,DF,,Stuttgart,Bundesliga,23,1999,14.1,14,9,10,4,0,5,14,35.7,9,19,16,3,21,35,81,Matches
2840,Wilfried Zaha,ci,FW,MF,Crystal Palace,Premier League,29,1992,25.4,32,20,12,12,8,8,21,38.1,13,21,1,20,16,48,9,Matches
2841,Warren Zaïre-Emery,fr,MF,DF,Paris S-G,Ligue 1,16,2006,10.3,17,10,5,10,2,8,29,27.6,21,11,0,11,12,29,17,Matches
2842,Denis Zakaria,ch,MF,,Chelsea,Premier League,25,1996,4.6,9,5,5,2,2,2,8,25.0,6,4,1,3,3,12,10,Matches
2843,Denis Zakaria,ch,MF,,Juventus,it Serie A,25,1996,1.4,6,3,1,4,1,2,2,100.0,0,2,0,2,2,8,1,Matches
2844,Rodrigo Zalazar,uy,MF,FW,Schalke 04,Bundesliga,22,1999,14.7,16,8,5,9,2,9,24,37.5,15,16,1,15,7,23,13,Matches
2845,Joseba Zaldúa,es,DF,,Cádiz,La Liga,30,1992,7.1,15,8,10,4,1,7,10,70.0,3,4,2,2,11,26,22,Matches
2846,Nicola Zalewski,pl,DF,,Roma,it Serie A,20,2002,24.4,45,26,25,15,5,22,71,31.0,49,27,1,26,31,76,23,Matches
2847,Andre-Frank Zambo Anguissa,cm,MF,,Napoli,it Serie A,26,1995,33.9,53,32,16,29,8,16,64,25.0,48,50,4,46,49,102,25,Matches
2848,Oliver Zandén,se,DF,MF,Toulouse,Ligue 1,20,2001,1.6,2,1,1,0,1,2,5,40.0,3,0,0,0,1,3,7,Matches
2849,Luca Zanimacchia,it,MF,FW,Cremonese,it Serie A,24,1998,8.3,21,13,11,6,4,8,21,38.1,13,9,0,9,9,30,5,Matches
2850,Nicolò Zaniolo,it,MF,FW,Roma,it Serie A,23,1999,9.9,7,5,2,4,1,2,7,28.6,5,11,0,11,2,9,0,Matches
2851,Alessandro Zanoli,it,DF,,Sampdoria,it Serie A,21,2000,17.1,22,14,14,6,2,8,17,47.1,9,19,15,4,12,34,39,Matches
2852,Alessandro Zanoli,it,DF,,Napoli,it Serie A,21,2000,0.1,1,0,0,1,0,0,0,,0,0,0,0,0,1,1,Matches
2853,Mattia Zanotti,it,DF,,Inter,it Serie A,19,2003,0.3,0,0,0,0,0,0,1,0.0,1,2,0,2,0,0,0,Matches
2854,Duván Zapata,co,FW,,Atalanta,it Serie A,31,1991,15.4,8,4,1,3,4,3,5,60.0,2,6,2,4,4,12,17,Matches
2855,Davide Zappacosta,it,DF,,Atalanta,it Serie A,30,1992,16.3,34,18,17,12,5,15,22,68.2,7,23,2,21,9,43,16,Matches
2856,Oier Zarraga,es,MF,,Athletic Club,La Liga,23,1999,9.5,14,9,5,7,2,8,20,40.0,12,7,0,7,10,24,5,Matches
2857,Akim Zedadka,dz,DF,,Auxerre,Ligue 1,27,1995,17.8,35,21,21,10,4,18,32,56.3,14,17,3,14,23,58,51,Matches
2858,Akim Zedadka,dz,DF,MF,Lille,Ligue 1,27,1995,3.9,1,1,1,0,0,0,2,0.0,2,3,0,3,2,3,6,Matches
2859,Karim Zedadka,fr,FW,,Napoli,it Serie A,22,2000,0.2,0,0,0,0,0,0,0,,0,0,0,0,0,0,1,Matches
2860,Deyovaisio Zeefuik,nl,DF,,Hellas Verona,it Serie A,24,1998,0.1,1,1,0,1,0,0,0,,0,0,0,0,0,1,0,Matches
2861,Marvin Zeegelaar,nl,DF,,Udinese,it Serie A,31,1990,3.9,8,4,6,2,0,3,4,75.0,1,2,0,2,3,11,5,Matches
2862,Mehdi Zeffane,dz,DF,MF,Clermont Foot,Ligue 1,30,1992,7.3,12,7,5,7,0,4,21,19.0,17,14,6,8,22,34,12,Matches
2863,Aaron Zehnter,de,DF,,Augsburg,Bundesliga,17,2004,0.0,0,0,0,0,0,0,1,0.0,1,0,0,0,1,1,0,Matches
2864,Jordan Zemura,zw,DF,,Bournemouth,Premier League,22,1999,16.2,39,24,24,14,1,23,44,52.3,21,31,9,22,16,55,32,Matches
2865,Arber Zeneli,xk,FW,MF,Reims,Ligue 1,27,1995,11.1,9,3,3,3,3,5,12,41.7,7,8,0,8,2,11,2,Matches
2866,Robin Zentner,de,GK,,Mainz 05,Bundesliga,27,1994,26.0,0,0,0,0,0,0,4,0.0,4,0,0,0,0,0,17,Matches
2867,Alessio Zerbin,it,FW,,Napoli,it Serie A,23,1999,2.2,10,5,4,5,1,4,8,50.0,4,2,0,2,2,12,2,Matches
2868,Michael Zetterer,de,GK,,Werder Bremen,Bundesliga,27,1995,1.7,0,0,0,0,0,0,0,,0,0,0,0,0,0,1,Matches
2869,Nathan Zeze,fr,DF,,Nantes,Ligue 1,17,2005,0.7,3,2,2,1,0,1,1,100.0,0,0,0,0,0,3,1,Matches
2870,Edon Zhegrova,xk,FW,MF,Lille,Ligue 1,23,1999,11.7,18,12,6,7,5,12,20,60.0,8,9,0,9,2,20,2,Matches
2871,Piotr Zieliński,pl,MF,,Napoli,it Serie A,28,1994,25.4,17,10,1,11,5,12,25,48.0,13,16,5,11,14,31,7,Matches
2872,David Zima,cz,DF,,Torino,it Serie A,21,2000,4.5,9,5,5,4,0,3,4,75.0,1,7,2,5,9,18,11,Matches
2873,Oleksandr Zinchenko,ua,DF,,Arsenal,Premier League,25,1996,23.5,40,18,14,17,9,21,40,52.5,19,20,2,18,22,62,38,Matches
2874,Joshua Zirkzee,nl,FW,,Bologna,it Serie A,21,2001,9.1,4,2,1,1,2,2,7,28.6,5,4,1,3,4,8,4,Matches
2875,Hakim Ziyech,ma,FW,MF,Chelsea,Premier League,29,1993,7.3,20,12,12,5,3,4,9,44.4,5,8,0,8,5,25,5,Matches
2876,Jeroen Zoet,nl,GK,,Spezia,it Serie A,31,1991,3.7,1,1,1,0,0,1,1,100.0,0,0,0,0,0,1,1,Matches
2877,Simon Zoller,de,FW,,Bochum,Bundesliga,31,1991,16.2,11,4,2,8,1,4,12,33.3,8,14,1,13,6,17,21,Matches
2878,Nadir Zortea,it,DF,MF,Atalanta,it Serie A,23,1999,2.5,10,5,3,7,0,3,4,75.0,1,4,0,4,0,10,4,Matches
2879,Nadir Zortea,it,DF,,Sassuolo,it Serie A,23,1999,7.3,15,8,12,2,1,9,14,64.3,5,10,4,6,4,19,21,Matches
2880,Tanguy Zoukrou,fr,DF,,Troyes,Ligue 1,19,2003,5.7,14,7,8,6,0,10,14,71.4,4,18,11,7,2,16,24,Matches
2881,Kurt Zouma,fr,DF,,West Ham,Premier League,27,1994,22.1,9,4,4,5,0,5,8,62.5,3,17,14,3,30,39,120,Matches
2882,Petar Zovko,ba,GK,,Spezia,it Serie A,20,2002,0.8,1,0,1,0,0,1,1,100.0,0,0,0,0,0,1,0,Matches
2883,Igor Zubeldia,es,DF,,Real Sociedad,La Liga,25,1997,28.2,35,18,28,7,0,25,35,71.4,10,23,17,6,21,56,93,Matches
2884,Martín Zubimendi,es,MF,,Real Sociedad,La Liga,23,1999,34.5,59,33,23,30,6,24,45,53.3,21,44,17,27,37,96,55,Matches
2885,Szymon Żurkowski,pl,MF,,Fiorentina,it Serie A,24,1997,0.4,0,0,0,0,0,0,0,,0,0,0,0,0,0,0,Matches
2886,Szymon Żurkowski,pl,MF,,Spezia,it Serie A,24,1997,4.7,9,3,4,4,1,2,15,13.3,13,9,2,7,4,13,6,Matches
2887,Martin Ødegaard,no,MF,,Arsenal,Premier League,23,1998,34.7,36,23,12,14,10,14,47,29.8,33,20,5,15,6,42,12,Matches
2888,Milan Đurić,ba,FW,,Hellas Verona,it Serie A,32,1990,15.2,2,1,1,0,1,1,3,33.3,2,7,4,3,1,3,24,Matches
2889,Filip Đuričić,rs,MF,FW,Sampdoria,it Serie A,30,1992,24.1,43,22,18,20,5,14,32,43.8,18,19,6,13,7,50,8,Matches
