Rk,Player,Nation,Pos1,Pos2,Squad,Comp,Age,Born,90s,Tkl,TklW,Def 3rd,Mid 3rd,Att 3rd,Tkl Att,Tkl%,Lost,Blocks,Sh,Pass,Int,Tkl+Int,Clr,Err
1,Max Aarons,eng,DF,,Bournemouth,Premier League,24,2000,0.2,0,0,0,0,0,0,0,,0,0,0,0,0,0,0
2,Rodrigo Abajas,es,DF,,Valencia,La Liga,21,2003,0.7,3,2,2,1,0,3,3,100.0,0,1,0,1,1,4,0
3,James Abankwah,ie,DF,MF,Udinese,Serie A,20,2004,0.3,0,0,0,0,0,0,0,,0,0,0,0,1,1,2
4,Keyliane Abdallah,fr,FW,,Marseille,Ligue 1,18,2006,0.0,1,1,1,0,0,1,1,100.0,0,0,0,0,0,1,0
5,Yunis Abdelhamid,ma,DF,,Saint-Étienne,Ligue 1,37,1987,10.4,17,11,15,2,0,10,16,62.5,6,22,15,7,12,29,54
6,Himad Abdelli,dz,MF,FW,Angers,Ligue 1,25,1999,14.8,23,17,7,8,8,8,23,34.8,15,8,0,8,12,35,11
7,Mohamed Abdelmoneim,eg,DF,,Nice,Ligue 1,25,1999,5.8,15,11,9,5,1,10,17,58.8,7,6,3,3,13,28,33
8,Ali Abdi,tn,DF,MF,Nice,Ligue 1,30,1993,6.5,16,10,7,4,5,14,21,66.7,7,13,3,10,3,19,13
9,Saud Abdulhamid,sa,DF,,Roma,Serie A,25,1999,1.6,2,1,1,0,1,1,1,100.0,0,1,0,1,1,3,0
10,Abel,es,DF,FW,Osasuna,La Liga,24,2000,11.4,24,17,11,8,5,14,27,51.9,13,15,2,13,10,34,33
11,Nabil Aberdin,fr,MF,,Getafe,La Liga,22,2002,2.9,6,4,3,3,0,1,1,100.0,0,3,0,3,0,6,5
12,Oliver Abildgaard,dk,MF,,Como,Serie A,28,1996,0.1,0,0,0,0,0,0,0,,0,1,0,1,0,0,0
13,Matthis Abline,fr,FW,,Nantes,Ligue 1,21,2003,12.6,6,3,2,2,2,1,6,16.7,5,3,0,3,2,8,20
14,Abner,br,DF,,Lyon,Ligue 1,24,2000,7.3,17,12,7,7,3,12,17,70.6,5,10,1,9,5,22,22
15,Zakaria Aboukhlal,ma,MF,FW,Toulouse,Ligue 1,24,2000,13.1,12,7,5,4,3,4,14,28.6,10,10,0,10,6,18,5
16,Abdel Abqar,ma,DF,,Alavés,La Liga,25,1999,14.5,23,14,14,8,1,11,17,64.7,6,15,10,5,24,47,73
17,Tammy Abraham,eng,FW,,Roma,Serie A,27,1997,0.0,0,0,0,0,0,0,1,0.0,1,0,0,0,0,0,0
18,Tammy Abraham,eng,FW,,Milan,Serie A,27,1997,4.9,6,3,0,5,1,1,1,100.0,0,3,0,3,2,8,4
19,Federico Accornero,it,MF,,Genoa,Serie A,20,2004,0.1,0,0,0,0,0,0,0,,0,0,0,0,0,0,0
20,Francesco Acerbi,it,DF,,Inter,Serie A,36,1988,7.4,6,4,5,1,0,2,3,66.7,1,6,6,0,15,21,28
21,Akor Adams,ng,FW,,Montpellier,Ligue 1,24,2000,10.2,3,2,1,1,1,2,3,66.7,1,2,1,1,1,4,4
22,Che Adams,sct,FW,,Torino,Serie A,28,1996,10.5,6,3,1,3,2,0,1,0.0,1,6,3,3,1,7,4
23,Tyler Adams,us,MF,,Bournemouth,Premier League,25,1999,4.1,21,14,6,13,2,8,12,66.7,4,6,3,3,15,36,9
24,Junior Adamu,at,FW,,Freiburg,Bundesliga,23,2001,8.9,3,0,1,1,1,0,4,0.0,4,6,0,6,5,8,9
25,Tosin Adarabioyo,eng,DF,,Chelsea,Premier League,27,1997,3.9,5,4,5,0,0,2,3,66.7,1,3,2,1,3,8,16
26,Martin Adeline,fr,MF,,Reims,Ligue 1,21,2003,0.3,1,1,0,1,0,1,2,50.0,1,0,0,0,0,1,2
27,Karim Adeyemi,de,FW,MF,Dortmund,Bundesliga,22,2002,3.9,7,5,3,1,3,2,4,50.0,2,6,0,6,1,8,0
28,Simon Adingra,ci,FW,MF,Brighton,Premier League,22,2002,3.9,9,4,5,3,1,4,10,40.0,6,5,0,5,4,13,1
29,Amine Adli,ma,MF,,Leverkusen,Bundesliga,24,2000,2.3,7,4,1,1,5,3,5,60.0,2,3,0,3,0,7,3
30,Yacine Adli,fr,MF,,Fiorentina,Serie A,24,2000,7.2,19,10,8,7,4,11,23,47.8,12,7,1,6,3,22,14
31,Adryelson,br,DF,,Lyon,Ligue 1,26,1998,0.0,0,0,0,0,0,0,0,,0,0,0,0,1,1,1
32,Vasilije Adžić,me,MF,,Juventus,Serie A,18,2006,0.2,2,2,0,1,1,0,1,0.0,1,0,0,0,0,2,0
33,Michel Aebischer,ch,MF,,Bologna,Serie A,27,1997,4.2,7,4,1,4,2,4,8,50.0,4,3,1,2,5,12,2
34,Oladapo Afolayan,eng,FW,MF,St. Pauli,Bundesliga,26,1998,10.6,13,6,3,6,4,4,11,36.4,7,9,1,8,5,18,9
35,Emmanuel Agbadou,ci,DF,,Reims,Ligue 1,27,1997,14.0,25,17,19,3,3,19,26,73.1,7,22,13,9,19,44,64
36,Asher Agbinone,eng,MF,,Crystal Palace,Premier League,19,2005,0.1,2,1,0,2,0,0,0,,0,0,0,0,0,2,0
37,Julen Agirrezabala,es,GK,,Athletic Club,La Liga,23,2000,13.4,0,0,0,0,0,0,1,0.0,1,0,0,0,0,0,4
38,Lucien Agoume,fr,MF,,Sevilla,La Liga,22,2002,9.5,24,7,10,11,3,11,17,64.7,6,15,6,9,15,39,14
39,Felix Agu,de,DF,,Werder Bremen,Bundesliga,25,1999,8.9,10,5,6,3,1,5,11,45.5,6,6,2,4,8,18,23
40,Álvaro Aguado,es,MF,,Espanyol,La Liga,28,1996,3.5,4,2,2,2,0,2,6,33.3,4,5,0,5,2,6,5
41,Nayef Aguerd,ma,DF,,Real Sociedad,La Liga,28,1996,12.2,19,15,11,8,0,7,13,53.8,6,11,6,5,9,28,46
42,Ruben Aguilar,fr,DF,,Lens,Ligue 1,31,1993,3.0,9,6,5,4,0,7,9,77.8,2,5,1,4,5,14,2
43,Honest Ahanor,it,DF,,Genoa,Serie A,16,2008,0.9,2,1,0,2,0,2,4,50.0,2,0,0,0,0,2,2
44,Erik Ahlstrand,se,FW,MF,St. Pauli,Bundesliga,23,2001,0.4,0,0,0,0,0,0,0,,0,1,0,1,1,1,0
45,Jean-Eudes Aholou,ci,MF,,Angers,Ligue 1,30,1994,12.2,34,22,17,9,8,15,27,55.6,12,21,11,10,24,58,13
46,Joseph Aidoo,gh,DF,,Celta Vigo,La Liga,29,1995,0.0,1,0,1,0,0,0,0,,0,0,0,0,0,1,0
47,Ayman Aiki,fr,FW,MF,Saint-Étienne,Ligue 1,19,2005,1.4,3,3,1,2,0,1,1,100.0,0,1,0,1,1,4,0
48,Ola Aina,ng,DF,,Nott'ham Forest,Premier League,28,1996,15.3,34,24,26,7,1,23,32,71.9,9,16,5,11,20,54,39
49,Rayan Aït-Nouri,dz,DF,,Wolves,Premier League,23,2001,15.2,40,25,28,9,3,19,30,63.3,11,20,4,16,13,53,38
50,Kristoffer Ajer,no,DF,,Brentford,Premier League,26,1998,7.2,7,6,6,1,0,3,9,33.3,6,8,1,7,6,13,19
51,Ludovic Ajorque,fr,FW,,Brest,Ligue 1,30,1994,10.8,11,8,1,5,5,4,12,33.3,8,5,2,3,3,14,8
52,Manuel Akanji,ch,DF,,Manchester City,Premier League,29,1995,11.2,12,10,5,4,3,5,10,50.0,5,6,4,2,5,17,31
53,Ümit Akdag,ro,DF,,Toulouse,Ligue 1,21,2003,2.5,4,2,1,3,0,3,6,50.0,3,5,4,1,10,14,8
54,Nathan Aké,nl,DF,,Manchester City,Premier League,29,1995,3.3,5,4,4,1,0,2,2,100.0,0,5,1,4,3,8,5
55,Ilias Akhomach,ma,MF,FW,Villarreal,La Liga,20,2004,6.5,12,7,4,4,4,6,12,50.0,6,8,0,8,3,15,13
56,Sergio Akieme,es,DF,,Reims,Ligue 1,27,1997,11.9,17,12,15,1,1,12,16,75.0,4,10,4,6,7,24,36
57,Maghnes Akliouche,fr,FW,MF,Monaco,Ligue 1,22,2002,10.6,22,12,8,6,8,8,21,38.1,13,8,0,8,8,30,3
58,Clément Akpa,ci,DF,,Auxerre,Ligue 1,23,2001,12.0,26,17,15,6,5,16,25,64.0,9,21,5,16,16,42,50
59,David Akpan Ankeye,ng,FW,MF,Genoa,Serie A,22,2002,0.5,0,0,0,0,0,0,1,0.0,1,0,0,0,0,0,1
60,Kevin Akpoguma,ng,DF,,Hoffenheim,Bundesliga,29,1995,10.3,17,7,13,2,2,9,18,50.0,9,31,21,10,11,28,56
61,Andreas Albers,dk,FW,,St. Pauli,Bundesliga,34,1990,0.6,0,0,0,0,0,0,1,0.0,1,0,0,0,0,0,1
62,Raúl Albiol,es,DF,,Villarreal,La Liga,39,1985,12.2,8,7,7,1,0,4,8,50.0,4,10,9,1,6,14,65
63,Carlos Alcaraz,ar,MF,,Southampton,Premier League,22,2002,0.1,0,0,0,0,0,0,0,,0,0,0,0,1,1,0
64,Omar Alderete,py,DF,,Getafe,La Liga,27,1996,15.8,21,14,15,4,2,11,15,73.3,4,15,9,6,19,40,72
65,Carles Aleñá,es,MF,FW,Getafe,La Liga,26,1998,3.5,6,3,2,3,1,4,8,50.0,4,7,1,6,0,6,2
66,Trent Alexander-Arnold,eng,DF,,Liverpool,Premier League,26,1998,11.6,35,28,23,8,4,22,44,50.0,22,12,5,7,9,44,16
67,Alfon,es,FW,MF,Celta Vigo,La Liga,25,1999,3.3,2,0,0,2,0,0,2,0.0,2,2,0,2,2,4,2
68,Mohamed Ali Cho,fr,FW,MF,Nice,Ligue 1,20,2004,8.5,6,3,1,1,4,2,6,33.3,4,7,1,6,1,7,2
69,Faride Alidou,de,FW,MF,Hellas Verona,Serie A,23,2001,0.8,0,0,0,0,0,0,0,,0,1,0,1,1,1,3
70,Alisson,br,GK,,Liverpool,Premier League,32,1992,6.9,0,0,0,0,0,0,0,,0,0,0,0,0,0,2
71,Tadeo Allende,ar,FW,,Celta Vigo,La Liga,25,1999,0.0,0,0,0,0,0,0,0,,0,0,0,0,0,0,0
72,Jim Allevinah,ga,FW,,Angers,Ligue 1,29,1995,8.3,7,5,3,2,2,2,13,15.4,11,2,0,2,4,11,8
73,Domingos André Ribeiro Almeida,pt,FW,MF,Valencia,La Liga,24,2000,5.7,15,9,6,6,3,6,10,60.0,4,7,1,6,3,18,2
74,Iker Almena,es,FW,DF,Girona,La Liga,20,2004,0.5,0,0,0,0,0,0,1,0.0,1,1,0,1,0,0,2
75,Miguel Almirón,py,FW,,Newcastle Utd,Premier League,30,1994,1.4,2,1,2,0,0,1,2,50.0,1,0,0,0,0,2,0
76,Pontus Almqvist,se,FW,MF,Parma,Serie A,25,1999,4.7,7,5,4,2,1,3,5,60.0,2,4,0,4,6,13,2
77,Marcos Alonso,es,DF,,Celta Vigo,La Liga,33,1990,12.0,13,9,8,2,3,9,17,52.9,8,9,4,5,13,26,52
78,Giorgio Altare,it,DF,,Venezia,Serie A,26,1998,5.4,7,6,5,1,1,2,9,22.2,7,9,4,5,10,17,25
79,Adrià Altimira,es,DF,FW,Leganés,La Liga,23,2001,7.6,17,7,9,6,2,9,16,56.3,7,7,4,3,12,29,24
80,Sergi Altimira,es,MF,,Betis,La Liga,23,2001,11.1,30,20,8,18,4,17,31,54.8,14,17,1,16,6,36,14
81,Edson Álvarez,mx,MF,,West Ham,Premier League,27,1997,7.8,18,10,9,5,4,9,13,69.2,4,11,4,7,10,28,15
82,Hugo Álvarez,es,MF,DF,Celta Vigo,La Liga,21,2003,13.3,23,9,11,10,2,9,16,56.3,7,17,1,16,7,30,21
83,Julián Álvarez,ar,FW,MF,Atlético Madrid,La Liga,24,2000,11.3,5,2,1,0,4,1,9,11.1,8,7,0,7,0,5,5
84,Yeray Álvarez,es,DF,,Athletic Club,La Liga,29,1995,9.0,10,7,6,3,1,4,7,57.1,3,6,3,3,18,28,32
85,Skelly Alvero,fr,MF,,Werder Bremen,Bundesliga,22,2002,1.2,4,3,3,0,1,1,1,100.0,0,4,0,4,2,6,5
86,Selim Amallah,ma,MF,FW,Valladolid,La Liga,28,1996,7.5,12,7,4,7,1,0,6,0.0,6,12,0,12,7,19,2
87,Amath,sn,FW,DF,Valladolid,La Liga,28,1996,3.3,1,0,1,0,0,1,5,20.0,4,5,1,4,2,3,2
88,Jordan Amavi,fr,DF,,Brest,Ligue 1,30,1994,8.3,24,17,10,11,3,15,21,71.4,6,8,2,6,7,31,16
89,Aurele Amenda,ch,DF,,Eint Frankfurt,Bundesliga,21,2003,0.8,0,0,0,0,0,0,0,,0,2,2,0,1,1,4
90,Kelvin Amian,fr,DF,MF,Nantes,Ligue 1,26,1998,9.9,26,15,23,3,0,13,16,81.3,3,8,4,4,2,28,23
91,Michael Amir Murillo,pa,DF,,Marseille,Ligue 1,28,1996,12.8,26,15,16,6,4,14,24,58.3,10,7,3,4,10,36,36
92,Nadiem Amiri,de,MF,,Mainz 05,Bundesliga,28,1996,12.1,18,9,8,8,2,4,20,20.0,16,12,2,10,12,30,15
93,Samuel Amo-Ameyaw,eng,FW,DF,Southampton,Premier League,18,2006,0.3,1,0,0,1,0,1,1,100.0,0,0,0,0,0,1,0
94,Mathis Amougou,fr,MF,,Saint-Étienne,Ligue 1,18,2006,8.0,14,9,10,4,0,7,13,53.8,6,6,0,6,12,26,4
95,Mohamed Amoura,dz,FW,,Wolfsburg,Bundesliga,24,2000,10.7,8,5,2,1,5,3,13,23.1,10,16,0,16,4,12,6
96,Sofyan Amrabat,ma,MF,,Fiorentina,Serie A,28,1996,2.0,3,2,1,2,0,2,2,100.0,0,1,1,0,0,3,2
97,Joachim Andersen,dk,DF,,Crystal Palace,Premier League,28,1996,1.0,1,1,1,0,0,1,2,50.0,1,0,0,0,0,1,7
98,Joachim Andersen,dk,DF,,Fulham,Premier League,28,1996,7.7,8,5,8,0,0,4,8,50.0,4,9,6,3,11,19,42
99,Elliot Anderson,eng,MF,FW,Nott'ham Forest,Premier League,22,2002,10.1,36,26,19,11,6,16,30,53.3,14,20,4,16,9,45,19
100,André,br,MF,,Wolves,Premier League,23,2001,8.1,30,22,14,11,5,15,21,71.4,6,21,5,16,6,36,11
101,Benjamin André,fr,MF,,Lille,Ligue 1,34,1990,12.9,36,14,14,19,3,23,41,56.1,18,18,3,15,18,54,25
102,Marcos André,br,FW,,Valladolid,La Liga,28,1996,4.8,3,3,0,2,1,0,3,0.0,3,6,1,5,2,5,3
103,Robert Andrich,de,MF,,Leverkusen,Bundesliga,30,1994,9.3,15,7,5,10,0,4,9,44.4,5,6,3,3,15,30,11
104,Angeliño,es,DF,,Roma,Serie A,27,1997,15.0,26,10,10,14,2,9,13,69.2,4,17,6,11,11,37,37
105,Lorenzo Anghelè,it,FW,,Juventus,Serie A,19,2005,0.1,0,0,0,0,0,0,0,,0,0,0,0,0,0,0
106,Faustino Anjorin,eng,MF,,Empoli,Serie A,23,2001,7.4,15,6,3,8,4,1,9,11.1,8,11,3,8,7,22,14
107,Waldemar Anton,de,DF,,Dortmund,Bundesliga,28,1996,8.7,15,12,7,5,3,7,9,77.8,2,17,10,7,7,22,31
108,Michail Antonio,jm,FW,,West Ham,Premier League,34,1990,9.3,2,2,0,1,1,2,3,66.7,1,6,0,6,0,2,2
109,Antoniu,es,MF,DF,Espanyol,La Liga,22,2002,1.5,6,3,1,2,3,2,3,66.7,1,2,0,2,1,7,2
110,Antony,br,FW,MF,Manchester Utd,Premier League,24,2000,0.6,2,0,2,0,0,1,3,33.3,2,1,0,1,2,4,0
111,Anuar,ma,FW,MF,Valladolid,La Liga,29,1995,5.7,10,7,6,2,2,2,9,22.2,7,7,2,5,6,16,6
112,Dennis Appiah,fr,DF,,Saint-Étienne,Ligue 1,32,1992,11.3,29,21,15,12,2,16,32,50.0,16,13,5,8,10,39,34
113,Aritz Arambarri,es,DF,,Leganés,La Liga,26,1998,2.0,1,1,1,0,0,1,1,100.0,0,2,2,0,3,4,8
114,Mauro Arambarri,uy,MF,,Getafe,La Liga,29,1995,11.7,14,6,1,9,4,7,16,43.8,9,11,1,10,4,18,16
115,Jon Aramburu,ve,DF,,Real Sociedad,La Liga,22,2002,12.3,50,37,29,16,5,34,54,63.0,20,19,3,16,17,67,43
116,Julian Araujo,mx,DF,,Bournemouth,Premier League,23,2001,3.9,7,3,3,4,0,4,10,40.0,6,3,0,3,4,11,13
117,Cameron Archer,eng,FW,,Southampton,Premier League,23,2001,9.5,8,5,4,2,2,1,4,25.0,3,5,1,4,2,10,3
118,Carlens Arcus,ht,DF,,Angers,Ligue 1,28,1996,13.0,34,21,22,11,1,23,38,60.5,15,14,2,12,18,52,45
119,Alphonse Areola,fr,GK,,West Ham,Premier League,31,1993,7.5,1,1,1,0,0,1,2,50.0,1,0,0,0,0,1,5
120,Adu Ares,es,FW,,Athletic Club,La Liga,23,2001,0.2,0,0,0,0,0,0,1,0.0,1,0,0,0,0,0,0
121,Jesús Areso,es,DF,,Osasuna,La Liga,25,1999,15.7,26,19,18,5,3,21,31,67.7,10,17,3,14,6,32,47
122,David Argüelles,es,MF,,Getafe,La Liga,22,2002,0.1,0,0,0,0,0,0,0,,0,2,0,2,0,0,0
123,Joe Aribo,ng,MF,,Southampton,Premier League,28,1996,10.0,18,12,6,7,5,7,16,43.8,9,10,5,5,9,27,14
124,Adam Armstrong,eng,FW,MF,Southampton,Premier League,27,1997,9.5,9,2,1,5,3,3,12,25.0,9,4,1,3,3,12,5
125,Harrison Armstrong,eng,MF,,Everton,Premier League,17,2007,0.0,0,0,0,0,0,0,1,0.0,1,0,0,0,0,0,0
126,José Arnaiz,es,FW,,Osasuna,La Liga,29,1995,0.4,2,2,1,1,0,1,2,50.0,1,0,0,0,1,3,1
127,Hákon Arnar Haraldsson,is,MF,,Lille,Ligue 1,21,2003,3.8,12,5,3,7,2,5,9,55.6,4,2,1,1,3,15,0
128,Marko Arnautović,at,FW,,Inter,Serie A,35,1989,0.8,4,3,1,2,1,2,3,66.7,1,0,0,0,1,5,1
129,Maximilian Arnold,de,MF,,Wolfsburg,Bundesliga,30,1994,12.4,19,11,6,11,2,10,18,55.6,8,12,7,5,10,29,30
130,Jann-Fiete Arp,de,FW,,Holstein Kiel,Bundesliga,24,2000,3.8,5,4,3,1,1,1,5,20.0,4,2,0,2,0,5,1
131,Kepa Arrizabalaga,es,GK,,Bournemouth,Premier League,30,1994,11.0,0,0,0,0,0,0,1,0.0,1,0,0,0,0,0,4
132,Arthur,br,DF,,Leverkusen,Bundesliga,21,2003,2.2,5,3,2,2,1,1,4,25.0,3,2,0,2,3,8,8
133,Takuma Asano,jp,FW,,Mallorca,La Liga,30,1994,3.6,5,3,1,3,1,2,3,66.7,1,3,0,3,2,7,4
134,Raúl Asencio,es,DF,,Real Madrid,La Liga,21,2003,3.8,6,4,6,0,0,1,2,50.0,1,0,0,0,3,9,23
135,Marco Asensio,es,FW,MF,Paris S-G,Ligue 1,28,1996,6.8,4,3,1,3,0,0,6,0.0,6,1,0,1,0,4,1
136,Kristjan Asllani,al,MF,,Inter,Serie A,22,2002,3.1,5,0,4,1,0,2,8,25.0,6,6,1,5,2,7,7
137,Iago Aspas,es,FW,MF,Celta Vigo,La Liga,37,1987,13.4,11,7,4,4,3,8,16,50.0,8,13,1,12,6,17,4
138,Yaser Asprilla,co,FW,MF,Girona,La Liga,21,2003,6.4,10,5,4,4,2,4,9,44.4,5,3,0,3,3,13,4
139,Lorenz Assignon,tg,DF,MF,Rennes,Ligue 1,24,2000,9.5,18,11,9,8,1,8,21,38.1,13,10,3,7,12,30,38
140,Dehmaine Assoumani,fr,MF,FW,Nantes,Ligue 1,19,2005,0.4,5,2,0,3,2,3,3,100.0,0,0,0,0,1,6,1
141,Valentin Atangana Edoa,fr,MF,,Reims,Ligue 1,19,2005,13.7,31,23,15,13,3,12,16,75.0,4,12,4,8,17,48,24
142,Arthur Atta,fr,MF,,Udinese,Serie A,21,2003,1.4,4,2,1,2,1,2,3,66.7,1,1,1,0,0,4,0
143,Noah Atubolu,de,GK,,Freiburg,Bundesliga,22,2002,12.0,0,0,0,0,0,0,0,,0,0,0,0,0,0,7
144,Emil Audero,it,GK,,Como,Serie A,27,1997,8.0,0,0,0,0,0,0,1,0.0,1,0,0,0,0,0,4
145,Tommaso Augello,it,DF,,Cagliari,Serie A,30,1994,12.7,22,12,12,7,3,13,20,65.0,7,12,4,8,11,33,47
146,Carlos Augusto,br,DF,,Inter,Serie A,25,1999,3.2,4,3,2,1,1,2,4,50.0,2,2,2,0,2,6,8
147,Yann Aurel Bisseck,de,DF,,Inter,Serie A,24,2000,6.8,5,3,4,1,0,3,4,75.0,1,6,2,4,5,10,21
148,Ezequiel Ávila,ar,FW,,Betis,La Liga,30,1994,6.4,7,3,1,2,4,3,8,37.5,5,4,0,4,1,8,5
149,Taiwo Awoniyi,ng,FW,,Nott'ham Forest,Premier League,27,1997,2.3,2,1,0,1,1,1,1,100.0,0,1,0,1,0,2,3
150,Yasin Ayari,se,MF,,Brighton,Premier League,21,2003,8.9,32,15,5,21,6,14,26,53.8,12,8,2,6,8,40,10
151,Florian Ayé,fr,FW,,Auxerre,Ligue 1,27,1997,3.5,2,2,0,0,2,0,1,0.0,1,3,0,3,3,5,5
152,André Ayew,gh,FW,,Le Havre,Ligue 1,35,1989,5.6,6,4,1,3,2,3,5,60.0,2,2,1,1,1,7,4
153,Jordan Ayew,gh,FW,MF,Crystal Palace,Premier League,33,1991,0.2,1,0,0,0,1,0,0,,0,0,0,0,0,1,0
154,Jordan Ayew,gh,FW,MF,Leicester City,Premier League,33,1991,7.3,11,5,3,6,2,2,8,25.0,6,6,0,6,7,18,3
155,Neil El Aynaoui,fr,MF,,Lens,Ligue 1,23,2001,3.2,11,8,9,2,0,4,14,28.6,10,7,3,4,2,13,5
156,Ayman Azhil,ma,MF,,Dortmund,Bundesliga,23,2001,0.3,1,1,1,0,0,0,0,,0,0,0,0,0,1,0
157,Adam Aznou,ma,DF,,Bayern Munich,Bundesliga,18,2006,0.1,0,0,0,0,0,0,0,,0,0,0,0,0,0,0
158,César Azpilicueta,es,DF,,Atlético Madrid,La Liga,35,1989,5.3,12,5,6,4,2,10,14,71.4,4,2,1,1,2,14,14
159,Paulo Azzi,br,DF,,Cagliari,Serie A,30,1994,4.7,11,9,3,6,2,5,9,55.6,4,5,2,3,5,16,11
160,Papa Ba,es,MF,,Girona,La Liga,20,2004,0.5,1,1,1,0,0,0,0,,0,1,0,1,0,1,1
161,Shavy Babicka,ga,MF,FW,Toulouse,Ligue 1,24,2000,5.6,12,9,3,5,4,7,11,63.6,4,9,0,9,1,13,3
162,Aliou Badara Baldé,gn,MF,FW,Bochum,Bundesliga,22,2002,1.0,1,1,1,0,0,0,0,,0,2,0,2,0,1,0
163,Loïc Bade,fr,DF,,Sevilla,La Liga,24,2000,12.2,26,15,19,7,0,11,15,73.3,4,11,7,4,13,39,59
164,Milan Badelj,hr,MF,,Genoa,Serie A,35,1989,11.0,20,10,10,5,5,9,23,39.1,14,14,6,8,14,34,30
165,Benoît Badiashile,fr,DF,,Chelsea,Premier League,23,2001,2.8,6,4,3,3,0,2,2,100.0,0,2,2,0,6,12,6
166,Alex Baena,es,MF,FW,Villarreal,La Liga,23,2001,13.2,9,4,2,5,2,2,11,18.2,9,18,2,16,14,23,9
167,Leon Bailey,jm,FW,MF,Aston Villa,Premier League,27,1997,8.1,3,1,0,1,2,0,3,0.0,3,6,0,6,2,5,7
168,Eric Bailly,ci,DF,,Villarreal,La Liga,30,1994,6.4,11,3,5,6,0,2,3,66.7,1,11,6,5,6,17,24
169,Theo Bair,ca,FW,,Auxerre,Ligue 1,25,1999,4.6,2,1,0,1,1,0,0,,0,5,2,3,0,2,5
170,Cédric Bakambu,cd,FW,,Betis,La Liga,33,1991,3.0,1,0,0,1,0,0,1,0.0,1,4,0,4,0,1,1
171,Mitchel Bakker,nl,MF,,Atalanta,Serie A,24,2000,0.2,1,0,1,0,0,1,1,100.0,0,0,0,0,0,1,0
172,Mitchel Bakker,nl,DF,FW,Lille,Ligue 1,24,2000,4.3,14,11,5,6,3,6,11,54.5,5,3,0,3,7,21,9
173,Ridle Baku,de,FW,MF,Wolfsburg,Bundesliga,26,1998,12.0,20,13,7,8,5,5,15,33.3,10,22,1,21,15,35,14
174,Dilane Bakwa,fr,FW,MF,Strasbourg,Ligue 1,22,2002,14.5,13,9,7,3,3,6,14,42.9,8,13,0,13,6,19,16
175,Tommaso Baldanzi,it,MF,FW,Roma,Serie A,21,2003,4.3,6,1,3,1,2,1,4,25.0,3,2,0,2,4,10,2
176,Alejandro Balde,es,DF,,Barcelona,La Liga,21,2003,13.3,8,4,4,3,1,4,7,57.1,3,10,4,6,5,13,12
177,Carlos Baleba,cm,MF,,Brighton,Premier League,20,2004,10.0,27,15,5,14,8,16,27,59.3,11,16,3,13,22,49,6
178,Leonardo Balerdi,ar,DF,,Marseille,Ligue 1,25,1999,11.0,18,14,13,4,1,11,20,55.0,9,16,10,6,14,32,32
179,Iván Balliu,al,DF,,Rayo Vallecano,La Liga,32,1992,7.0,10,8,2,5,3,3,10,30.0,7,4,1,3,6,16,19
180,Botond Balogh,hu,DF,,Parma,Serie A,22,2002,13.8,23,9,16,7,0,12,16,75.0,4,26,20,6,17,40,83
181,Folarin Balogun,us,FW,,Monaco,Ligue 1,23,2001,5.2,0,0,0,0,0,0,2,0.0,2,0,0,0,0,0,0
182,Mario Balotelli,it,FW,MF,Genoa,Serie A,34,1990,0.6,0,0,0,0,0,0,0,,0,0,0,0,0,0,1
183,Abdoulaye Bamba,ci,DF,,Angers,Ligue 1,34,1990,6.8,12,6,10,2,0,7,9,77.8,2,5,3,2,7,19,31
184,Jonathan Bamba,ci,FW,MF,Celta Vigo,La Liga,28,1996,8.3,10,5,3,5,2,4,10,40.0,6,6,0,6,5,15,6
185,Mohamed Bamba,ci,MF,,Reims,Ligue 1,20,2004,0.0,0,0,0,0,0,0,0,,0,1,0,1,0,0,0
186,Samuel Bamba,de,FW,MF,Bochum,Bundesliga,20,2004,0.1,0,0,0,0,0,0,0,,0,0,0,0,0,0,0
187,Lameck Banda,zm,FW,MF,Lecce,Serie A,23,2001,5.6,5,4,4,1,0,3,10,30.0,7,6,0,6,1,6,6
188,Daniel Bandeira,pt,MF,,Hellas Verona,Serie A,24,2000,4.5,4,0,1,3,0,3,6,50.0,3,2,1,1,6,10,8
189,Mattia Bani,it,DF,,Genoa,Serie A,31,1993,7.9,5,2,4,1,0,2,4,50.0,2,6,3,3,12,17,31
190,Scott Banks,sct,FW,MF,St. Pauli,Bundesliga,23,2001,0.6,0,0,0,0,0,0,2,0.0,2,0,0,0,1,1,2
191,Antonín Barák,cz,MF,,Fiorentina,Serie A,30,1994,0.6,2,0,0,2,0,0,2,0.0,2,1,1,0,0,2,0
192,Federico Barba,it,DF,,Como,Serie A,31,1993,4.6,1,1,0,1,0,0,3,0.0,3,2,2,0,4,5,14
193,Valentín Barco,ar,DF,FW,Sevilla,La Liga,20,2004,3.2,15,9,8,3,4,12,15,80.0,3,0,0,0,2,17,5
194,Bradley Barcola,fr,FW,,Paris S-G,Ligue 1,22,2002,11.0,12,6,5,5,2,1,12,8.3,11,11,0,11,7,19,3
195,Melvin Bard,fr,DF,MF,Nice,Ligue 1,24,2000,6.5,21,11,16,5,0,9,14,64.3,5,11,6,5,7,28,15
196,Nicolò Barella,it,MF,,Inter,Serie A,27,1997,10.5,18,10,6,9,3,6,22,27.3,16,11,0,11,5,23,4
197,Gabriel Bares,ch,MF,DF,Montpellier,Ligue 1,24,2000,0.6,2,2,2,0,0,1,2,50.0,1,0,0,0,1,3,3
198,Kike Barja,es,FW,,Osasuna,La Liga,27,1997,0.1,0,0,0,0,0,0,0,,0,0,0,0,1,1,0
199,Ross Barkley,eng,MF,,Aston Villa,Premier League,31,1993,5.0,9,2,4,5,0,7,10,70.0,3,7,2,5,5,14,4
200,Aymen Barkok,ma,MF,,Mainz 05,Bundesliga,26,1998,0.8,2,1,1,1,0,1,1,100.0,0,1,1,0,2,4,0
201,Harvey Barnes,eng,FW,,Newcastle Utd,Premier League,27,1997,8.0,8,5,3,3,2,3,5,60.0,2,3,0,3,4,12,5
202,Enzo Barrenechea,ar,MF,,Valencia,La Liga,23,2001,6.2,12,5,6,4,2,3,9,33.3,6,9,2,7,5,17,12
203,Ander Barrenetxea,es,MF,FW,Real Sociedad,La Liga,22,2001,6.5,11,10,3,6,2,2,11,18.2,9,9,0,9,6,17,12
204,Pablo Barrios,es,MF,,Atlético Madrid,La Liga,21,2003,10.8,19,12,7,11,1,6,16,37.5,10,5,1,4,14,33,12
205,Thierno Barry,fr,FW,,Villarreal,La Liga,22,2002,10.6,4,3,1,2,1,1,4,25.0,3,5,0,5,0,4,6
206,Davide Bartesaghi,it,DF,,Milan,Serie A,18,2005,0.1,0,0,0,0,0,0,0,,0,0,0,0,0,0,0
207,Marc Bartra,es,DF,,Betis,La Liga,33,1991,9.3,11,7,9,2,0,6,8,75.0,2,12,7,5,20,31,52
208,Federico Baschirotto,it,DF,,Lecce,Serie A,28,1996,16.0,20,16,14,4,2,12,15,80.0,3,23,18,5,14,34,67
209,Daniele Baselli,it,MF,,Como,Serie A,32,1992,0.2,0,0,0,0,0,0,0,,0,0,0,0,1,1,1
210,Calvin Bassey,ng,DF,,Fulham,Premier League,24,1999,15.0,16,11,12,4,0,6,9,66.7,3,27,13,14,7,23,50
211,Aboubacar Bassinga,ci,MF,,Las Palmas,La Liga,19,2005,0.0,0,0,0,0,0,0,0,,0,0,0,0,0,0,0
212,Alessandro Bastoni,it,DF,,Inter,Serie A,25,1999,11.7,21,13,9,9,3,10,15,66.7,5,10,4,6,9,30,15
213,Augusto Batalla,ar,GK,,Rayo Vallecano,La Liga,28,1996,12.0,0,0,0,0,0,0,1,0.0,1,0,0,0,0,0,4
214,Dylan Batubinsika,cd,DF,,Saint-Étienne,Ligue 1,28,1996,13.6,15,8,11,3,1,7,13,53.8,6,16,8,8,29,44,72
215,Maximilian Bauer,de,DF,,Augsburg,Bundesliga,24,2000,6.0,12,7,4,7,1,8,13,61.5,5,9,3,6,6,18,31
216,Oliver Baumann,de,GK,,Hoffenheim,Bundesliga,34,1990,14.0,0,0,0,0,0,0,1,0.0,1,0,0,0,0,0,7
217,Christoph Baumgartner,at,MF,,RB Leipzig,Bundesliga,25,1999,8.0,18,13,3,10,5,6,22,27.3,16,19,5,14,6,24,8
218,Rafael Bauza,es,MF,,Espanyol,La Liga,19,2005,1.7,4,2,2,1,1,3,5,60.0,2,3,1,2,0,4,4
219,Adrian Beck,de,FW,MF,Heidenheim,Bundesliga,27,1997,4.8,16,6,11,5,0,5,15,33.3,10,16,1,15,4,20,10
220,Sheraldo Becker,sr,MF,FW,Real Sociedad,La Liga,29,1995,7.1,2,2,0,2,0,0,2,0.0,2,4,0,4,1,3,8
221,Timo Becker,de,DF,,Holstein Kiel,Bundesliga,27,1997,11.5,19,12,14,5,0,13,19,68.4,6,9,6,3,7,26,32
222,Jan Bednarek,pl,DF,,Southampton,Premier League,28,1996,11.9,8,4,6,2,0,3,9,33.3,6,20,17,3,18,26,63
223,Donny van de Beek,nl,MF,,Girona,La Liga,27,1997,8.8,20,11,12,4,4,9,15,60.0,6,9,2,7,4,24,7
224,Kevin Behrens,de,FW,,Wolfsburg,Bundesliga,33,1991,1.2,1,1,0,1,0,0,1,0.0,1,0,0,0,0,1,1
225,Maximilian Beier,de,FW,MF,Dortmund,Bundesliga,22,2002,7.8,15,10,5,6,4,5,16,31.3,11,9,0,9,5,20,5
226,Reda Belahyane,ma,MF,,Hellas Verona,Serie A,20,2004,13.9,26,18,10,10,6,9,11,81.8,2,15,4,11,7,33,13
227,Haris Belkebla,dz,MF,,Angers,Ligue 1,30,1994,10.0,19,13,13,5,1,9,18,50.0,9,12,2,10,16,35,21
228,Yassin Belkhdim,fr,MF,FW,Angers,Ligue 1,22,2002,6.4,30,15,13,11,6,13,29,44.8,16,11,2,9,9,39,13
229,Stefan Bell,de,DF,,Mainz 05,Bundesliga,33,1991,7.8,9,4,7,2,0,3,6,50.0,3,6,6,0,18,27,45
230,Raoul Bellanova,it,DF,,Torino,Serie A,24,2000,1.0,0,0,0,0,0,0,1,0.0,1,0,0,0,0,0,4
231,Raoul Bellanova,it,DF,,Atalanta,Serie A,24,2000,10.6,7,5,2,4,1,3,6,50.0,3,6,2,4,10,17,10
232,Jean-Ricner Bellegarde,fr,MF,FW,Wolves,Premier League,26,1998,8.1,10,6,4,4,2,4,6,66.7,2,9,2,7,6,16,7
233,Héctor Bellerín,es,DF,,Betis,La Liga,29,1995,5.8,12,7,6,4,2,9,16,56.3,7,4,3,1,6,18,18
234,Jude Bellingham,eng,MF,,Real Madrid,La Liga,21,2003,11.8,28,15,12,11,5,14,19,73.7,5,20,2,18,13,41,11
235,Jeanuël Belocian,fr,DF,MF,Leverkusen,Bundesliga,19,2005,0.7,1,1,1,0,0,1,1,100.0,0,0,0,0,0,1,2
236,Andrea Belotti,it,FW,,Como,Serie A,30,1993,5.2,6,4,1,4,1,0,3,0.0,3,3,0,3,1,7,7
237,Fran Beltrán,es,MF,,Celta Vigo,La Liga,25,1999,10.9,23,15,12,8,3,11,24,45.8,13,12,4,8,7,30,16
238,Lucas Beltrán,ar,MF,FW,Fiorentina,Serie A,23,2001,7.7,10,6,3,5,2,3,6,50.0,3,7,1,6,3,13,3
239,Eliesse Ben Seghir,ma,MF,FW,Monaco,Ligue 1,19,2005,10.6,17,13,5,8,4,10,17,58.8,7,11,0,11,6,23,1
240,Carlos Benavídez,uy,MF,,Alavés,La Liga,26,1998,2.6,5,3,2,2,1,0,3,0.0,3,1,1,0,6,11,3
241,Adrian Benedyczak,pl,FW,,Parma,Serie A,24,2000,1.3,0,0,0,0,0,0,1,0.0,1,1,1,0,0,0,2
242,László Bénes,sk,MF,FW,Union Berlin,Bundesliga,27,1997,2.1,1,1,0,1,0,0,1,0.0,1,2,1,1,0,1,1
243,Iker Benito,es,FW,MF,Osasuna,La Liga,22,2002,0.4,0,0,0,0,0,0,1,0.0,1,0,0,0,1,1,2
244,Ismaël Bennacer,dz,MF,,Milan,Serie A,27,1997,0.6,1,1,0,1,0,0,0,,0,0,0,0,0,1,0
245,Saïd Benrahma,dz,FW,MF,Lyon,Ligue 1,29,1995,6.6,7,4,3,3,1,2,7,28.6,5,6,0,6,2,9,1
246,Ramy Bensebaini,dz,DF,,Dortmund,Bundesliga,29,1995,8.8,24,11,14,8,2,14,21,66.7,7,22,2,20,11,35,23
247,Rodrigo Bentancur,uy,MF,,Tottenham,Premier League,27,1997,5.9,19,9,9,9,1,11,16,68.8,5,5,0,5,16,35,5
248,Lucas Beraldo,br,DF,,Paris S-G,Ligue 1,21,2003,9.1,16,14,12,4,0,10,20,50.0,10,6,2,4,8,24,15
249,Yuri Berchiche,es,DF,,Athletic Club,La Liga,34,1990,11.6,16,9,10,5,1,8,16,50.0,8,12,2,10,10,26,32
250,Álex Berenguer,es,FW,MF,Athletic Club,La Liga,29,1995,11.0,13,5,2,7,4,9,14,64.3,5,5,2,3,5,18,6
251,Sander Berge,no,MF,,Fulham,Premier League,26,1998,9.8,26,16,11,13,2,13,21,61.9,8,11,5,6,14,40,16
252,Lucas Bergvall,se,MF,,Tottenham,Premier League,18,2006,1.9,7,4,1,4,2,6,9,66.7,3,1,1,0,5,12,1
253,Medon Berisha,al,MF,,Lecce,Serie A,21,2003,1.8,2,1,1,1,0,1,2,50.0,1,0,0,0,1,3,2
254,Mergim Berisha,de,FW,MF,Hoffenheim,Bundesliga,26,1998,3.6,3,3,1,2,0,0,3,0.0,3,2,1,1,0,3,3
255,Adrian Bernabe,es,MF,,Parma,Serie A,23,2001,10.0,21,13,14,6,1,12,26,46.2,14,18,9,9,6,27,16
256,Marc Bernal,es,MF,,Barcelona,La Liga,17,2007,2.7,8,6,2,5,1,7,8,87.5,1,5,1,4,1,9,4
257,Bernardo,br,DF,,Bochum,Bundesliga,29,1995,2.8,10,5,9,1,0,7,8,87.5,1,6,3,3,4,14,7
258,Juan Bernat,es,DF,MF,Villarreal,La Liga,31,1993,2.0,7,5,6,0,1,3,4,75.0,1,3,1,2,1,8,2
259,Alexander Bernhardsson,se,DF,FW,Holstein Kiel,Bundesliga,26,1998,2.7,2,1,0,0,2,2,4,50.0,2,3,0,3,0,2,4
260,Victor Bernth Kristiansen,dk,DF,,Leicester City,Premier League,22,2002,13.5,50,31,35,14,1,28,48,58.3,20,23,10,13,16,66,37
261,Matúš Bero,sk,MF,,Bochum,Bundesliga,29,1995,11.2,19,8,8,7,4,8,26,30.8,18,18,3,15,8,27,8
262,Juan Berrocal,es,DF,,Getafe,La Liga,25,1999,6.3,11,4,9,2,0,8,11,72.7,3,1,1,0,8,19,29
263,Dimitry Bertaud,cd,GK,,Montpellier,Ligue 1,26,1998,3.0,0,0,0,0,0,0,0,,0,0,0,0,0,0,2
264,Beto,gw,FW,,Everton,Premier League,26,1998,2.1,2,0,0,1,1,0,1,0.0,1,1,0,1,0,2,2
265,Sam Beukema,nl,DF,,Bologna,Serie A,26,1998,14.5,15,5,6,8,1,4,14,28.6,10,15,12,3,13,28,43
266,Alessandro Bianco,it,MF,,Monza,Serie A,22,2002,10.1,21,14,6,11,4,14,18,77.8,4,11,2,9,6,27,16
267,Alessandro Bianco,it,MF,,Fiorentina,Serie A,22,2002,0.2,0,0,0,0,0,0,1,0.0,1,0,0,0,0,0,0
268,Jaka Bijol,si,DF,,Udinese,Serie A,25,1999,15.0,21,13,14,7,0,12,22,54.5,10,18,9,9,17,38,75
269,El Bilal Touré,ml,FW,MF,Stuttgart,Bundesliga,23,2001,3.5,3,1,1,1,1,3,3,100.0,0,1,0,1,0,3,1
270,Philip Billing,dk,MF,,Bournemouth,Premier League,28,1996,0.8,8,2,4,4,0,1,1,100.0,0,1,0,1,2,10,1
271,Cristiano Biraghi,it,DF,,Fiorentina,Serie A,32,1992,4.8,4,4,1,3,0,2,7,28.6,5,2,0,2,4,8,11
272,Samuele Birindelli,it,DF,,Monza,Serie A,25,1999,3.3,8,6,2,3,3,2,4,50.0,2,2,1,1,0,8,6
273,Tom Bischof,de,MF,,Hoffenheim,Bundesliga,19,2005,10.4,49,26,15,28,6,19,33,57.6,14,25,5,20,12,61,19
274,Yves Bissouma,ml,MF,,Tottenham,Premier League,28,1996,8.2,26,17,11,13,2,14,22,63.6,8,5,2,3,10,36,18
275,Leonardo Bittencourt,de,MF,,Werder Bremen,Bundesliga,30,1993,5.3,8,3,4,3,1,3,8,37.5,5,6,0,6,7,15,7
276,Emmanuel Biumla,fr,DF,,Angers,Ligue 1,19,2005,8.1,14,7,10,4,0,9,14,64.3,5,11,5,6,6,20,37
277,Marco Bizot,nl,GK,,Brest,Ligue 1,33,1991,14.0,1,1,1,0,0,0,0,,0,0,0,0,0,1,11
278,Bjarki Bjarkason,is,DF,,Venezia,Serie A,24,2000,0.0,0,0,0,0,0,0,0,,0,0,0,0,0,0,0
279,Antonio Blanco,es,MF,,Alavés,La Liga,24,2000,12.1,28,18,10,18,0,14,30,46.7,16,14,5,9,21,49,20
280,Ludovic Blas,fr,MF,FW,Rennes,Ligue 1,26,1997,13.5,18,13,3,6,9,12,23,52.2,11,11,2,9,4,22,3
281,Daley Blind,nl,DF,,Girona,La Liga,34,1990,12.1,19,9,9,9,1,12,17,70.6,5,16,6,10,13,32,36
282,Myron Boadu,nl,FW,,Bochum,Bundesliga,23,2001,3.9,0,0,0,0,0,0,1,0.0,1,1,0,1,0,0,3
283,Augustine Boakye,gh,MF,FW,Saint-Étienne,Ligue 1,24,2000,3.7,4,2,1,3,0,2,8,25.0,6,1,0,1,4,8,2
284,Sacha Boey,fr,DF,,Bayern Munich,Bundesliga,24,2000,3.1,10,3,4,2,4,5,7,71.4,2,3,0,3,1,11,4
285,Jeremie Boga,ci,MF,FW,Nice,Ligue 1,27,1997,6.9,6,4,1,5,0,2,3,66.7,1,9,0,9,2,8,1
286,Lamare Bogarde,nl,DF,,Aston Villa,Premier League,20,2004,2.4,8,4,2,5,1,5,9,55.6,4,2,0,2,1,9,4
287,Emil Bohinen,no,MF,,Genoa,Serie A,25,1999,1.8,4,4,3,0,1,2,5,40.0,3,2,0,2,1,5,6
288,Adama Boiro,es,DF,,Athletic Club,La Liga,22,2002,5.2,10,4,4,4,2,4,7,57.1,3,5,3,2,6,16,16
289,Willy Boly,ci,DF,,Nott'ham Forest,Premier League,33,1991,1.0,5,1,4,1,0,4,4,100.0,0,3,1,2,1,6,11
290,Moïse Bombito,ca,DF,,Nice,Ligue 1,24,2000,12.7,17,12,9,8,0,14,21,66.7,7,18,10,8,9,26,67
291,Warren Bondo,fr,MF,,Monza,Serie A,21,2003,13.9,26,17,16,7,3,10,15,66.7,5,15,6,9,5,31,5
292,Victor Boniface,ng,FW,,Leverkusen,Bundesliga,23,2000,7.3,4,3,0,3,1,2,2,100.0,0,1,0,1,0,4,4
293,Ange-Yoan Bonny,fr,FW,,Parma,Serie A,21,2003,12.3,14,8,2,9,3,4,8,50.0,4,6,0,6,0,14,5
294,Sebastiaan Bornauw,be,DF,,Wolfsburg,Bundesliga,25,1999,7.0,7,4,2,4,1,2,6,33.3,4,13,12,1,9,16,26
295,Saïmon Bouabré,fr,MF,,Monaco,Ligue 1,18,2006,0.1,0,0,0,0,0,0,2,0.0,2,1,0,1,0,0,0
296,Ayyoub Bouaddi,fr,MF,,Lille,Ligue 1,17,2007,5.8,23,15,12,6,5,7,13,53.8,6,4,0,4,6,29,4
297,Badredine Bouanani,dz,MF,FW,Nice,Ligue 1,20,2004,5.5,3,1,1,1,1,0,5,0.0,5,9,2,7,3,6,3
298,Benjamin Bouchouari,ma,MF,,Saint-Étienne,Ligue 1,23,2001,7.2,14,11,5,6,3,9,18,50.0,9,7,1,6,8,22,6
299,Hicham Boudaoui,dz,MF,,Nice,Ligue 1,25,1999,10.9,35,19,15,14,6,15,26,57.7,11,17,4,13,12,47,23
300,Carlo Boukhalfa,ma,MF,,St. Pauli,Bundesliga,25,1999,9.3,17,5,4,12,1,4,7,57.1,3,10,1,9,7,24,9
301,Benjamin Bourigeaud,fr,MF,,Rennes,Ligue 1,30,1994,0.9,1,0,0,1,0,0,2,0.0,2,2,1,1,2,3,1
302,Edoardo Bove,it,MF,FW,Fiorentina,Serie A,22,2002,9.3,24,17,7,14,3,14,28,50.0,14,12,0,12,6,30,8
303,Jarrod Bowen,eng,FW,MF,West Ham,Premier League,27,1996,15.7,22,12,8,5,9,10,24,41.7,14,11,2,9,10,32,16
304,Enzo Boyomo,cm,DF,,Osasuna,La Liga,23,2001,14.0,28,18,20,6,2,13,16,81.3,3,19,12,7,15,43,65
305,Enzo Boyomo,cm,DF,,Valladolid,La Liga,23,2001,3.0,6,2,4,2,0,3,3,100.0,0,4,3,1,1,7,7
306,Domagoj Bradarić,hr,DF,,Hellas Verona,Serie A,25,1999,6.4,12,9,10,1,1,7,12,58.3,5,5,2,3,2,14,18
307,Conor Bradley,nir,DF,,Liverpool,Premier League,21,2003,2.6,3,2,1,1,1,3,9,33.3,6,0,0,0,2,5,11
308,Bilal Brahimi,dz,MF,,Nice,Ligue 1,24,2000,0.8,0,0,0,0,0,0,0,,0,1,0,1,0,0,2
309,Julian Brandt,de,MF,,Dortmund,Bundesliga,28,1996,9.9,8,3,4,3,1,5,14,35.7,9,6,0,6,3,11,6
310,Jarrad Branthwaite,eng,DF,,Everton,Premier League,22,2002,6.1,11,6,8,3,0,5,7,71.4,2,6,2,4,10,21,26
311,Darko Brašanac,rs,MF,,Leganés,La Liga,32,1992,9.3,13,5,2,6,5,4,9,44.4,5,10,6,4,7,20,25
312,Lilian Brassier,fr,DF,,Marseille,Ligue 1,25,1999,7.0,6,5,6,0,0,3,4,75.0,1,7,2,5,4,10,25
313,Matthias Braunöder,at,MF,,Como,Serie A,22,2002,3.0,10,4,6,3,1,7,11,63.6,4,3,0,3,2,12,4
314,Iker Bravo,es,FW,MF,Udinese,Serie A,19,2005,2.6,5,3,1,4,0,2,3,66.7,1,0,0,0,0,5,2
315,James Bree,eng,DF,,Southampton,Premier League,27,1997,1.5,3,1,0,3,0,1,2,50.0,1,1,1,0,1,4,5
316,Tim Breithaupt,de,MF,,Augsburg,Bundesliga,22,2002,1.3,1,1,0,1,0,0,4,0.0,4,1,0,1,2,3,0
317,Gleison Bremer,br,DF,,Juventus,Serie A,27,1997,6.0,15,7,9,5,1,4,5,80.0,1,15,11,4,6,21,16
318,Brenner,br,MF,FW,Udinese,Serie A,24,2000,4.3,6,4,2,3,1,3,8,37.5,5,4,0,4,1,7,6
319,Ben Brereton,cl,FW,,Southampton,Premier League,25,1999,5.0,3,2,0,2,1,1,9,11.1,8,2,1,1,0,3,4
320,Marco Brescianini,it,MF,,Atalanta,Serie A,24,2000,5.6,5,2,1,3,1,2,3,66.7,1,9,1,8,1,6,4
321,Maximilian Breunig,de,FW,MF,Heidenheim,Bundesliga,24,2000,3.6,4,3,1,2,1,3,6,50.0,3,9,2,7,1,5,3
322,Nathan Broadhead,wls,FW,MF,Ipswich Town,Premier League,26,1998,0.4,2,2,1,1,0,1,1,100.0,0,0,0,0,0,2,0
323,Armando Broja,al,FW,,Everton,Premier League,23,2001,0.4,1,0,0,1,0,0,0,,0,0,0,0,0,1,1
324,David Brooks,wls,FW,MF,Bournemouth,Premier League,27,1997,1.9,3,1,0,3,0,1,2,50.0,1,4,1,3,2,5,1
325,Moritz Broschinski,de,FW,MF,Bochum,Bundesliga,24,2000,8.8,11,7,4,4,3,1,9,11.1,8,11,0,11,0,11,10
326,Nathaniel Brown,de,DF,MF,Eint Frankfurt,Bundesliga,21,2003,5.3,15,12,5,6,4,8,12,66.7,4,7,0,7,2,17,16
327,Jacob Bruun Larsen,dk,MF,FW,Hoffenheim,Bundesliga,26,1998,3.6,4,3,1,2,1,3,8,37.5,5,5,1,4,1,5,2
328,Tajon Buchanan,ca,DF,FW,Inter,Serie A,25,1999,0.5,1,0,1,0,0,1,2,50.0,1,0,0,0,0,1,1
329,Ante Budimir,hr,FW,,Osasuna,La Liga,33,1991,14.3,10,5,1,7,2,2,5,40.0,3,11,3,8,1,11,11
330,Emi Buendía,ar,MF,FW,Aston Villa,Premier League,27,1996,0.5,3,3,2,1,0,0,2,0.0,2,4,0,4,0,3,1
331,Manu Bueno,es,MF,,Sevilla,La Liga,20,2004,0.8,2,2,0,0,2,1,1,100.0,0,0,0,0,0,2,2
332,Santiago Bueno,uy,DF,,Wolves,Premier League,26,1998,7.8,12,6,8,4,0,7,10,70.0,3,14,8,6,4,16,24
333,Marius Bülter,de,FW,,Hoffenheim,Bundesliga,31,1993,8.9,6,6,1,4,1,6,8,75.0,2,3,1,2,1,7,4
334,Facundo Buonanotte,ar,MF,FW,Leicester City,Premier League,19,2004,10.2,27,13,9,10,8,12,43,27.9,31,23,5,18,7,34,7
335,Alessandro Buongiorno,it,DF,,Napoli,Serie A,25,1999,15.0,25,16,16,9,0,17,20,85.0,3,21,13,8,24,49,43
336,Cameron Burgess,au,DF,,Ipswich Town,Premier League,29,1995,8.0,6,5,4,2,0,2,2,100.0,0,11,9,2,6,12,58
337,Jonathan Burkardt,de,FW,,Mainz 05,Bundesliga,24,2000,11.7,5,3,1,2,2,1,4,25.0,3,6,1,5,0,5,11
338,Oliver Burke,sct,FW,MF,Werder Bremen,Bundesliga,27,1997,1.1,4,2,1,0,3,1,2,50.0,1,0,0,0,0,4,1
339,Dan Burn,eng,DF,,Newcastle Utd,Premier League,32,1992,15.0,15,9,9,6,0,9,18,50.0,9,14,10,4,9,24,68
340,Wes Burns,wls,FW,,Ipswich Town,Premier League,30,1994,7.3,7,7,1,5,1,3,9,33.3,6,5,1,4,7,14,7
341,Marnon Busch,de,DF,MF,Heidenheim,Bundesliga,30,1994,4.7,8,5,5,3,0,8,11,72.7,3,8,5,3,5,13,21
342,Gianluca Busio,us,MF,,Venezia,Serie A,22,2002,11.6,15,11,9,3,3,8,19,42.1,11,10,2,8,4,19,19
343,Aurélio Buta,pt,DF,,Reims,Ligue 1,27,1997,9.9,25,16,15,8,2,14,25,56.0,11,4,0,4,11,36,24
344,Marcin Bułka,pl,GK,,Nice,Ligue 1,25,1999,15.0,0,0,0,0,0,0,0,,0,0,0,0,0,0,7
345,Pau Cabanes,es,MF,FW,Villarreal,La Liga,19,2005,0.7,3,3,0,2,1,2,2,100.0,0,2,0,2,0,3,1
346,Rémy Cabella,fr,MF,FW,Lille,Ligue 1,34,1990,5.2,17,11,3,8,6,10,16,62.5,6,4,0,4,6,23,1
347,Leandro Cabrera,uy,DF,,Espanyol,La Liga,33,1991,11.0,21,12,16,4,1,8,15,53.3,7,12,6,6,13,34,61
348,Liberato Cacace,nz,MF,DF,Empoli,Serie A,24,2000,6.4,9,4,6,2,1,6,8,75.0,2,10,3,7,1,10,19
349,Anthony Caci,fr,DF,,Mainz 05,Bundesliga,27,1997,12.7,25,15,6,12,7,12,20,60.0,8,12,3,9,12,37,21
350,Mathieu Cafaro,fr,MF,FW,Saint-Étienne,Ligue 1,27,1997,6.8,7,5,3,3,1,2,11,18.2,9,6,1,5,6,13,3
351,Moisés Caicedo,ec,MF,DF,Chelsea,Premier League,23,2001,15.7,49,32,21,23,5,27,41,65.9,14,18,5,13,27,76,20
352,Tom Cairney,sct,MF,,Fulham,Premier League,33,1991,2.0,5,1,1,1,3,1,2,50.0,1,3,1,2,3,8,1
353,Jens Cajuste,se,MF,,Ipswich Town,Premier League,25,1999,6.1,12,4,5,6,1,5,18,27.8,13,9,1,8,5,17,5
354,Davide Calabria,it,DF,,Milan,Serie A,28,1996,1.7,5,3,5,0,0,4,6,66.7,2,0,0,0,3,8,4
355,Riccardo Calafiori,it,DF,,Arsenal,Premier League,22,2002,5.6,15,11,10,4,1,11,17,64.7,6,9,4,5,5,20,17
356,Luca Caldirola,it,DF,,Monza,Serie A,33,1991,4.4,5,3,4,1,0,2,5,40.0,3,4,4,0,2,7,17
357,Fernando Calero,es,DF,,Espanyol,La Liga,29,1995,2.1,4,2,4,0,0,1,2,50.0,1,3,3,0,5,9,20
358,Duje Ćaleta-Car,hr,DF,,Lyon,Ligue 1,28,1996,11.9,14,8,7,7,0,7,13,53.8,6,22,17,5,12,26,60
359,Hakan Çalhanoğlu,tr,MF,,Inter,Serie A,30,1994,7.8,19,8,4,8,7,10,18,55.6,8,2,2,0,4,23,7
360,Dominic Calvert-Lewin,eng,FW,,Everton,Premier League,27,1997,12.9,7,5,1,3,3,0,2,0.0,2,4,1,3,5,12,14
361,Drissa Camara,ci,FW,MF,Parma,Serie A,22,2002,1.0,2,2,1,1,0,0,2,0.0,2,1,0,1,0,2,1
362,Issiaga Camara,gn,MF,,Nice,Ligue 1,19,2005,0.2,2,1,0,2,0,0,1,0.0,1,0,0,0,3,5,0
363,Lamine Camara,sn,MF,,Monaco,Ligue 1,20,2004,9.5,36,25,13,18,5,16,28,57.1,12,19,4,15,18,54,10
364,Mahdi Camara,fr,MF,,Brest,Ligue 1,26,1998,11.6,36,16,5,21,10,11,19,57.9,8,19,2,17,13,49,14
365,Francesco Camarda,it,FW,MF,Milan,Serie A,16,2008,1.2,2,0,0,0,2,1,3,33.3,2,0,0,0,0,2,3
366,Eduardo Camavinga,fr,MF,,Real Madrid,La Liga,22,2002,4.5,10,7,2,7,1,5,10,50.0,5,9,3,6,6,16,6
367,Nicolò Cambiaghi,it,FW,,Bologna,Serie A,23,2000,0.2,1,0,0,1,0,0,0,,0,1,0,1,0,1,0
368,Andrea Cambiaso,it,DF,FW,Juventus,Serie A,24,2000,13.2,22,15,14,5,3,16,24,66.7,8,12,2,10,8,30,16
369,Axel Camblan,fr,MF,FW,Brest,Ligue 1,21,2003,0.3,1,1,0,0,1,1,2,50.0,1,1,0,1,0,1,0
370,Sergio Camello,es,FW,,Rayo Vallecano,La Liga,23,2001,8.8,8,3,2,5,1,3,5,60.0,2,7,1,6,4,12,13
371,José Campaña,es,MF,,Las Palmas,La Liga,31,1993,7.1,11,9,3,6,2,5,9,55.6,4,2,0,2,14,25,12
372,Cole Campbell,is,MF,FW,Dortmund,Bundesliga,18,2006,0.2,0,0,0,0,0,0,0,,0,0,0,0,0,0,1
373,Emre Can,de,MF,DF,Dortmund,Bundesliga,30,1994,7.7,19,10,12,6,1,6,13,46.2,7,8,4,4,4,23,25
374,Peio Canales,es,MF,,Athletic Club,La Liga,19,2005,0.2,1,1,0,0,1,0,0,,0,0,0,0,1,2,1
375,Matteo Cancellieri,it,FW,MF,Parma,Serie A,22,2002,7.7,16,10,10,5,1,4,10,40.0,6,6,0,6,9,25,14
376,Antonio Candela,it,DF,,Venezia,Serie A,24,2000,10.2,27,18,13,9,5,17,23,73.9,6,6,5,1,8,35,15
377,Sergi Canós,es,MF,,Valencia,La Liga,27,1997,2.3,6,4,0,3,3,3,6,50.0,3,2,0,2,2,8,1
378,Jaydee Canvot,fr,DF,,Toulouse,Ligue 1,18,2006,0.1,1,1,1,0,0,1,2,50.0,1,0,0,0,0,1,0
379,Pierrick Capelle,fr,MF,,Angers,Ligue 1,37,1987,2.9,11,7,4,5,2,3,7,42.9,4,1,1,0,4,15,0
380,Gianluca Caprari,it,MF,,Monza,Serie A,31,1993,6.8,9,6,3,5,1,1,4,25.0,3,6,0,6,2,11,1
381,Elia Caprile,it,GK,,Napoli,Serie A,23,2001,3.6,0,0,0,0,0,0,0,,0,0,0,0,0,0,2
382,Francesco Caputo,it,FW,,Empoli,Serie A,37,1987,0.1,0,0,0,0,0,0,0,,0,0,0,0,0,0,0
383,Maxence Caqueret,fr,MF,,Lyon,Ligue 1,24,2000,6.4,21,11,5,11,5,4,22,18.2,18,12,2,10,7,28,2
384,Andrea Carboni,it,DF,,Monza,Serie A,23,2001,11.7,28,15,18,8,2,13,23,56.5,10,16,6,10,16,44,46
385,Franco Carboni,it,DF,,Venezia,Serie A,21,2003,0.1,0,0,0,0,0,0,0,,0,0,0,0,0,0,1
386,Valentin Carboni,ar,MF,FW,Marseille,Ligue 1,19,2005,1.1,2,2,0,1,1,0,1,0.0,1,1,0,1,1,3,1
387,Cárdenas,es,GK,,Rayo Vallecano,La Liga,27,1997,4.0,0,0,0,0,0,0,0,,0,0,0,0,0,0,3
388,Irvin Cardona,fr,FW,MF,Espanyol,La Liga,27,1997,6.3,8,5,2,4,2,6,14,42.9,8,4,1,3,3,11,9
389,Marc Cardona,es,FW,,Las Palmas,La Liga,29,1995,0.8,1,0,0,1,0,0,0,,0,0,0,0,0,1,0
390,Sergi Cardona,es,DF,,Villarreal,La Liga,25,1999,14.7,30,22,16,11,3,21,34,61.8,13,26,5,21,19,49,48
391,Johnny Cardoso,us,MF,,Betis,La Liga,23,2001,7.3,19,12,4,11,4,7,21,33.3,14,9,3,6,19,38,29
392,Patrik Carlgren,se,GK,,Nantes,Ligue 1,32,1992,3.0,0,0,0,0,0,0,0,,0,0,0,0,0,0,0
393,Diego Carlos,br,DF,,Aston Villa,Premier League,31,1993,8.2,7,3,6,1,0,3,5,60.0,2,8,5,3,5,12,32
394,Carmona,es,DF,,Sevilla,La Liga,22,2002,15.7,41,31,26,12,3,19,34,55.9,15,16,4,12,36,77,42
395,Marco Carnesecchi,it,GK,,Atalanta,Serie A,24,2000,15.0,0,0,0,0,0,0,0,,0,1,0,1,0,0,8
396,Sergio Carreira,es,MF,DF,Celta Vigo,La Liga,24,2000,2.6,6,4,3,2,1,2,4,50.0,2,2,0,2,1,7,9
397,Dani Carvajal,es,DF,,Real Madrid,La Liga,32,1992,6.8,12,8,7,3,2,9,12,75.0,3,8,3,5,10,22,19
398,Fabio Carvalho,pt,FW,MF,Brentford,Premier League,22,2002,4.7,13,9,4,4,5,6,13,46.2,7,6,1,5,3,16,2
399,William Carvalho,pt,MF,,Betis,La Liga,32,1992,2.7,3,2,0,3,0,2,4,50.0,2,4,1,3,3,6,4
400,Marc Casado,es,MF,,Barcelona,La Liga,21,2003,12.3,30,17,6,18,6,12,24,50.0,12,16,5,11,12,42,15
401,Nicolò Casale,it,DF,,Bologna,Serie A,26,1998,2.9,3,1,1,2,0,1,2,50.0,1,8,6,2,2,5,7
402,Nicolò Casale,it,DF,,Lazio,Serie A,26,1998,1.5,5,3,4,1,0,0,0,,0,4,3,1,1,6,2
403,Casemiro,br,MF,,Manchester Utd,Premier League,32,1992,8.3,35,22,20,9,6,17,35,48.6,18,20,5,15,7,42,27
404,Kaelan Casey,eng,DF,,West Ham,Premier League,20,2004,0.0,0,0,0,0,0,0,0,,0,0,0,0,0,0,1
405,Matty Cash,pl,DF,FW,Aston Villa,Premier League,27,1997,8.2,22,10,14,7,1,9,15,60.0,6,7,4,3,13,35,23
406,Josué Casimir,fr,FW,DF,Le Havre,Ligue 1,23,2001,7.5,15,9,5,8,2,4,9,44.4,5,7,0,7,1,16,16
407,Federico Cassa,it,MF,FW,Atalanta,Serie A,18,2006,0.2,0,0,0,0,0,0,0,,0,1,0,1,0,0,0
408,Cristian Cásseres Jr.,ve,MF,,Toulouse,Ligue 1,24,2000,12.3,44,30,23,18,3,17,37,45.9,20,16,3,13,19,63,14
409,Timothy Castagne,be,DF,,Fulham,Premier League,29,1995,2.0,5,3,3,2,0,4,7,57.1,3,0,0,0,2,7,13
410,Valentín Castellanos,ar,FW,,Lazio,Serie A,26,1998,12.7,4,2,0,1,3,1,7,14.3,6,10,1,9,3,7,5
411,Jean-Charles Castelletto,cm,DF,,Nantes,Ligue 1,29,1995,12.8,14,6,5,8,1,9,14,64.3,5,8,5,3,9,23,67
412,Santiago Castro,ar,FW,,Bologna,Serie A,20,2004,12.7,9,3,3,5,1,2,7,28.6,5,10,2,8,2,11,11
413,Gaetano Castrovilli,it,MF,FW,Lazio,Serie A,27,1997,1.5,5,2,3,1,1,2,4,50.0,2,2,0,2,3,8,1
414,Danilo Cataldi,it,MF,,Fiorentina,Serie A,30,1994,8.0,17,12,6,9,2,7,15,46.7,8,7,4,3,8,25,14
415,Catena,es,DF,,Osasuna,La Liga,30,1994,16.0,25,14,19,6,0,15,25,60.0,10,17,10,7,18,43,101
416,Maximiliano Caufriez,be,DF,,Valencia,La Liga,27,1997,1.0,1,1,1,0,0,1,1,100.0,0,2,1,1,1,2,4
417,Dani Ceballos,es,MF,,Real Madrid,La Liga,28,1996,4.0,14,6,8,5,1,6,9,66.7,3,4,0,4,4,18,3
418,Zeki Çelik,tr,DF,,Roma,Serie A,27,1997,13.3,29,19,10,12,7,13,23,56.5,10,14,3,11,6,35,37
419,Fabien Centonze,fr,DF,,Nantes,Ligue 1,28,1996,0.9,3,1,1,1,1,1,3,33.3,2,1,0,1,1,4,7
420,Alberto Cerri,it,FW,,Como,Serie A,28,1996,0.9,0,0,0,0,0,0,0,,0,2,0,2,0,0,1
421,Franco Cervi,ar,DF,,Celta Vigo,La Liga,30,1994,0.1,0,0,0,0,0,0,2,0.0,2,0,0,0,1,1,0
422,Julian Chabot,de,DF,,Stuttgart,Bundesliga,26,1998,11.3,17,10,11,5,1,9,20,45.0,11,11,7,4,22,39,57
423,El Chadaille Bitshiabu,fr,DF,,RB Leipzig,Bundesliga,19,2005,2.5,8,4,3,5,0,3,5,60.0,2,4,2,2,5,13,13
424,Fares Chaïbi,dz,MF,FW,Eint Frankfurt,Bundesliga,22,2002,6.1,9,5,4,3,2,5,11,45.5,6,9,0,9,7,16,21
425,Trevoh Chalobah,eng,DF,,Crystal Palace,Premier League,25,1999,9.8,18,14,7,10,1,10,20,50.0,10,18,9,9,17,35,49
426,Timothy Chandler,us,DF,,Eint Frankfurt,Bundesliga,34,1990,0.2,0,0,0,0,0,0,0,,0,0,0,0,3,3,0
427,Conor Chaplin,eng,MF,FW,Ipswich Town,Premier League,27,1997,6.1,9,5,3,6,0,6,10,60.0,4,7,1,6,3,12,2
428,Brendan Chardonnet,fr,DF,,Brest,Ligue 1,29,1994,13.0,19,14,7,10,2,12,21,57.1,9,14,10,4,14,33,69
429,Gabriel Charpentier,cg,FW,,Parma,Serie A,25,1999,3.0,4,3,2,1,1,3,4,75.0,1,3,0,3,0,4,9
430,Raúl Chasco,es,DF,,Valladolid,La Liga,21,2003,1.4,4,1,3,1,0,2,4,50.0,2,1,0,1,2,6,2
431,Anrie Chase,jp,DF,,Stuttgart,Bundesliga,20,2004,7.6,9,4,6,3,0,5,7,71.4,2,10,6,4,8,17,33
432,Pep Chavarría,es,DF,,Rayo Vallecano,La Liga,26,1998,9.3,18,13,12,6,0,11,21,52.4,10,11,3,8,13,31,38
433,Arthur Chaves,br,DF,,Hoffenheim,Bundesliga,23,2001,6.7,12,7,5,7,0,7,12,58.3,5,13,3,10,9,21,29
434,Jhoanner Chávez,ec,DF,MF,Lens,Ligue 1,22,2002,6.5,9,5,4,4,1,2,7,28.6,5,10,1,9,6,15,13
435,Walid Cheddira,ma,FW,,Napoli,Serie A,26,1998,0.1,0,0,0,0,0,0,0,,0,0,0,0,0,0,0
436,Walid Cheddira,ma,FW,,Espanyol,La Liga,26,1998,5.1,3,0,0,0,3,0,1,0.0,1,2,0,2,1,4,5
437,Théo Chennahi,fr,MF,DF,Montpellier,Ligue 1,19,2005,0.1,0,0,0,0,0,0,0,,0,1,0,1,0,0,0
438,Sidiki Cherif,fr,FW,,Angers,Ligue 1,18,2006,3.1,4,4,0,3,1,3,4,75.0,1,2,0,2,0,4,0
439,Rayan Cherki,fr,FW,MF,Lyon,Ligue 1,21,2003,7.0,6,5,1,4,1,2,8,25.0,6,3,0,3,3,9,2
440,Lucas Chevalier,fr,GK,,Lille,Ligue 1,23,2001,15.0,2,2,2,0,0,2,3,66.7,1,0,0,0,0,2,2
441,Fabio Chiarodia,it,DF,,Gladbach,Bundesliga,19,2005,0.5,2,1,1,1,0,1,1,100.0,0,1,0,1,1,3,10
442,Julián Chicco,ar,MF,,Leganés,La Liga,26,1998,2.0,6,4,0,6,0,3,5,60.0,2,2,0,2,2,8,2
443,Leandro Chichizola,ar,GK,,Parma,Serie A,34,1990,1.0,0,0,0,0,0,0,0,,0,0,0,0,0,0,2
444,Federico Chiesa,it,FW,,Liverpool,Premier League,27,1997,0.2,0,0,0,0,0,0,0,,0,0,0,0,0,0,0
445,Chiquinho,pt,MF,,Wolves,Premier League,24,2000,0.1,0,0,0,0,0,0,0,,0,0,0,0,0,0,0
446,Chiquinho,pt,MF,FW,Mallorca,La Liga,24,2000,1.6,1,0,0,1,0,0,7,0.0,7,3,0,3,2,3,0
447,Pedro Chirivella,es,MF,,Nantes,Ligue 1,27,1997,13.1,20,16,9,10,1,8,18,44.4,10,6,0,6,6,26,26
448,Joris Chotard,fr,MF,,Montpellier,Ligue 1,23,2001,7.5,20,13,7,13,0,11,19,57.9,8,10,2,8,9,29,16
449,Hamza Choudhury,eng,MF,,Leicester City,Premier League,27,1997,0.8,0,0,0,0,0,0,1,0.0,1,1,1,0,1,1,2
450,Andreas Christensen,dk,DF,,Barcelona,La Liga,28,1996,0.3,0,0,0,0,0,0,0,,0,0,0,0,0,0,2
451,Ryan Christie,sct,MF,,Bournemouth,Premier League,29,1995,11.6,19,11,8,8,3,8,23,34.8,15,22,6,16,12,31,26
452,Samuel Chukwueze,ng,FW,MF,Milan,Serie A,25,1999,6.7,6,2,3,2,1,3,11,27.3,8,2,0,2,0,6,4
453,Aaron Ciammaglichella,it,MF,,Torino,Serie A,19,2005,0.0,0,0,0,0,0,0,0,,0,0,0,0,0,0,0
454,Jasper Cillessen,nl,GK,,Las Palmas,La Liga,35,1989,14.7,1,0,1,0,0,1,1,100.0,0,0,0,0,0,1,9
455,Alessandro Circati,au,DF,,Parma,Serie A,21,2003,4.0,4,2,3,1,0,1,1,100.0,0,5,4,1,2,6,29
456,Pathé Ciss,sn,MF,,Rayo Vallecano,La Liga,30,1994,6.8,10,6,5,5,0,2,10,20.0,8,8,4,4,11,21,29
457,Alphadjo Cissè,it,MF,,Hellas Verona,Serie A,18,2006,0.0,0,0,0,0,0,0,0,,0,0,0,0,0,0,0
458,Seydouba Cissé,gn,MF,,Leganés,La Liga,23,2001,11.6,21,13,7,11,3,7,17,41.2,10,12,1,11,7,28,17
459,Harry Clarke,eng,DF,,Ipswich Town,Premier League,23,2001,3.2,5,3,3,2,0,3,5,60.0,2,4,4,0,3,8,12
460,Jack Clarke,eng,FW,,Ipswich Town,Premier League,24,2000,5.6,18,10,8,8,2,10,17,58.8,7,4,0,4,3,21,6
461,Alexis Claude-Maurice,fr,FW,,Augsburg,Bundesliga,26,1998,5.4,12,8,4,5,3,4,6,66.7,2,2,0,2,5,17,1
462,Jonathan Clauss,fr,DF,MF,Nice,Ligue 1,32,1992,9.5,27,19,15,11,1,16,26,61.5,10,12,2,10,19,46,30
463,Silvi Clúa,es,MF,,Girona,La Liga,19,2005,1.8,8,7,4,3,1,4,6,66.7,2,1,0,1,2,10,6
464,Nathaniel Clyne,eng,DF,MF,Crystal Palace,Premier League,33,1991,3.4,11,7,7,3,1,5,6,83.3,1,3,1,2,3,14,10
465,Conor Coady,eng,DF,,Leicester City,Premier League,31,1993,4.1,5,3,3,2,0,1,2,50.0,1,10,8,2,3,8,14
466,Marcus Coco,fr,DF,,Nantes,Ligue 1,28,1996,4.9,15,15,6,7,2,8,17,47.1,9,6,2,4,3,18,12
467,Saúl Coco,gq,DF,,Torino,Serie A,25,1999,15.0,16,7,12,4,0,3,9,33.3,6,21,13,8,23,39,73
468,Séamus Coleman,ie,DF,,Everton,Premier League,36,1988,1.0,1,0,0,1,0,1,2,50.0,1,2,1,1,0,1,2
469,Nathan Collins,ie,DF,,Brentford,Premier League,23,2001,16.0,20,12,13,5,2,13,17,76.5,4,36,27,9,15,35,83
470,Nnamdi Collins,de,DF,,Eint Frankfurt,Bundesliga,20,2004,3.1,6,6,5,0,1,3,3,100.0,0,9,4,5,3,9,14
471,Toby Collyer,eng,MF,,Manchester Utd,Premier League,20,2004,0.5,4,3,1,3,0,2,2,100.0,0,0,0,0,0,4,1
472,Lorenzo Colombo,it,FW,MF,Empoli,Serie A,22,2002,11.5,12,7,4,4,4,5,12,41.7,7,12,1,11,1,13,6
473,Andrea Colpani,it,FW,MF,Fiorentina,Serie A,25,1999,11.4,10,5,5,4,1,1,7,14.3,6,5,0,5,3,13,9
474,Levi Colwill,eng,DF,,Chelsea,Premier League,21,2003,15.0,12,8,9,3,0,4,8,50.0,4,23,17,6,16,28,49
475,Kingsley Coman,fr,FW,,Bayern Munich,Bundesliga,28,1996,6.9,10,6,3,2,5,3,5,60.0,2,6,0,6,6,16,12
476,Eray Cömert,ch,DF,MF,Valladolid,La Liga,26,1998,10.8,15,9,8,7,0,6,11,54.5,5,17,10,7,12,27,32
477,Santi Comesaña,es,MF,,Villarreal,La Liga,28,1996,12.2,35,23,17,15,3,16,30,53.3,14,22,8,14,10,45,20
478,Pietro Comuzzo,it,DF,,Fiorentina,Serie A,19,2005,12.5,25,12,14,8,3,12,15,80.0,3,17,12,5,13,38,38
479,Francisco Conceição,pt,FW,MF,Juventus,Serie A,22,2002,7.3,10,5,3,4,3,4,11,36.4,7,2,0,2,4,14,1
480,Diego Conde,es,GK,,Villarreal,La Liga,26,1998,14.8,2,2,2,0,0,2,4,50.0,2,0,0,0,1,3,7
481,Tomás Conechny,ar,FW,MF,Alavés,La Liga,26,1998,5.2,4,2,2,2,0,2,10,20.0,8,8,1,7,4,8,4
482,Sirlord Conteh,de,FW,MF,Heidenheim,Bundesliga,28,1996,3.8,7,4,3,4,0,2,3,66.7,1,1,1,0,0,7,1
483,Lewis Cook,eng,MF,,Bournemouth,Premier League,27,1997,14.1,39,22,20,17,2,16,31,51.6,15,18,6,12,25,64,25
484,Copete,es,DF,,Mallorca,La Liga,25,1999,5.7,8,6,7,1,0,3,3,100.0,0,6,4,2,4,12,43
485,Diego Coppola,it,DF,,Hellas Verona,Serie A,20,2003,11.5,23,14,17,4,2,11,16,68.8,5,21,10,11,29,52,49
486,Derek Cornelius,ca,DF,,Marseille,Ligue 1,27,1997,6.2,10,6,7,3,0,8,10,80.0,2,7,3,4,4,14,25
487,Maxwel Cornet,ci,FW,,Southampton,Premier League,28,1996,0.8,5,5,1,4,0,0,4,0.0,4,0,0,0,0,5,2
488,Pierre Cornud,fr,DF,,Saint-Étienne,Ligue 1,28,1996,4.2,8,8,4,3,1,7,11,63.6,4,4,1,3,5,13,13
489,Ángel Correa,ar,FW,MF,Atlético Madrid,La Liga,29,1995,5.1,4,0,2,0,2,1,6,16.7,5,5,0,5,3,7,3
490,Joaquín Correa,ar,FW,MF,Inter,Serie A,30,1994,1.7,2,0,0,2,0,1,2,50.0,1,0,0,0,0,2,0
491,Thierry Correia,pt,DF,,Valencia,La Liga,25,1999,8.5,27,18,19,5,3,13,23,56.5,10,10,1,9,4,31,18
492,Coba da Costa,es,FW,MF,Getafe,La Liga,22,2002,2.2,6,6,1,5,0,1,6,16.7,5,3,0,3,2,8,1
493,Danny da Costa,de,DF,,Mainz 05,Bundesliga,31,1993,3.9,10,4,7,2,1,3,3,100.0,0,5,1,4,3,13,8
494,David Costa,pt,MF,,Lens,Ligue 1,23,2001,3.5,2,0,1,1,0,1,4,25.0,3,5,1,4,1,3,0
495,Logan Costa,cv,DF,,Villarreal,La Liga,23,2001,11.2,16,10,10,5,1,11,13,84.6,2,8,4,4,5,21,38
496,Logan Costa,cv,DF,,Toulouse,Ligue 1,23,2001,1.0,2,1,0,2,0,1,1,100.0,0,2,2,0,2,4,4
497,Samu Costa,pt,MF,,Mallorca,La Liga,24,2000,15.2,44,20,24,19,1,17,34,50.0,17,21,6,15,18,62,43
498,Grégoire Coudert,fr,GK,,Brest,Ligue 1,25,1999,1.0,0,0,0,0,0,0,0,,0,0,0,0,0,0,1
499,Vladimír Coufal,cz,DF,,West Ham,Premier League,32,1992,4.6,6,4,4,2,0,2,7,28.6,5,4,4,0,2,8,13
500,Lassana Coulibaly,ml,MF,,Lecce,Serie A,28,1996,10.6,15,11,5,10,0,7,20,35.0,13,17,5,12,8,23,14
501,Lasso Coulibaly,gh,FW,MF,Auxerre,Ligue 1,22,2002,0.4,0,0,0,0,0,0,0,,0,0,0,0,0,0,0
502,Soumaïla Coulibaly,fr,DF,,Brest,Ligue 1,21,2003,3.6,2,2,0,2,0,0,0,,0,4,1,3,5,7,13
503,Tanguy Coulibaly,fr,FW,MF,Montpellier,Ligue 1,23,2001,4.9,9,6,2,6,1,2,8,25.0,6,3,0,3,4,13,0
504,Woyo Coulibaly,fr,DF,,Parma,Serie A,25,1999,10.0,12,9,8,2,2,5,11,45.5,6,17,2,15,8,20,20
505,Thibaut Courtois,be,GK,,Real Madrid,La Liga,32,1992,14.0,0,0,0,0,0,0,0,,0,0,0,0,1,1,7
506,Yan Couto,br,DF,,Dortmund,Bundesliga,22,2002,4.3,9,5,7,1,1,6,10,60.0,4,9,0,9,5,14,13
507,Nicolas Cozza,fr,DF,MF,Nantes,Ligue 1,25,1999,10.3,27,18,14,10,3,12,21,57.1,9,11,3,8,11,38,28
508,Aaron Cresswell,eng,DF,,West Ham,Premier League,35,1989,0.4,1,0,0,1,0,1,1,100.0,0,1,0,1,0,1,3
509,Charlie Cresswell,eng,DF,,Toulouse,Ligue 1,22,2002,11.8,14,6,7,7,0,13,24,54.2,11,17,10,7,15,29,63
510,Bryan Cristante,it,MF,,Roma,Serie A,29,1995,11.1,23,17,7,13,3,9,16,56.3,7,12,7,5,11,34,20
511,Domen Črnigoj,si,MF,,Venezia,Serie A,29,1995,1.3,4,2,0,1,3,1,2,50.0,1,4,2,2,3,7,3
512,Juan Cruz Armada,es,DF,,Osasuna,La Liga,32,1992,6.7,8,4,3,5,0,4,8,50.0,4,4,0,4,2,10,20
513,Juan Cruz,es,FW,MF,Leganés,La Liga,24,2000,10.6,8,6,2,6,0,5,12,41.7,7,7,2,5,6,14,10
514,Juan Cuadrado,co,DF,MF,Atalanta,Serie A,36,1988,2.3,1,0,0,0,1,1,6,16.7,5,2,1,1,1,2,3
515,Pau Cubarsí,es,DF,,Barcelona,La Liga,17,2007,15.5,13,9,10,2,1,8,15,53.3,7,5,4,1,9,22,39
516,Marc Cucurella,es,DF,,Chelsea,Premier League,26,1998,13.0,26,18,17,8,1,13,26,50.0,13,21,5,16,13,39,34
517,Jorge Cuenca,es,DF,,Fulham,Premier League,25,1999,1.0,1,1,1,0,0,1,4,25.0,3,0,0,0,1,2,13
518,Matheus Cunha,br,MF,FW,Wolves,Premier League,25,1999,14.8,18,11,7,9,2,5,19,26.3,14,12,0,12,10,28,15
519,Patrick Cutrone,it,FW,,Como,Serie A,26,1998,12.6,10,8,0,6,4,5,9,55.6,4,5,0,5,2,12,6
520,Tomáš Čvančara,cz,FW,MF,Gladbach,Bundesliga,24,2000,2.4,1,1,0,1,0,1,2,50.0,1,3,2,1,0,1,5
521,Wylan Cyprien,fr,MF,,Parma,Serie A,29,1995,0.3,0,0,0,0,0,0,1,0.0,1,1,0,1,1,1,0
522,Danilo D'Ambrosio,it,DF,,Monza,Serie A,36,1988,2.4,9,3,8,0,1,3,7,42.9,4,4,2,2,2,11,4
523,Lucas Da Cunha,fr,MF,FW,Como,Serie A,23,2001,8.7,19,8,6,9,4,7,12,58.3,5,5,0,5,8,27,12
524,Samuel Dahl,se,DF,MF,Roma,Serie A,24,2000,0.5,2,2,0,2,0,1,2,50.0,1,2,0,2,0,2,0
525,Mahmoud Dahoud,de,MF,,Eint Frankfurt,Bundesliga,28,1996,3.6,9,4,4,5,0,4,6,66.7,2,5,1,4,2,11,4
526,Patson Daka,zm,FW,MF,Leicester City,Premier League,26,1998,1.2,5,1,0,3,2,4,8,50.0,4,1,1,0,0,5,2
527,Ameen Al-Dakhil,be,DF,,Stuttgart,Bundesliga,22,2002,0.1,0,0,0,0,0,0,0,,0,0,0,0,0,0,2
528,Thijs Dallinga,nl,FW,MF,Bologna,Serie A,24,2000,2.8,6,3,0,1,5,2,2,100.0,0,4,1,3,0,6,4
529,Diogo Dalot,pt,DF,,Manchester Utd,Premier League,25,1999,15.6,38,26,23,11,4,17,26,65.4,9,12,6,6,23,61,31
530,Mikkel Damsgaard,dk,MF,FW,Brentford,Premier League,24,2000,12.2,43,25,19,10,14,16,33,48.5,17,18,1,17,13,56,23
531,Flavius Daniliuc,at,DF,,Hellas Verona,Serie A,23,2001,6.5,17,12,11,5,1,10,17,58.8,7,5,1,4,6,23,14
532,Danilo,br,MF,,Nott'ham Forest,Premier League,23,2001,0.2,0,0,0,0,0,0,0,,0,0,0,0,0,0,0
533,Danilo,br,DF,,Juventus,Serie A,33,1991,6.5,10,4,7,2,1,5,10,50.0,5,4,3,1,9,19,21
534,Arnaut Danjuma,nl,FW,,Villarreal,La Liga,27,1997,2.2,2,1,0,1,1,0,1,0.0,1,1,0,1,0,2,0
535,Arnaut Danjuma,nl,FW,MF,Girona,La Liga,27,1997,7.4,5,3,2,2,1,1,4,25.0,3,4,1,3,1,6,0
536,Kévin Danois,fr,MF,,Auxerre,Ligue 1,20,2004,9.8,35,22,15,15,5,13,32,40.6,19,6,0,6,15,50,14
537,Kevin Danso,at,DF,,Lens,Ligue 1,26,1998,10.0,16,6,12,4,0,9,11,81.8,2,23,18,5,18,34,56
538,Dante,br,DF,,Nice,Ligue 1,41,1983,8.3,19,8,9,8,2,10,15,66.7,5,5,1,4,11,30,26
539,Pape Daouda Diongue,sn,MF,FW,Strasbourg,Ligue 1,,,0.8,1,0,0,1,0,0,0,,0,0,0,0,3,4,2
540,Mohammed Daramy,dk,FW,,Reims,Ligue 1,22,2002,0.2,0,0,0,0,0,0,0,,0,0,0,0,0,0,1
541,Bence Dárdai,de,MF,,Wolfsburg,Bundesliga,18,2006,5.2,8,6,2,6,0,4,8,50.0,4,8,2,6,3,11,10
542,Sergi Darder,es,MF,FW,Mallorca,La Liga,30,1993,12.5,24,13,11,8,5,9,20,45.0,11,7,0,7,6,30,9
543,Matteo Darmian,it,DF,,Inter,Serie A,35,1989,9.1,19,10,8,8,3,11,16,68.8,5,6,3,3,2,21,16
544,Lukas Daschner,de,MF,FW,Bochum,Bundesliga,26,1998,4.2,4,2,1,2,1,2,9,22.2,7,5,0,5,0,4,3
545,Juan David Cabal,co,DF,,Juventus,Serie A,23,2001,5.1,10,4,7,3,0,8,12,66.7,4,2,0,2,2,12,14
546,Jonathan David,ca,FW,,Lille,Ligue 1,24,2000,13.1,12,3,2,7,3,4,10,40.0,6,6,2,4,3,15,3
547,Alphonso Davies,ca,DF,,Bayern Munich,Bundesliga,24,2000,11.2,18,11,5,10,3,9,11,81.8,2,11,1,10,8,26,14
548,Ben Davies,wls,DF,,Tottenham,Premier League,31,1993,3.0,1,0,0,1,0,1,4,25.0,3,6,5,1,5,6,18
549,Keinan Davis,eng,FW,,Udinese,Serie A,26,1998,7.6,6,3,1,3,2,1,2,50.0,1,2,1,1,1,7,4
550,Leif Davis,eng,DF,,Ipswich Town,Premier League,24,2000,16.0,23,13,18,2,3,17,29,58.6,12,12,2,10,12,35,44
551,Zuriko Davitashvili,ge,MF,FW,Saint-Étienne,Ligue 1,23,2001,14.2,10,5,3,5,2,8,23,34.8,15,8,0,8,9,19,3
552,Paweł Dawidowicz,pl,DF,,Hellas Verona,Serie A,29,1995,6.7,13,8,4,8,1,5,6,83.3,1,7,3,4,6,19,23
553,Craig Dawson,eng,DF,,Wolves,Premier League,34,1990,9.8,14,3,8,5,1,11,14,78.6,3,14,11,3,9,23,48
554,Kevin De Bruyne,be,MF,,Manchester City,Premier League,33,1991,7.0,5,3,2,1,2,1,8,12.5,7,3,0,3,3,8,2
555,Charles De Ketelaere,be,MF,FW,Atalanta,Serie A,23,2001,11.1,5,5,0,4,1,1,6,16.7,5,4,2,2,1,6,4
556,Rodrigo De Paul,ar,MF,,Atlético Madrid,La Liga,30,1994,8.9,8,7,4,4,0,5,12,41.7,7,7,0,7,3,11,8
557,Mattia De Sciglio,it,DF,,Empoli,Serie A,32,1992,1.9,3,1,0,3,0,3,4,75.0,1,2,0,2,2,5,8
558,Lorenzo De Silvestri,it,DF,,Bologna,Serie A,36,1988,5.7,5,3,3,1,1,3,10,30.0,7,6,1,5,4,9,16
559,Thibault De Smet,be,DF,,Reims,Ligue 1,26,1998,1.1,2,2,2,0,0,1,1,100.0,0,3,1,2,2,4,9
560,Koni De Winter,be,DF,,Genoa,Serie A,22,2002,7.0,12,9,6,5,1,4,6,66.7,2,2,1,1,8,20,34
561,Alessandro Deiola,it,MF,,Cagliari,Serie A,29,1995,7.1,15,9,4,10,1,5,18,27.8,13,9,6,3,3,18,18
562,Romain Del Castillo,fr,FW,,Brest,Ligue 1,28,1996,8.8,18,11,4,8,6,11,19,57.9,8,11,0,11,5,23,0
563,Enrico Del Prato,it,DF,,Parma,Serie A,25,1999,14.2,10,8,5,4,1,5,10,50.0,5,36,20,16,13,23,62
564,Liam Delap,eng,FW,,Ipswich Town,Premier League,21,2003,13.2,6,4,2,1,3,0,7,0.0,7,4,0,4,2,8,14
565,Fisayo Dele-Bashiru,ng,MF,FW,Lazio,Serie A,23,2001,3.8,4,3,1,2,1,0,0,,0,4,1,3,2,6,2
566,Olivier Deman,be,DF,,Werder Bremen,Bundesliga,24,2000,0.7,6,3,2,4,0,2,7,28.6,5,3,1,2,1,7,4
567,Ali Dembélé,fr,DF,,Torino,Serie A,20,2004,0.8,3,2,2,1,0,3,3,100.0,0,0,0,0,0,3,2
568,Ousmane Dembélé,fr,FW,,Paris S-G,Ligue 1,27,1997,9.0,5,2,0,2,3,2,5,40.0,3,1,0,1,7,12,0
569,Ermedin Demirović,ba,FW,,Stuttgart,Bundesliga,26,1998,9.8,4,3,1,1,2,0,5,0.0,5,8,1,7,2,6,4
570,Sepp van den Berg,nl,DF,,Brentford,Premier League,22,2001,13.0,22,13,14,6,2,11,20,55.0,9,23,14,9,10,32,50
571,Arthur Desmas,fr,GK,,Le Havre,Ligue 1,30,1994,15.0,0,0,0,0,0,0,1,0.0,1,0,0,0,0,0,6
572,Justin Devenny,nir,MF,,Crystal Palace,Premier League,21,2003,2.3,9,6,6,3,0,6,10,60.0,4,2,0,2,0,9,4
573,Kiernan Dewsbury-Hall,eng,MF,,Chelsea,Premier League,26,1998,0.7,0,0,0,0,0,0,0,,0,1,0,1,1,1,2
574,Michele Di Gregorio,it,GK,,Juventus,Serie A,27,1997,11.0,0,0,0,0,0,0,0,,0,0,0,0,0,0,2
575,Giovanni Di Lorenzo,it,DF,,Napoli,Serie A,31,1993,16.0,36,25,18,15,3,22,32,68.8,10,6,3,3,17,53,41
576,Boulaye Dia,sn,MF,FW,Lazio,Serie A,28,1996,8.8,9,3,4,1,4,5,9,55.6,4,2,0,2,3,12,3
577,Mamadou Diakhon,fr,FW,MF,Reims,Ligue 1,19,2005,1.7,5,5,2,0,3,4,5,80.0,1,0,0,0,1,6,1
578,Bafodé Diakité,fr,DF,,Lille,Ligue 1,23,2001,15.0,15,9,9,4,2,11,17,64.7,6,13,6,7,16,31,42
579,Oumar Diakité,ci,FW,,Reims,Ligue 1,20,2003,11.8,15,10,7,5,3,7,14,50.0,7,8,1,7,2,17,6
580,Amad Diallo,ci,FW,DF,Manchester Utd,Premier League,22,2002,9.8,23,19,4,11,8,11,17,64.7,6,3,0,3,8,31,11
581,Assane Diao,es,FW,,Betis,La Liga,19,2005,2.8,4,2,0,3,1,3,7,42.9,4,3,0,3,0,4,3
582,Habib Diarra,sn,MF,FW,Strasbourg,Ligue 1,20,2004,13.2,10,6,1,7,2,5,9,55.6,4,8,2,6,4,14,19
583,Moussa Diarra,ml,DF,,Alavés,La Liga,24,2000,9.4,18,11,7,10,1,11,17,64.7,6,5,1,4,10,28,10
584,Rúben Dias,pt,DF,,Manchester City,Premier League,27,1997,12.1,9,5,3,5,1,3,4,75.0,1,10,9,1,12,21,32
585,Krépin Diatta,sn,DF,,Monaco,Ligue 1,25,1999,2.2,11,7,8,1,2,7,13,53.8,6,4,1,3,3,14,7
586,Kandet Diawara,gn,FW,,Le Havre,Ligue 1,24,2000,0.0,0,0,0,0,0,0,0,,0,1,0,1,0,0,1
587,Mahamadou Diawara,fr,MF,,Lyon,Ligue 1,19,2005,0.2,1,0,0,1,0,1,3,33.3,2,2,0,2,0,1,0
588,Brahim Díaz,ma,FW,MF,Real Madrid,La Liga,25,1999,5.5,13,9,6,6,1,0,4,0.0,4,5,0,5,1,14,0
589,Luis Díaz,co,FW,,Liverpool,Premier League,27,1997,9.8,13,7,5,7,1,6,13,46.2,7,10,0,10,3,16,4
590,Pedro Díaz,es,MF,DF,Rayo Vallecano,La Liga,26,1998,1.5,4,3,1,3,0,2,6,33.3,4,5,0,5,1,5,1
591,Tyler Dibling,eng,MF,FW,Southampton,Premier League,18,2006,10.3,16,11,6,8,2,8,14,57.1,6,8,2,6,4,20,6
592,Diego,es,FW,MF,Leganés,La Liga,24,2000,4.4,0,0,0,0,0,0,1,0.0,1,2,1,1,0,0,6
593,Justin Diehl,de,FW,DF,Stuttgart,Bundesliga,20,2004,0.9,0,0,0,0,0,0,0,,0,2,0,2,0,0,0
594,Bamba Dieng,sn,FW,,Angers,Ligue 1,24,2000,4.3,3,0,1,1,1,0,0,,0,1,0,1,0,3,3
595,Eric Dier,eng,DF,,Bayern Munich,Bundesliga,30,1994,1.2,2,2,2,0,0,1,2,50.0,1,3,0,3,1,3,4
596,Lucas Digne,fr,DF,,Aston Villa,Premier League,31,1993,12.9,31,19,17,8,6,20,31,64.5,11,12,3,9,18,49,40
597,Federico Dimarco,it,DF,,Inter,Serie A,27,1997,12.3,9,4,4,3,2,5,8,62.5,3,10,2,8,9,18,12
598,Stole Dimitrievski,mk,GK,,Valencia,La Liga,30,1993,1.0,0,0,0,0,0,0,0,,0,0,0,0,0,0,0
599,Junior Dina Ebimbe,fr,MF,FW,Eint Frankfurt,Bundesliga,24,2000,3.1,2,1,1,1,0,0,2,0.0,2,4,0,4,7,9,6
600,Eren Dinkçi,de,MF,,Freiburg,Bundesliga,23,2001,6.9,13,7,3,6,4,3,13,23.1,10,14,2,12,4,17,1
601,Sinaly Diomande,ci,DF,,Auxerre,Ligue 1,23,2001,7.8,10,7,3,6,1,8,12,66.7,4,13,9,4,9,19,26
602,Lois Diony,fr,FW,,Angers,Ligue 1,31,1992,0.2,0,0,0,0,0,0,0,,0,0,0,0,0,0,0
603,Issa Diop,fr,DF,,Fulham,Premier League,27,1997,8.4,14,8,10,4,0,6,9,66.7,3,7,6,1,2,16,42
604,Sofiane Diop,fr,MF,FW,Nice,Ligue 1,24,2000,5.3,14,11,9,2,3,7,14,50.0,7,15,2,13,5,19,4
605,Andy Diouf,fr,MF,,Lens,Ligue 1,21,2003,11.4,17,11,4,10,3,10,20,50.0,10,16,1,15,8,25,8
606,Yehvann Diouf,fr,GK,,Reims,Ligue 1,25,1999,15.0,1,1,1,0,0,1,2,50.0,1,0,0,0,0,1,4
607,Assane Dioussé,sn,MF,,Auxerre,Ligue 1,27,1997,0.3,1,1,0,1,0,0,0,,0,0,0,0,0,1,1
608,Axel Disasi,fr,DF,,Chelsea,Premier League,26,1998,2.0,1,1,1,0,0,1,3,33.3,2,2,1,1,1,2,7
609,Roman Dixon,eng,DF,,Everton,Premier League,19,2004,1.0,5,5,3,2,0,4,4,100.0,0,1,0,1,1,6,3
610,Álvaro djaló,es,FW,,Athletic Club,La Liga,25,1999,4.9,6,4,3,2,1,1,3,33.3,2,2,0,2,1,7,4
611,Djené,tg,DF,,Getafe,La Liga,32,1991,13.5,6,1,3,3,0,1,9,11.1,8,8,5,3,15,21,48
612,Berat Djimsiti,al,DF,,Atalanta,Serie A,31,1993,11.7,27,17,14,13,0,13,16,81.3,3,15,9,6,22,49,42
613,Marko Dmitrović,rs,GK,,Leganés,La Liga,32,1992,11.0,0,0,0,0,0,0,1,0.0,1,0,0,0,0,0,11
614,Ritsu Doan,jp,FW,MF,Freiburg,Bundesliga,26,1998,13.1,22,17,11,9,2,9,16,56.3,7,19,0,19,7,29,12
615,Dodô,br,DF,,Fiorentina,Serie A,26,1998,14.9,15,12,8,4,3,9,18,50.0,9,10,3,7,20,35,28
616,Danilho Doekhi,nl,DF,,Union Berlin,Bundesliga,26,1998,14.0,18,11,9,7,2,8,11,72.7,3,18,7,11,21,39,43
617,Matt Doherty,ie,DF,,Wolves,Premier League,32,1992,4.9,10,7,7,3,0,4,6,66.7,2,7,3,4,4,14,14
618,Jeremy Doku,be,FW,MF,Manchester City,Premier League,22,2002,6.9,14,9,6,4,4,3,5,60.0,2,6,1,5,1,15,2
619,Marc Domenech,es,FW,,Mallorca,La Liga,18,2006,1.3,0,0,0,0,0,0,2,0.0,2,2,0,2,0,0,0
620,Álex Domínguez,es,GK,,Toulouse,Ligue 1,26,1998,0.2,0,0,0,0,0,0,0,,0,0,0,0,0,0,0
621,Benjamín Domínguez,ar,FW,,Bologna,Serie A,21,2003,2.6,3,0,0,2,1,0,2,0.0,2,3,1,2,1,4,2
622,Carlos Dominguez,es,DF,,Celta Vigo,La Liga,23,2001,3.8,7,4,4,3,0,4,7,57.1,3,4,4,0,4,11,22
623,Israel Domínguez,es,FW,,Sevilla,La Liga,21,2003,0.2,0,0,0,0,0,0,0,,0,0,0,0,0,0,0
624,Nicolás Domínguez,ar,MF,FW,Nott'ham Forest,Premier League,26,1998,8.7,29,13,13,11,5,14,29,48.3,15,17,4,13,16,45,15
625,Sergi Dominguez,es,DF,,Barcelona,La Liga,19,2005,1.9,1,1,1,0,0,0,0,,0,0,0,0,3,4,7
626,Gianluigi Donnarumma,it,GK,,Paris S-G,Ligue 1,25,1999,11.0,1,1,1,0,0,1,1,100.0,0,0,0,0,0,1,5
627,Patrick Dorgu,dk,FW,DF,Lecce,Serie A,20,2004,14.4,27,14,11,12,4,15,28,53.6,13,15,3,12,13,40,29
628,Alfie Dorrington,eng,DF,,Tottenham,Premier League,19,2005,0.2,0,0,0,0,0,0,0,,0,0,0,0,0,0,0
629,Niklas Dorsch,de,MF,,Augsburg,Bundesliga,26,1998,0.4,0,0,0,0,0,0,0,,0,1,0,1,0,0,0
630,Niklas Dorsch,de,MF,,Heidenheim,Bundesliga,26,1998,6.2,9,5,4,5,0,2,7,28.6,5,6,0,6,6,15,6
631,Alberto Dossena,it,DF,,Como,Serie A,26,1998,11.6,16,9,13,3,0,7,12,58.3,5,9,6,3,12,28,57
632,Abdoulaye Doucouré,ml,MF,,Everton,Premier League,31,1993,10.9,17,7,11,5,1,5,10,50.0,5,15,4,11,5,22,9
633,Cheick Doucouré,ml,MF,,Crystal Palace,Premier League,24,2000,2.7,7,3,1,5,1,2,6,33.3,4,4,0,4,6,13,3
634,Désiré Doué,fr,FW,MF,Paris S-G,Ligue 1,19,2005,5.7,7,5,2,4,1,3,12,25.0,9,4,0,4,2,9,2
635,Guela Doué,ci,DF,,Strasbourg,Ligue 1,22,2002,14.0,27,20,16,4,7,16,23,69.6,7,12,0,12,22,49,68
636,Douglas,br,MF,,Nantes,Ligue 1,27,1997,12.4,32,18,10,17,5,11,20,55.0,9,25,5,20,8,40,15
637,Ismaël Doukouré,fr,MF,DF,Strasbourg,Ligue 1,21,2003,11.8,21,8,10,11,0,10,13,76.9,3,16,6,10,12,33,42
638,Issa Doumbia,ci,MF,,Venezia,Serie A,21,2003,2.3,3,1,1,2,0,3,4,75.0,1,6,2,4,1,4,3
639,Kamory Doumbia,ml,MF,FW,Brest,Ligue 1,21,2003,6.2,18,13,7,9,2,8,18,44.4,10,4,0,4,11,29,6
640,Amidou Doumbouya,fr,DF,,Nice,Ligue 1,17,2007,0.5,1,1,0,0,1,1,1,100.0,0,3,1,2,1,2,1
641,Anastasios Douvikas,gr,FW,,Celta Vigo,La Liga,25,1999,7.0,8,3,2,5,1,3,5,60.0,2,5,2,3,3,11,5
642,Artem Dovbyk,ua,FW,,Roma,Serie A,27,1997,12.8,3,2,0,1,2,0,2,0.0,2,6,2,4,1,4,7
643,Flynn Downes,eng,MF,,Southampton,Premier League,25,1999,13.5,28,14,14,12,2,8,24,33.3,16,16,3,13,18,46,25
644,Tommy Doyle,eng,MF,,Wolves,Premier League,23,2001,3.7,7,3,2,3,2,3,9,33.3,6,5,2,3,2,9,6
645,Radu Drăgușin,ro,DF,,Tottenham,Premier League,22,2002,8.0,9,5,7,2,0,6,10,60.0,4,11,9,2,11,20,28
646,Patrick Drewes,de,GK,,Bochum,Bundesliga,31,1993,14.0,0,0,0,0,0,0,1,0.0,1,0,0,0,0,0,10
647,Tim Drexler,de,DF,,Hoffenheim,Bundesliga,19,2005,4.0,17,7,11,6,0,9,12,75.0,3,6,4,2,1,18,9
648,Domingos Duarte,pt,DF,,Getafe,La Liga,29,1995,3.0,3,2,3,0,0,2,2,100.0,0,1,1,0,3,6,10
649,Martin Dúbravka,sk,GK,,Newcastle Utd,Premier League,35,1989,1.0,0,0,0,0,0,0,0,,0,0,0,0,0,0,0
650,Marvin Ducksch,de,FW,,Werder Bremen,Bundesliga,30,1994,12.8,6,4,1,4,1,2,11,18.2,9,2,0,2,3,9,13
651,Ondrej Duda,sk,MF,,Hellas Verona,Serie A,30,1994,8.9,13,8,6,7,0,8,19,42.1,11,8,2,6,9,22,6
652,Denzel Dumfries,nl,DF,FW,Inter,Serie A,28,1996,7.3,7,6,1,4,2,4,10,40.0,6,10,0,10,2,9,8
653,Alfred Duncan,gh,MF,,Venezia,Serie A,31,1993,8.8,14,5,3,9,2,4,12,33.3,8,4,2,2,8,22,6
654,Lewis Dunk,eng,DF,,Brighton,Premier League,33,1991,11.0,7,3,3,3,1,2,3,66.7,1,12,7,5,8,15,29
655,Jhon Durán,co,FW,,Aston Villa,Premier League,21,2003,5.5,7,6,1,1,5,1,4,25.0,3,4,0,4,0,7,10
656,Pablo Durán,es,FW,MF,Celta Vigo,La Liga,23,2001,2.9,3,2,0,2,1,2,4,50.0,2,1,1,0,3,6,2
657,Julien Duranville,be,FW,MF,Dortmund,Bundesliga,18,2006,0.6,0,0,0,0,0,0,0,,0,1,0,1,0,0,0
658,Hugo Duro,es,FW,,Valencia,La Liga,25,1999,11.6,7,5,3,3,1,2,4,50.0,2,7,1,6,6,13,5
659,Jean-Kevin Duverne,ht,DF,,Nantes,Ligue 1,27,1997,6.0,21,12,13,4,4,15,27,55.6,12,10,3,7,8,29,23
660,Paulo Dybala,ar,FW,MF,Roma,Serie A,31,1993,8.7,11,4,2,5,4,5,9,55.6,4,4,0,4,1,12,0
661,Stefan Džodić,rs,DF,,Montpellier,Ligue 1,19,2005,1.9,5,2,3,2,0,3,5,60.0,2,2,1,1,4,9,7
662,Adam Dźwigała,pl,MF,DF,St. Pauli,Bundesliga,29,1995,1.2,9,3,7,1,1,5,7,71.4,2,0,0,0,0,9,5
663,Aron Dønnum,no,DF,MF,Toulouse,Ligue 1,26,1998,12.0,16,8,5,8,3,7,20,35.0,13,12,2,10,11,27,17
664,Enzo Ebosse,cm,DF,,Udinese,Serie A,25,1999,1.0,0,0,0,0,0,0,2,0.0,2,3,3,0,1,1,1
665,Ederson,br,GK,,Manchester City,Premier League,31,1993,13.0,0,0,0,0,0,0,2,0.0,2,0,0,0,1,1,3
666,Éderson,br,MF,,Atalanta,Serie A,25,1999,14.8,17,12,7,9,1,9,15,60.0,6,8,1,7,17,34,16
667,George Edmundson,eng,DF,,Ipswich Town,Premier League,27,1997,0.0,0,0,0,0,0,0,0,,0,0,0,0,0,0,0
668,Odsonne Édouard,fr,MF,FW,Crystal Palace,Premier League,26,1998,1.3,1,0,0,1,0,0,2,0.0,2,1,0,1,0,1,1
669,Odsonne Édouard,fr,FW,,Leicester City,Premier League,26,1998,0.3,1,1,1,0,0,0,0,,0,0,0,0,0,1,1
670,Samuel Edozie,eng,DF,FW,Southampton,Premier League,21,2003,0.7,3,1,0,1,2,2,2,100.0,0,0,0,0,0,3,0
671,Ronnie Edwards,eng,DF,,Southampton,Premier League,21,2003,0.1,0,0,0,0,0,0,0,,0,1,1,0,0,0,0
672,Johannes Eggestein,de,FW,,St. Pauli,Bundesliga,26,1998,12.6,3,2,0,1,2,0,2,0.0,2,2,0,2,0,3,4
673,Maximilian Eggestein,de,MF,,Freiburg,Bundesliga,28,1996,12.4,21,13,7,12,2,10,17,58.8,7,13,2,11,17,38,17
674,Kingsley Ehizibue,nl,DF,,Udinese,Serie A,29,1995,14.4,32,23,19,11,2,16,26,61.5,10,18,5,13,12,44,34
675,Chidera Ejuke,ng,FW,MF,Sevilla,La Liga,26,1998,6.0,5,3,0,3,2,3,9,33.3,6,6,0,6,1,6,2
676,Jeff Ekhator,it,FW,MF,Genoa,Serie A,18,2006,4.0,0,0,0,0,0,0,0,,0,4,0,4,0,0,1
677,Hugo Ekitike,fr,FW,,Eint Frankfurt,Bundesliga,22,2002,10.5,9,6,3,3,3,4,5,80.0,1,5,1,4,5,14,6
678,Jurgen Ekkelenkamp,nl,MF,,Udinese,Serie A,24,2000,6.7,17,11,5,11,1,10,19,52.6,9,9,2,7,5,22,11
679,Jacques Ekomie,ga,DF,,Angers,Ligue 1,21,2003,3.2,8,6,3,4,1,3,6,50.0,3,7,1,6,2,10,8
680,Emmanuel Ekong,se,MF,FW,Empoli,Serie A,22,2002,1.9,4,3,0,2,2,3,3,100.0,0,1,0,1,1,5,1
681,Caleb Ekuban,gh,FW,,Genoa,Serie A,30,1994,2.3,1,1,0,1,0,0,0,,0,2,0,2,0,1,3
682,Pierre Ekwah Elimby,fr,MF,DF,Saint-Étienne,Ligue 1,22,2002,11.7,19,12,9,10,0,12,20,60.0,8,10,6,4,18,37,41
683,Anthony Elanga,se,FW,,Nott'ham Forest,Premier League,22,2002,9.1,8,5,4,3,1,2,6,33.3,4,4,0,4,3,11,15
684,Mikael Ellertsson,is,DF,MF,Venezia,Serie A,22,2002,10.6,22,10,10,9,3,11,20,55.0,9,12,2,10,7,29,25
685,Harvey Elliott,eng,DF,FW,Liverpool,Premier League,21,2003,0.2,3,2,2,1,0,0,0,,0,0,0,0,0,3,0
686,Elif Elmas,mk,MF,,RB Leipzig,Bundesliga,25,1999,0.5,3,1,3,0,0,1,3,33.3,2,2,0,2,0,3,2
687,Aritz Elustondo,es,DF,,Real Sociedad,La Liga,30,1994,3.1,6,3,4,1,1,3,3,100.0,0,6,5,1,2,8,15
688,Nico Elvedi,ch,DF,,Gladbach,Bundesliga,28,1996,7.5,10,5,5,2,3,6,7,85.7,1,11,9,2,10,20,31
689,Adri Embarba,es,FW,MF,Rayo Vallecano,La Liga,32,1992,8.3,18,5,8,8,2,10,20,50.0,10,9,1,8,5,23,8
690,Breel Embolo,ch,FW,,Monaco,Ligue 1,27,1997,8.1,4,3,1,1,2,1,7,14.3,6,3,0,3,1,5,3
691,Emanuel Emegha,nl,FW,,Strasbourg,Ligue 1,21,2003,8.7,4,4,0,2,2,1,2,50.0,1,7,4,3,0,4,9
692,Emerson,br,DF,,Milan,Serie A,25,1999,11.5,31,20,15,12,4,15,32,46.9,17,6,2,4,12,43,40
693,Yunus Emre Konak,tr,MF,FW,Brentford,Premier League,18,2006,0.2,1,1,0,1,0,0,1,0.0,1,0,0,0,0,1,0
694,Julio Enciso,py,MF,FW,Brighton,Premier League,20,2004,1.5,0,0,0,0,0,0,1,0.0,1,1,0,1,0,0,0
695,Wataru Endo,jp,MF,,Liverpool,Premier League,31,1993,0.3,3,2,0,3,0,2,2,100.0,0,2,0,2,1,4,1
696,Endrick,br,FW,,Real Madrid,La Liga,18,2006,1.0,0,0,0,0,0,0,1,0.0,1,0,0,0,1,1,0
697,Yannik Engelhardt,de,MF,,Como,Serie A,23,2001,6.6,18,7,6,11,1,10,14,71.4,4,1,0,1,4,22,14
698,Arne Engels,be,MF,FW,Augsburg,Bundesliga,21,2003,0.9,0,0,0,0,0,0,0,,0,1,1,0,0,0,0
699,Christian Eriksen,dk,MF,,Manchester Utd,Premier League,32,1992,5.6,9,3,2,5,2,5,10,50.0,5,4,1,3,4,13,5
700,Martin Erlic,hr,DF,,Bologna,Serie A,26,1998,2.5,2,0,0,2,0,1,2,50.0,1,5,4,1,1,3,5
701,Patrick Erras,de,DF,,Holstein Kiel,Bundesliga,29,1995,9.2,8,5,6,2,0,2,9,22.2,7,13,11,2,9,17,64
702,Alfonso Espino,uy,DF,,Rayo Vallecano,La Liga,32,1992,3.4,16,9,10,5,1,9,20,45.0,11,6,2,4,7,23,7
703,Sebastiano Esposito,it,FW,MF,Empoli,Serie A,22,2002,8.4,20,10,5,12,3,8,16,50.0,8,5,1,4,8,28,4
704,Samuel Essende,cd,FW,,Augsburg,Bundesliga,26,1998,7.4,1,1,0,0,1,0,0,,0,8,1,7,0,1,3
705,Dario Essugo,pt,MF,,Las Palmas,La Liga,19,2005,10.1,29,20,18,7,4,14,25,56.0,11,10,5,5,22,51,24
706,Nahuel Estévez,ar,MF,,Parma,Serie A,29,1995,4.0,6,3,4,1,1,2,8,25.0,6,6,2,4,3,9,14
707,Pervis Estupiñán,ec,DF,,Brighton,Premier League,26,1998,10.8,27,18,16,8,3,11,17,64.7,6,5,2,3,13,40,31
708,Evanilson,br,FW,,Bournemouth,Premier League,25,1999,12.3,7,4,1,3,3,3,7,42.9,4,7,1,6,0,7,11
709,Jonny Evans,nir,DF,,Manchester Utd,Premier League,36,1988,3.2,7,5,4,3,0,2,4,50.0,2,2,1,1,4,11,13
710,Eberechi Eze,eng,MF,FW,Crystal Palace,Premier League,26,1998,12.0,20,12,9,8,3,9,19,47.4,10,11,0,11,6,26,3
711,Abde Ezzalzouli,ma,FW,MF,Betis,La Liga,23,2001,13.4,23,15,12,9,2,10,17,58.8,7,16,3,13,5,28,8
712,Giovanni Fabbian,it,MF,,Bologna,Serie A,21,2003,4.7,7,5,1,2,4,4,7,57.1,3,1,1,0,2,9,4
713,Łukasz Fabiański,pl,GK,,West Ham,Premier League,39,1985,8.5,0,0,0,0,0,0,1,0.0,1,0,0,0,0,0,3
714,Alieu Fadera,gm,FW,,Como,Serie A,23,2001,11.0,37,30,12,15,10,13,30,43.3,17,10,1,9,3,40,4
715,Wout Faes,be,DF,,Leicester City,Premier League,26,1998,13.5,18,13,14,3,1,8,23,34.8,15,26,18,8,11,29,85
716,Nicolò Fagioli,it,MF,,Juventus,Serie A,23,2001,6.2,13,9,7,5,1,6,8,75.0,2,3,0,3,2,15,5
717,Romain Faivre,fr,FW,MF,Brest,Ligue 1,26,1998,5.4,8,8,3,4,1,4,9,44.4,5,1,0,1,3,11,2
718,Wladimiro Falcone,it,GK,,Lecce,Serie A,29,1995,16.0,0,0,0,0,0,0,0,,0,0,0,0,0,0,12
719,Davide Faraoni,it,DF,MF,Hellas Verona,Serie A,33,1991,0.5,1,1,0,1,0,0,2,0.0,2,1,1,0,0,1,2
720,Abdul Fatawu Issahaku,gh,FW,,Leicester City,Premier League,20,2004,6.4,21,15,13,2,6,11,19,57.9,8,7,0,7,4,25,12
721,Ansu Fati,es,FW,,Barcelona,La Liga,22,2002,1.4,1,1,0,1,0,0,0,,0,0,0,0,0,1,0
722,Khalil Fayad,fr,MF,FW,Montpellier,Ligue 1,20,2004,2.8,14,7,5,9,0,5,8,62.5,3,4,0,4,1,15,4
723,Jacopo Fazzini,it,MF,,Empoli,Serie A,21,2003,6.1,16,9,8,7,1,9,13,69.2,4,7,1,6,2,18,10
724,Peter Federico,do,MF,FW,Getafe,La Liga,22,2002,2.8,5,2,1,2,2,3,4,75.0,1,3,0,3,0,5,3
725,Nabil Fekir,fr,MF,,Betis,La Liga,31,1993,2.0,3,2,1,1,1,1,2,50.0,1,2,0,2,0,3,0
726,Mattia Felici,it,MF,FW,Cagliari,Serie A,23,2001,1.7,3,3,1,2,0,1,4,25.0,3,1,0,1,5,8,1
727,João Félix,pt,FW,MF,Chelsea,Premier League,25,1999,3.3,7,3,2,4,1,5,8,62.5,3,2,0,2,3,10,2
728,Kiko Femenía,es,DF,,Villarreal,La Liga,33,1991,14.3,28,17,20,7,1,17,32,53.1,15,15,8,7,22,50,31
729,Evan Ferguson,ie,FW,,Brighton,Premier League,20,2004,2.5,3,2,0,3,0,2,5,40.0,3,2,1,1,0,3,4
730,Lewis Ferguson,sct,MF,,Bologna,Serie A,25,1999,0.6,2,1,0,0,2,1,2,50.0,1,0,0,0,0,2,1
731,Zinedine Ferhat,dz,FW,MF,Angers,Ligue 1,31,1993,2.5,1,0,0,1,0,0,2,0.0,2,1,0,1,2,3,2
732,Bruno Fernandes,pt,MF,FW,Manchester Utd,Premier League,30,1994,14.9,35,22,8,19,8,12,36,33.3,24,15,2,13,12,47,18
733,Edimilson Fernandes,ch,MF,,Brest,Ligue 1,28,1996,4.7,4,3,2,2,0,4,7,57.1,3,8,3,5,9,13,11
734,Mateus Fernandes,pt,MF,,Southampton,Premier League,20,2004,12.7,37,21,19,12,6,12,29,41.4,17,16,1,15,7,44,17
735,Álvaro Fernández,es,GK,,Sevilla,La Liga,26,1998,6.3,0,0,0,0,0,0,1,0.0,1,0,0,0,0,0,7
736,Enzo Fernández,ar,MF,,Chelsea,Premier League,23,2001,11.8,35,16,9,15,11,16,41,39.0,25,16,2,14,6,41,10
737,Valery Fernández,es,MF,FW,Mallorca,La Liga,25,1999,2.4,7,6,3,1,3,5,7,71.4,2,2,1,1,0,7,1
738,Matias Fernandez-Pardo,be,FW,,Lille,Ligue 1,19,2005,4.8,6,4,3,3,0,4,8,50.0,4,5,0,5,1,7,4
739,Jordan Ferri,fr,MF,,Montpellier,Ligue 1,32,1992,8.8,21,10,9,11,1,10,17,58.8,7,7,1,6,4,25,7
740,Karol Fila,pl,MF,,Strasbourg,Ligue 1,26,1998,0.1,0,0,0,0,0,0,0,,0,0,0,0,0,0,0
741,Kilian Fischer,de,DF,,Wolfsburg,Bundesliga,24,2000,11.2,23,16,18,3,2,17,41,41.5,24,19,3,16,8,31,47
742,Mark Flekken,nl,GK,,Brentford,Premier League,31,1993,16.0,2,2,2,0,0,1,6,16.7,5,0,0,0,0,2,15
743,Mateo Flores,es,MF,,Betis,La Liga,20,2004,1.2,0,0,0,0,0,0,0,,0,0,0,0,1,1,2
744,Phil Foden,eng,MF,FW,Manchester City,Premier League,24,2000,8.0,2,1,2,0,0,2,7,28.6,5,4,1,3,3,5,2
745,Malick Fofana,be,FW,,Lyon,Ligue 1,19,2005,9.0,12,8,5,6,1,6,11,54.5,5,8,0,8,6,18,6
746,Wesley Fofana,fr,DF,,Chelsea,Premier League,24,2000,11.3,13,12,6,7,0,6,14,42.9,8,14,9,5,12,25,49
747,Yahia Fofana,ci,GK,,Angers,Ligue 1,24,2000,15.0,0,0,0,0,0,0,1,0.0,1,0,0,0,1,1,12
748,Youssouf Fofana,fr,MF,,Milan,Serie A,25,1999,12.6,23,14,5,16,2,11,22,50.0,11,12,3,9,10,33,14
749,Jonas Föhrenbach,de,DF,,Heidenheim,Bundesliga,28,1996,13.6,24,12,15,8,1,12,19,63.2,7,19,3,16,11,35,36
750,Michael Folorunsho,it,FW,MF,Napoli,Serie A,26,1998,0.4,3,2,0,3,0,2,4,50.0,2,0,0,0,1,4,1
751,Lamine Fomba,fr,MF,,Saint-Étienne,Ligue 1,26,1998,0.8,4,3,2,2,0,1,2,50.0,1,4,1,3,2,6,3
752,Carlos Forbs,pt,MF,FW,Wolves,Premier League,20,2004,2.3,6,5,3,2,1,4,5,80.0,1,3,0,3,1,7,2
753,Pablo Fornals,es,MF,FW,Betis,La Liga,28,1996,10.6,11,7,5,5,1,4,14,28.6,10,17,0,17,13,24,8
754,Omari Forson,eng,MF,FW,Monza,Serie A,20,2004,0.7,2,2,1,1,0,1,1,100.0,0,2,0,2,0,2,0
755,Fraser Forster,eng,GK,,Tottenham,Premier League,36,1988,4.0,0,0,0,0,0,0,0,,0,0,0,0,0,0,3
756,Héctor Fort,es,DF,,Barcelona,La Liga,18,2006,3.1,8,6,4,3,1,7,10,70.0,3,6,0,6,4,12,9
757,Dimitri Foulquier,fr,DF,,Valencia,La Liga,31,1993,8.1,22,16,12,7,3,10,16,62.5,6,8,0,8,3,25,16
758,Alejandro Francés,es,DF,,Girona,La Liga,22,2002,6.2,19,13,11,7,1,16,22,72.7,6,6,2,4,9,28,19
759,Przemysław Frankowski,pl,DF,,Lens,Ligue 1,29,1995,10.5,19,12,10,6,3,13,20,65.0,7,5,0,5,7,26,20
760,Enric Franquesa,es,DF,FW,Leganés,La Liga,27,1997,6.8,17,9,9,6,2,9,13,69.2,4,7,1,6,5,22,12
761,Ryan Fraser,sct,FW,DF,Southampton,Premier League,30,1994,3.4,6,2,2,4,0,4,6,66.7,2,1,1,0,1,7,9
762,Davide Frattesi,it,MF,,Inter,Serie A,25,1999,6.5,8,4,3,4,1,6,11,54.5,5,4,2,2,2,10,2
763,Morten Frendrup,dk,MF,,Genoa,Serie A,23,2001,14.5,55,35,13,27,15,22,42,52.4,20,25,10,15,18,73,23
764,Martin Frese,dk,DF,,Hellas Verona,Serie A,26,1998,3.7,13,7,6,7,0,5,8,62.5,3,2,1,1,6,19,14
765,Remo Freuler,ch,MF,,Bologna,Serie A,32,1992,14.7,34,18,16,14,4,16,38,42.1,22,18,2,16,18,52,31
766,Marco Friedl,at,DF,,Werder Bremen,Bundesliga,26,1998,11.4,30,21,18,12,0,17,29,58.6,12,18,10,8,18,48,63
767,Marvin Friedrich,de,DF,,Gladbach,Bundesliga,29,1995,6.6,6,1,6,0,0,4,6,66.7,2,11,9,2,2,8,32
768,Jeremie Frimpong,nl,DF,MF,Leverkusen,Bundesliga,24,2000,11.0,11,10,7,2,2,6,13,46.2,7,11,0,11,5,16,9
769,Jorge de Frutos,es,MF,FW,Rayo Vallecano,La Liga,27,1997,12.3,21,11,9,6,6,9,26,34.6,17,9,0,9,7,28,14
770,Darío Fuentes,es,DF,,Sevilla,La Liga,21,2003,0.1,0,0,0,0,0,0,0,,0,0,0,0,0,0,0
771,Chris Führich,de,FW,MF,Stuttgart,Bundesliga,26,1998,7.5,5,3,1,3,1,5,12,41.7,7,10,2,8,1,6,10
772,Angelo Fulgini,fr,MF,FW,Lens,Ligue 1,28,1996,6.5,5,4,2,1,2,3,5,60.0,2,7,1,6,0,5,2
773,Niclas Füllkrug,de,FW,,West Ham,Premier League,31,1993,1.3,1,1,0,0,1,1,1,100.0,0,0,0,0,0,1,3
774,Manuel Fuster,es,FW,MF,Las Palmas,La Liga,27,1997,3.3,5,1,1,4,0,5,10,50.0,5,5,1,4,1,6,7
775,Matteo Gabbia,it,DF,,Milan,Serie A,25,1999,7.7,7,5,4,2,1,3,4,75.0,1,11,9,2,5,12,24
776,Alessandro Gabrielloni,it,FW,MF,Como,Serie A,30,1994,1.1,0,0,0,0,0,0,3,0.0,3,0,0,0,0,0,0
777,Gianluca Gaetano,it,MF,FW,Cagliari,Serie A,24,2000,5.6,6,4,3,3,0,3,11,27.3,8,4,0,4,3,9,6
778,Roberto Gagliardini,it,MF,DF,Monza,Serie A,30,1994,1.1,1,0,0,1,0,0,2,0.0,2,0,0,0,1,2,4
779,Cody Gakpo,nl,FW,,Liverpool,Premier League,25,1999,7.7,13,8,4,6,3,7,11,63.6,4,8,0,8,6,19,7
780,Javi Galán,es,DF,,Atlético Madrid,La Liga,30,1994,6.5,20,13,9,8,3,11,21,52.4,10,9,1,8,5,25,5
781,Iñigo Ruiz de Galarreta,es,MF,,Athletic Club,La Liga,31,1993,9.1,19,13,9,8,2,12,19,63.2,7,6,2,4,4,23,6
782,Conor Gallagher,eng,MF,,Atlético Madrid,La Liga,24,2000,8.3,20,13,6,11,3,9,19,47.4,10,9,1,8,7,27,12
783,Antonino Gallo,it,DF,,Lecce,Serie A,24,2000,12.3,26,16,17,6,3,10,20,50.0,10,15,1,14,9,35,51
784,Gauthier Gallon,fr,GK,,Rennes,Ligue 1,31,1993,0.5,0,0,0,0,0,0,0,,0,0,0,0,0,0,0
785,Cristian Gamboa,cr,DF,,Bochum,Bundesliga,35,1989,1.3,1,1,1,0,0,1,2,50.0,1,0,0,0,0,1,2
786,Idrissa Gana Gueye,sn,MF,,Everton,Premier League,35,1989,11.9,44,24,23,15,6,18,28,64.3,10,18,2,16,13,57,8
787,Ignatius Ganago,cm,FW,MF,Nantes,Ligue 1,25,1999,1.8,1,1,0,1,0,1,1,100.0,0,2,1,1,3,4,1
788,Aleix García,es,MF,,Leverkusen,Bundesliga,27,1997,5.2,5,2,1,3,1,2,5,40.0,3,3,1,2,3,8,6
789,Álvaro García,es,MF,FW,Rayo Vallecano,La Liga,32,1992,10.3,22,16,13,6,3,8,16,50.0,8,12,0,12,13,35,19
790,Eric García,es,MF,DF,Barcelona,La Liga,23,2001,5.8,12,5,2,8,2,6,8,75.0,2,8,3,5,4,16,11
791,Fran Garcia,es,DF,,Real Madrid,La Liga,25,1999,8.5,11,8,7,2,2,5,10,50.0,5,6,3,3,7,18,22
792,Joan García,es,GK,,Espanyol,La Liga,23,2001,16.0,0,0,0,0,0,0,0,,0,0,0,0,0,0,7
793,Rubén García,es,FW,MF,Osasuna,La Liga,31,1993,10.4,24,16,9,9,6,14,24,58.3,10,17,1,16,9,33,17
794,Ulisses Garcia,ch,DF,,Marseille,Ligue 1,28,1996,4.4,9,7,4,4,1,3,10,30.0,7,3,0,3,2,11,8
795,Alejandro Garnacho,ar,FW,MF,Manchester Utd,Premier League,20,2004,10.5,13,10,4,4,5,3,13,23.1,10,8,0,8,6,19,8
796,James Garner,eng,DF,MF,Everton,Premier League,23,2001,2.8,10,8,6,4,0,7,10,70.0,3,2,2,0,4,14,9
797,Yarek Gasiorowski,es,DF,,Valencia,La Liga,19,2005,6.6,16,13,14,2,0,8,11,72.7,3,10,4,6,14,30,32
798,Federico Gatti,it,DF,,Juventus,Serie A,26,1998,12.5,12,9,10,2,0,7,11,63.6,4,13,10,3,8,20,30
799,Gavi,es,MF,,Barcelona,La Liga,20,2004,2.2,7,5,3,4,0,5,5,100.0,0,6,1,5,5,12,2
800,Paulo Gazzaniga,ar,GK,,Girona,La Liga,32,1992,17.0,1,1,1,0,0,1,1,100.0,0,0,0,0,0,1,5
801,Jean-Philippe Gbamin,ci,MF,,Nantes,Ligue 1,29,1995,2.1,2,1,0,2,0,1,3,33.3,2,4,1,3,3,5,2
802,Yann Gboho,fr,MF,FW,Toulouse,Ligue 1,23,2001,13.3,18,6,5,8,5,9,17,52.9,8,10,0,10,3,21,3
803,David de Gea,es,GK,,Fiorentina,Serie A,34,1990,12.0,0,0,0,0,0,0,0,,0,0,0,0,0,0,2
804,Viggo Gebel,de,MF,,RB Leipzig,Bundesliga,17,2007,0.2,0,0,0,0,0,0,0,,0,0,0,0,0,0,0
805,Lutsharel Geertruida,nl,DF,,RB Leipzig,Bundesliga,24,2000,9.3,20,12,14,6,0,8,18,44.4,10,7,1,6,10,30,29
806,Dennis Geiger,de,MF,,Hoffenheim,Bundesliga,26,1998,2.4,10,7,2,7,1,3,6,50.0,3,5,0,5,1,11,2
807,Valentin Gendrey,fr,DF,,Lecce,Serie A,24,2000,2.0,2,2,1,0,1,1,1,100.0,0,3,1,2,2,4,1
808,Valentin Gendrey,fr,DF,,Hoffenheim,Bundesliga,24,2000,7.5,17,9,11,5,1,5,10,50.0,5,8,2,6,7,24,25
809,Denis Genreau,au,MF,FW,Toulouse,Ligue 1,25,1999,0.4,1,1,0,0,1,1,2,50.0,1,0,0,0,0,1,0
810,Yannick Gerhardt,de,MF,DF,Wolfsburg,Bundesliga,30,1994,4.4,10,6,6,4,0,4,7,57.1,3,10,0,10,7,17,14
811,Max Geschwill,de,DF,,Holstein Kiel,Bundesliga,23,2001,10.3,21,17,9,11,1,9,14,64.3,5,12,7,5,21,42,30
812,Daniele Ghilardi,it,DF,,Hellas Verona,Serie A,21,2003,6.1,10,6,5,5,0,6,12,50.0,6,6,4,2,7,17,34
813,Lautaro Gianetti,ar,DF,,Udinese,Serie A,31,1993,9.3,22,10,16,5,1,14,20,70.0,6,19,10,9,15,37,44
814,Dimitris Giannoulis,gr,DF,,Augsburg,Bundesliga,29,1995,10.8,18,12,10,7,1,15,24,62.5,9,21,6,15,17,35,26
815,Morgan Gibbs-White,eng,MF,,Nott'ham Forest,Premier League,24,2000,10.4,15,4,4,9,2,3,6,50.0,3,4,2,2,7,22,9
816,Samuel Gigot,fr,DF,,Lazio,Serie A,31,1993,0.9,0,0,0,0,0,0,1,0.0,1,2,1,1,1,1,3
817,Armin Gigovic,ba,MF,,Holstein Kiel,Bundesliga,22,2002,8.2,10,6,5,4,1,2,11,18.2,9,8,0,8,10,20,16
818,Bryan Gil,es,FW,MF,Girona,La Liga,23,2001,10.8,19,13,7,7,5,9,17,52.9,8,14,0,14,5,24,6
819,Mario Gila,es,DF,,Lazio,Serie A,24,2000,12.2,26,20,16,9,1,18,26,69.2,8,10,8,2,10,36,47
820,Billy Gilmour,sct,MF,,Brighton,Premier League,23,2001,1.1,3,3,2,1,0,3,4,75.0,1,1,0,1,0,3,1
821,Billy Gilmour,sct,MF,,Napoli,Serie A,23,2001,4.5,9,3,3,1,5,3,7,42.9,4,5,1,4,3,12,6
822,Benedikt Gimber,de,DF,,Heidenheim,Bundesliga,27,1997,13.5,42,24,32,10,0,23,34,67.6,11,27,8,19,15,57,73
823,Gvidas Gineitis,lt,MF,,Torino,Serie A,20,2004,6.1,10,4,4,4,2,5,11,45.5,6,6,2,4,4,14,14
824,Matthias Ginter,de,DF,,Freiburg,Bundesliga,30,1994,10.7,11,8,7,3,1,5,8,62.5,3,13,8,5,3,14,48
825,Jamie Gittens,eng,FW,MF,Dortmund,Bundesliga,20,2004,9.7,16,8,4,8,4,6,10,60.0,4,7,0,7,5,21,3
826,Serge Gnabry,de,FW,MF,Bayern Munich,Bundesliga,29,1995,5.5,7,5,3,1,3,3,7,42.9,4,4,0,4,4,11,3
827,Ben Godfrey,eng,DF,,Atalanta,Serie A,26,1998,0.3,0,0,0,0,0,0,1,0.0,1,1,1,0,0,0,0
828,Saba Goglichidze,ge,DF,,Empoli,Serie A,20,2004,11.6,31,19,19,11,1,14,22,63.6,8,11,6,5,14,45,33
829,Edoardo Goldaniga,it,DF,,Como,Serie A,31,1993,9.5,14,9,11,1,2,7,8,87.5,1,7,3,4,9,23,35
830,Pierluigi Gollini,it,GK,,Genoa,Serie A,29,1995,7.0,0,0,0,0,0,0,0,,0,1,0,1,0,0,2
831,Aleksandr Golovin,ru,MF,FW,Monaco,Ligue 1,28,1996,9.8,29,19,7,17,5,13,25,52.0,12,12,4,8,8,37,6
832,André Gomes,pt,MF,,Lille,Ligue 1,31,1993,4.3,5,3,2,2,1,2,7,28.6,5,2,1,1,3,8,2
833,Angel Gomes,eng,MF,,Lille,Ligue 1,24,2000,6.8,7,4,3,2,2,1,7,14.3,6,0,0,0,0,7,2
834,João Gomes,br,MF,,Wolves,Premier League,23,2001,14.1,49,25,29,19,1,12,40,30.0,28,14,1,13,11,60,11
835,Rodrigo Gomes,pt,DF,FW,Wolves,Premier League,21,2003,3.0,8,3,5,3,0,2,7,28.6,5,4,1,3,1,9,5
836,Toti Gomes,pt,DF,,Wolves,Premier League,25,1999,12.0,22,16,14,7,1,9,12,75.0,3,11,8,3,6,28,57
837,Carlos Gómez,co,MF,FW,Rennes,Ligue 1,22,2002,3.0,7,6,2,4,1,3,7,42.9,4,3,0,3,1,8,2
838,Dani Gómez,es,FW,,Valencia,La Liga,26,1998,4.7,3,2,0,0,3,0,0,,0,1,0,1,2,5,3
839,Joe Gomez,eng,DF,,Liverpool,Premier League,27,1997,3.4,9,6,3,6,0,8,13,61.5,5,7,6,1,5,14,9
840,Moi Gómez,es,MF,FW,Osasuna,La Liga,30,1994,4.2,9,5,3,5,1,2,4,50.0,2,2,1,1,5,14,3
841,Sergi Gómez,es,DF,,Espanyol,La Liga,32,1992,7.2,8,5,7,1,0,2,3,66.7,1,12,8,4,7,15,36
842,Sergio Gómez,es,MF,DF,Real Sociedad,La Liga,24,2000,14.2,42,25,17,19,6,17,30,56.7,13,23,1,22,9,51,15
843,Unai Gómez,es,MF,FW,Athletic Club,La Liga,21,2003,5.7,5,1,2,2,1,2,2,100.0,0,5,0,5,2,7,6
844,Fabio González,es,MF,,Las Palmas,La Liga,27,1997,0.6,0,0,0,0,0,0,1,0.0,1,0,0,0,0,0,0
845,Nicolás González,ar,FW,,Juventus,Serie A,26,1998,2.6,3,1,1,0,2,1,2,50.0,1,4,1,3,0,3,0
846,Urko González,es,MF,,Real Sociedad,La Liga,23,2001,0.5,0,0,0,0,0,0,0,,0,1,1,0,0,0,0
847,Anthony Gordon,eng,FW,,Newcastle Utd,Premier League,23,2001,13.1,16,8,7,7,2,6,17,35.3,11,18,1,17,5,21,1
848,Leon Goretzka,de,MF,DF,Bayern Munich,Bundesliga,29,1995,4.2,7,4,2,5,0,3,4,75.0,1,6,0,6,5,12,6
849,Andoni Gorosabel,es,DF,,Athletic Club,La Liga,28,1996,3.9,9,2,7,1,1,5,10,50.0,5,4,1,3,1,10,14
850,Robin Gosens,de,DF,,Fiorentina,Serie A,30,1994,12.6,27,15,15,7,5,11,20,55.0,9,9,1,8,9,36,37
851,Robin Gosens,de,DF,,Union Berlin,Bundesliga,30,1994,1.0,0,0,0,0,0,0,3,0.0,3,1,0,1,1,1,2
852,Mario Götze,de,MF,FW,Eint Frankfurt,Bundesliga,32,1992,6.2,14,11,5,6,3,6,17,35.3,11,6,1,5,4,18,6
853,Amine Gouiri,dz,MF,FW,Rennes,Ligue 1,24,2000,9.5,8,5,4,3,1,2,7,28.6,5,7,0,7,1,9,2
854,Jeffrey Gouweleeuw,nl,DF,,Augsburg,Bundesliga,33,1991,14.0,19,11,9,7,3,11,18,61.1,7,20,9,11,13,32,68
855,Kamil Grabara,pl,GK,,Wolfsburg,Bundesliga,25,1999,14.0,0,0,0,0,0,0,2,0.0,2,1,0,1,0,0,4
856,Jonathan Gradit,fr,DF,,Lens,Ligue 1,32,1992,8.3,18,9,10,7,1,10,19,52.6,9,9,4,5,12,30,26
857,José Gragera,es,MF,,Espanyol,La Liga,24,2000,6.3,25,16,11,14,0,9,17,52.9,8,9,1,8,5,30,13
858,Samuel Grandsir,fr,MF,FW,Le Havre,Ligue 1,28,1996,0.9,5,5,0,3,2,2,3,66.7,1,2,0,2,0,5,0
859,Alberto Grassi,it,MF,,Empoli,Serie A,29,1995,6.2,15,7,4,9,2,5,6,83.3,1,5,3,2,8,23,8
860,Ryan Gravenberch,nl,MF,,Liverpool,Premier League,22,2002,14.7,28,16,11,11,6,14,24,58.3,10,20,5,15,31,59,17
861,Archie Gray,eng,DF,MF,Tottenham,Premier League,18,2006,2.7,6,2,0,3,3,1,4,25.0,3,7,3,4,2,8,4
862,Jack Grealish,eng,FW,MF,Manchester City,Premier League,29,1995,5.4,8,4,4,2,2,2,4,50.0,2,8,2,6,2,10,3
863,Jacob Greaves,eng,DF,,Ipswich Town,Premier League,24,2000,8.0,17,7,7,9,1,7,12,58.3,5,9,7,2,9,26,48
864,Mason Greenwood,eng,FW,MF,Marseille,Ligue 1,23,2001,14.1,21,11,8,8,5,11,25,44.0,14,3,0,3,4,25,5
865,Michael Gregoritsch,at,FW,,Freiburg,Bundesliga,30,1994,3.2,3,2,1,0,2,0,2,0.0,2,2,1,1,0,3,5
866,Dominik Greif,sk,GK,,Mallorca,La Liga,27,1997,13.0,0,0,0,0,0,0,0,,0,0,0,0,0,0,5
867,Antoine Griezmann,fr,FW,MF,Atlético Madrid,La Liga,33,1991,14.0,13,9,8,3,2,4,16,25.0,12,11,0,11,5,18,12
868,Vincenzo Grifo,it,FW,MF,Freiburg,Bundesliga,31,1993,11.3,8,7,3,4,1,2,15,13.3,13,9,1,8,2,10,7
869,Florian Grillitsch,at,MF,,Hoffenheim,Bundesliga,29,1995,6.7,15,9,5,9,1,8,14,57.1,6,6,2,4,8,23,18
870,Álex Grimaldo,es,DF,,Leverkusen,Bundesliga,29,1995,13.8,14,7,7,4,3,10,21,47.6,11,8,2,6,11,25,18
871,Pascal Groß,de,MF,DF,Dortmund,Bundesliga,33,1991,11.0,20,12,5,12,3,6,17,35.3,11,14,2,12,3,23,10
872,Brajan Gruda,de,MF,,Brighton,Premier League,20,2004,1.0,3,1,0,3,0,3,4,75.0,1,2,0,2,0,3,1
873,Marco Grüll,at,MF,FW,Werder Bremen,Bundesliga,26,1998,5.1,5,3,0,2,3,1,6,16.7,5,5,1,4,2,7,2
874,Albert Grønbaek,dk,MF,FW,Rennes,Ligue 1,23,2001,8.3,21,11,10,7,4,10,26,38.5,16,7,0,7,4,25,6
875,Vicente Guaita,es,GK,,Celta Vigo,La Liga,37,1987,13.0,0,0,0,0,0,0,0,,0,0,0,0,0,0,4
876,Sergi Guardiola,es,FW,,Rayo Vallecano,La Liga,33,1991,0.9,3,2,0,3,0,0,0,,0,0,0,0,0,3,2
877,Nemanja Gudelj,rs,MF,DF,Sevilla,La Liga,33,1991,14.0,26,11,8,14,4,10,13,76.9,3,14,4,10,17,43,36
878,Gabriel Gudmundsson,se,DF,,Lille,Ligue 1,25,1999,10.9,20,14,6,10,4,14,24,58.3,10,14,4,10,7,27,20
879,Gonçalo Guedes,pt,FW,MF,Wolves,Premier League,28,1996,3.0,11,3,1,3,7,2,7,28.6,5,5,0,5,2,13,2
880,Axel Gueguin,fr,FW,,Montpellier,Ligue 1,19,2005,0.3,1,1,0,1,0,1,1,100.0,0,0,0,0,0,1,0
881,Marc Guéhi,eng,DF,,Crystal Palace,Premier League,24,2000,16.0,20,10,12,8,0,10,16,62.5,6,26,14,12,9,29,80
882,Mattéo Guendouzi,fr,MF,,Lazio,Serie A,25,1999,15.5,18,10,4,10,4,9,23,39.1,14,10,3,7,14,32,19
883,Javier Guerra,es,MF,FW,Valencia,La Liga,21,2003,9.2,27,13,8,11,8,12,22,54.5,10,5,0,5,5,32,15
884,Raphaël Guerreiro,pt,DF,MF,Bayern Munich,Bundesliga,30,1993,8.9,10,7,6,2,2,7,9,77.8,2,5,0,5,6,16,10
885,Evann Guessand,ci,FW,MF,Nice,Ligue 1,23,2001,14.4,18,9,2,9,7,0,2,0.0,2,10,1,9,6,24,9
886,Ander Guevara,es,MF,,Alavés,La Liga,27,1997,10.6,22,11,11,10,1,12,30,40.0,18,15,3,12,7,29,19
887,Pape Gueye,sn,MF,FW,Villarreal,La Liga,25,1999,9.8,21,12,12,6,3,9,11,81.8,2,7,1,6,9,30,15
888,Morgan Guilavogui,gn,FW,MF,St. Pauli,Bundesliga,26,1998,9.0,17,8,6,9,2,8,13,61.5,5,13,0,13,6,23,15
889,Frederic Guilbert,fr,DF,,Lecce,Serie A,29,1994,10.3,27,10,12,13,2,11,17,64.7,6,14,5,9,13,40,35
890,Luis Guilherme,br,MF,,West Ham,Premier League,18,2006,0.1,0,0,0,0,0,0,0,,0,1,0,1,0,0,0
891,Hugo Guillamón,es,MF,,Valencia,La Liga,24,2000,3.7,9,6,0,8,1,7,8,87.5,1,2,1,1,5,14,7
892,Bruno Guimarães,br,MF,,Newcastle Utd,Premier League,27,1997,15.5,34,20,16,14,4,14,27,51.9,13,14,5,9,14,48,13
893,Carlos Guirao,es,MF,,Betis,La Liga,21,2003,1.2,5,3,1,4,0,4,6,66.7,2,1,1,0,3,8,2
894,Bahereba Guirassy,fr,FW,MF,Nantes,Ligue 1,18,2006,1.2,2,2,0,0,2,1,3,33.3,2,3,0,3,0,2,1
895,Serhou Guirassy,gn,FW,,Dortmund,Bundesliga,28,1996,10.8,3,2,1,0,2,0,1,0.0,1,5,2,3,2,5,15
896,Marc Guiu,es,FW,,Chelsea,Premier League,18,2006,0.3,0,0,0,0,0,0,0,,0,0,0,0,0,0,0
897,Péter Gulácsi,hu,GK,,RB Leipzig,Bundesliga,34,1990,12.5,0,0,0,0,0,0,0,,0,0,0,0,0,0,4
898,Arda Güler,tr,MF,FW,Real Madrid,La Liga,19,2005,6.2,15,6,6,2,7,6,13,46.2,7,9,0,9,3,18,6
899,Gerard Gumbau,es,MF,,Rayo Vallecano,La Liga,30,1994,5.0,12,10,6,5,1,6,11,54.5,5,5,3,2,3,15,9
900,Robert Gumny,pl,DF,,Augsburg,Bundesliga,26,1998,0.3,0,0,0,0,0,0,2,0.0,2,0,0,0,0,0,0
901,İlkay Gündoğan,de,MF,,Manchester City,Premier League,34,1990,11.6,13,7,2,8,3,6,16,37.5,10,6,0,6,10,23,14
902,Christian Günter,de,DF,,Freiburg,Bundesliga,31,1993,13.3,10,8,6,4,0,6,14,42.9,8,13,7,6,6,16,25
903,Jon Guridi,es,MF,,Alavés,La Liga,29,1995,11.3,15,8,4,9,2,7,23,30.4,16,11,0,11,8,23,6
904,Gorka Guruzeta,es,FW,,Athletic Club,La Liga,28,1996,9.9,8,3,0,7,1,4,15,26.7,11,17,2,15,5,13,8
905,Malo Gusto,fr,DF,,Chelsea,Premier League,21,2003,10.6,29,19,17,11,1,17,30,56.7,13,18,5,13,12,41,23
906,Miguel Gutiérrez,es,DF,FW,Girona,La Liga,23,2001,15.9,26,16,13,12,1,9,19,47.4,10,8,3,5,9,35,18
907,Albert Guðmundsson,is,MF,,Fiorentina,Serie A,27,1997,3.1,2,1,1,1,0,2,4,50.0,2,1,0,1,4,6,2
908,Joško Gvardiol,hr,DF,,Manchester City,Premier League,22,2002,14.5,27,19,13,7,7,13,17,76.5,4,20,8,12,19,46,42
909,Emmanuel Gyasi,gh,DF,FW,Empoli,Serie A,30,1994,15.8,25,13,16,8,1,12,20,60.0,8,13,5,8,4,29,42
910,Christian Gytkjær,dk,FW,MF,Venezia,Serie A,34,1990,2.7,1,1,1,0,0,1,2,50.0,1,1,1,0,0,1,4
911,Erling Haaland,no,FW,,Manchester City,Premier League,24,2000,16.0,5,3,1,2,2,1,2,50.0,1,3,0,3,3,8,14
912,Nicolas Haas,ch,MF,,Empoli,Serie A,28,1996,3.2,11,8,4,5,2,5,9,55.6,4,2,1,1,4,15,6
913,Janik Haberer,de,DF,MF,Union Berlin,Bundesliga,30,1994,5.3,10,6,4,5,1,10,18,55.6,8,2,0,2,1,11,8
914,Robin Hack,de,FW,,Gladbach,Bundesliga,26,1998,7.6,9,9,4,3,2,5,11,45.5,6,5,0,5,1,10,7
915,Saad El Haddad,ma,MF,,Venezia,Serie A,19,2005,0.3,0,0,0,0,0,0,0,,0,0,0,0,0,0,0
916,Munir El Haddadi,ma,MF,FW,Leganés,La Liga,29,1995,4.8,11,8,5,4,2,3,9,33.3,6,6,1,5,0,11,1
917,Amadou Haidara,ml,MF,,RB Leipzig,Bundesliga,26,1998,7.8,17,10,8,8,1,7,13,53.8,6,19,6,13,7,24,31
918,Massadio Haïdara,ml,DF,,Brest,Ligue 1,32,1992,6.2,7,4,5,2,0,3,9,33.3,6,3,0,3,11,18,31
919,Antoine Hainaut,fr,DF,,Parma,Serie A,22,2002,6.6,12,9,7,4,1,6,7,85.7,1,8,2,6,5,17,31
920,Mohamed Haj,tn,MF,,Parma,Serie A,19,2005,2.7,2,1,1,1,0,1,1,100.0,0,1,0,1,3,5,2
921,Achraf Hakimi,ma,DF,,Paris S-G,Ligue 1,26,1998,12.4,28,23,12,10,6,16,28,57.1,12,11,0,11,17,45,8
922,Lewis Hall,eng,DF,,Newcastle Utd,Premier League,20,2004,13.6,30,21,10,12,8,20,41,48.8,21,23,13,10,14,44,47
923,Sébastien Haller,ci,FW,,Leganés,La Liga,30,1994,4.5,2,0,1,0,1,1,2,50.0,1,1,0,1,0,2,7
924,Ali Al Hamadi,iq,FW,,Ipswich Town,Premier League,22,2002,0.8,1,0,0,0,1,0,1,0.0,1,0,0,0,0,1,2
925,Andreas Hanche-Olsen,no,DF,,Mainz 05,Bundesliga,27,1997,4.3,4,1,1,2,1,0,0,,0,7,6,1,3,7,21
926,Florent Hanin,dz,DF,,Angers,Ligue 1,34,1990,11.7,28,23,14,10,4,16,28,57.1,12,5,2,3,21,49,38
927,Ridgeciano Haps,sr,DF,,Venezia,Serie A,31,1993,7.6,14,9,12,1,1,8,12,66.7,4,7,1,6,2,16,22
928,Amine Harit,ma,MF,,Marseille,Ligue 1,27,1997,5.2,7,6,0,5,2,1,2,50.0,1,6,0,6,3,10,1
929,Marcus Harness,eng,MF,,Ipswich Town,Premier League,28,1996,0.5,1,0,0,0,1,0,3,0.0,3,2,1,1,0,1,1
930,Phil Harres,de,FW,,Holstein Kiel,Bundesliga,22,2002,5.5,3,3,0,2,1,2,2,100.0,0,3,0,3,1,4,2
931,Jack Harrison,eng,FW,,Everton,Premier League,28,1996,8.1,13,8,5,3,5,6,15,40.0,9,4,0,4,5,18,13
932,Abdou Harroui,nl,MF,FW,Hellas Verona,Serie A,26,1998,5.1,9,6,6,3,0,4,4,100.0,0,5,0,5,2,11,5
933,Taylor Harwood-Bellis,eng,DF,,Southampton,Premier League,22,2002,13.6,9,6,6,2,1,7,11,63.6,4,34,23,11,13,22,57
934,Hans Hateboer,nl,DF,,Rennes,Ligue 1,30,1994,10.3,19,11,10,5,4,9,19,47.4,10,13,4,9,12,31,29
935,Kai Havertz,de,FW,,Arsenal,Premier League,25,1999,14.8,11,7,2,5,4,3,10,30.0,7,16,3,13,5,16,25
936,Jan Paul van Hecke,nl,DF,,Brighton,Premier League,24,2000,12.9,20,13,12,8,0,12,19,63.2,7,17,10,7,9,29,43
937,Hwang Hee-chan,kr,MF,FW,Wolves,Premier League,28,1996,3.5,3,2,1,1,1,1,2,50.0,1,7,0,7,1,4,3
938,Dean Henderson,eng,GK,,Crystal Palace,Premier League,27,1997,16.0,2,1,2,0,0,2,4,50.0,2,0,0,0,0,2,11
939,Liam Henderson,sct,MF,,Empoli,Serie A,28,1996,10.9,21,11,11,9,1,12,25,48.0,13,9,5,4,8,29,22
940,Ramon Hendriks,nl,DF,,Stuttgart,Bundesliga,23,2001,2.0,3,2,2,1,0,2,3,66.7,1,1,0,1,7,10,12
941,Paul Hennrich,de,MF,,Hoffenheim,Bundesliga,19,2005,0.1,0,0,0,0,0,0,0,,0,1,1,0,0,0,0
942,Benjamin Henrichs,de,DF,,RB Leipzig,Bundesliga,27,1997,9.4,29,14,16,9,4,14,24,58.3,10,20,3,17,14,43,28
943,Luis Henrique,br,FW,DF,Marseille,Ligue 1,23,2001,12.6,7,5,2,4,1,4,4,100.0,0,10,2,8,4,11,16
944,Mads Hermansen,dk,GK,,Leicester City,Premier League,24,2000,15.5,1,1,1,0,0,1,1,100.0,0,1,0,1,0,1,8
945,Mario Hermoso,es,DF,,Roma,Serie A,29,1995,2.8,2,1,2,0,0,0,1,0.0,1,1,1,0,4,6,13
946,Javi Hernández,es,DF,,Leganés,La Liga,26,1998,11.9,17,10,8,6,3,10,27,37.0,17,15,3,12,15,32,49
947,Aridane Hernández,es,DF,,Rayo Vallecano,La Liga,35,1989,1.3,2,1,2,0,0,0,0,,0,0,0,0,2,4,9
948,Lucas Hernández,fr,DF,,Paris S-G,Ligue 1,28,1996,0.3,0,0,0,0,0,0,0,,0,0,0,0,0,0,1
949,Theo Hernández,fr,DF,,Milan,Serie A,27,1997,10.4,12,8,11,0,1,6,11,54.5,5,9,5,4,12,24,25
950,Hernani,br,MF,,Parma,Serie A,30,1994,5.4,14,9,6,6,2,7,15,46.7,8,9,1,8,4,18,2
951,Jorge Herrando,es,DF,,Osasuna,La Liga,23,2001,4.2,3,2,2,1,0,2,3,66.7,1,6,5,1,1,4,19
952,Ander Herrera,es,MF,,Athletic Club,La Liga,35,1989,3.0,8,4,1,7,0,3,6,50.0,3,1,0,1,2,10,10
953,Sergio Herrera,es,GK,,Osasuna,La Liga,31,1993,17.0,1,0,1,0,0,1,2,50.0,1,1,0,1,0,1,15
954,Yangel Herrera,ve,MF,,Girona,La Liga,26,1998,8.9,28,17,12,14,2,13,23,56.5,10,7,1,6,12,40,17
955,Juan Herzog,es,DF,,Las Palmas,La Liga,21,2003,5.2,3,3,3,0,0,2,4,50.0,2,5,3,2,4,7,27
956,Son Heung-min,kr,FW,,Tottenham,Premier League,32,1992,10.9,6,3,1,4,1,2,13,15.4,11,5,0,5,3,9,8
957,Isak Hien,se,DF,,Atalanta,Serie A,25,1999,11.3,25,15,14,11,0,12,18,66.7,6,14,8,6,15,40,35
958,Omar El Hilali,ma,DF,,Espanyol,La Liga,21,2003,14.4,50,33,36,10,4,25,38,65.8,13,19,5,14,15,65,57
959,James Hill,eng,MF,,Bournemouth,Premier League,22,2002,0.1,0,0,0,0,0,0,0,,0,0,0,0,0,0,1
960,Piero Hincapié,ec,DF,,Leverkusen,Bundesliga,22,2002,12.7,22,18,10,8,4,13,21,61.9,8,18,9,9,17,39,31
961,Jack Hinshelwood,eng,MF,DF,Brighton,Premier League,19,2005,9.3,12,9,4,6,2,5,11,45.5,6,4,2,2,4,16,14
962,George Hirst,eng,FW,,Ipswich Town,Premier League,25,1999,2.0,1,1,1,0,0,0,1,0.0,1,0,0,0,0,1,4
963,Adam Hložek,cz,FW,MF,Hoffenheim,Bundesliga,22,2002,10.0,13,6,4,3,6,7,13,53.8,6,7,1,6,0,13,9
964,Ki-Jana Hoever,nl,DF,,Auxerre,Ligue 1,22,2002,10.5,22,16,14,6,2,13,22,59.1,9,16,1,15,11,33,29
965,Nicolas Höfler,de,MF,,Freiburg,Bundesliga,34,1990,5.0,16,11,4,11,1,8,16,50.0,8,3,0,3,11,27,18
966,Jonas Hofmann,de,MF,DF,Leverkusen,Bundesliga,32,1992,2.5,0,0,0,0,0,0,1,0.0,1,2,0,2,0,0,2
967,Philipp Hofmann,de,FW,,Bochum,Bundesliga,31,1993,10.5,8,6,2,3,3,2,5,40.0,3,5,0,5,1,9,17
968,Lucas Höler,de,FW,MF,Freiburg,Bundesliga,30,1994,5.3,12,6,4,7,1,2,11,18.2,9,9,3,6,1,13,11
969,Mason Holgate,eng,FW,DF,Everton,Premier League,28,1996,0.1,0,0,0,0,0,0,0,,0,0,0,0,0,0,0
970,Benedict Hollerbach,de,MF,FW,Union Berlin,Bundesliga,23,2001,11.4,18,11,5,9,4,10,17,58.8,7,13,0,13,1,19,3
971,Emil Holm,se,DF,,Bologna,Serie A,24,2000,3.5,12,8,5,5,2,6,10,60.0,4,3,1,2,3,15,9
972,Lewis Holtby,de,MF,,Holstein Kiel,Bundesliga,34,1990,7.8,19,10,10,8,1,5,13,38.5,8,6,1,5,13,32,10
973,Gerrit Holtmann,ph,DF,FW,Bochum,Bundesliga,29,1995,3.8,7,6,4,2,1,4,9,44.4,5,5,0,5,7,14,5
974,Franck Honorat,fr,FW,,Gladbach,Bundesliga,28,1996,10.0,9,2,4,2,3,1,3,33.3,2,6,1,5,3,12,17
975,Mathias Honsak,at,FW,MF,Heidenheim,Bundesliga,27,1996,5.6,10,6,7,3,0,7,12,58.3,5,5,2,3,5,15,16
976,Dinko Horkaš,hr,GK,,Las Palmas,La Liga,25,1999,2.3,0,0,0,0,0,0,0,,0,0,0,0,0,0,2
977,Cédric Hountondji,bj,DF,,Angers,Ligue 1,30,1994,3.0,6,4,4,2,0,3,7,42.9,4,3,3,0,4,10,14
978,Ilyes Housni,fr,FW,,Le Havre,Ligue 1,19,2005,1.6,5,4,0,3,2,2,4,50.0,2,2,0,2,1,6,1
979,Lukáš Hrádecký,fi,GK,,Leverkusen,Bundesliga,35,1989,13.0,0,0,0,0,0,0,0,,0,0,0,0,0,0,3
980,Robin Hranáč,cz,DF,,Hoffenheim,Bundesliga,24,2000,1.0,0,0,0,0,0,0,1,0.0,1,1,0,1,2,2,3
981,Callum Hudson-Odoi,eng,FW,,Nott'ham Forest,Premier League,24,2000,12.7,13,8,4,6,3,6,8,75.0,2,4,0,4,6,19,4
982,Will Hughes,eng,MF,,Crystal Palace,Premier League,29,1995,9.8,37,18,11,17,9,13,33,39.4,20,9,4,5,6,43,6
983,Dean Huijsen,es,DF,,Bournemouth,Premier League,19,2005,5.8,7,4,6,1,0,1,4,25.0,3,6,5,1,12,19,33
984,Mats Hummels,de,DF,,Roma,Serie A,36,1988,2.5,16,7,9,7,0,8,9,88.9,1,5,1,4,6,22,13
985,Omari Hutchinson,eng,MF,FW,Ipswich Town,Premier League,21,2003,14.6,18,8,8,7,3,9,28,32.1,19,14,1,13,6,24,7
986,Elseid Hysaj,al,DF,,Lazio,Serie A,30,1994,0.1,1,1,0,1,0,0,0,,0,0,0,0,0,1,1
987,Hong Hyunseok,kr,MF,,Mainz 05,Bundesliga,25,1999,3.3,4,1,2,1,1,0,1,0.0,1,3,1,2,4,8,6
988,Pierre Højbjerg,dk,MF,,Marseille,Ligue 1,29,1995,14.9,36,26,17,15,4,22,44,50.0,22,17,4,13,22,58,22
989,Oscar Højlund,dk,MF,,Eint Frankfurt,Bundesliga,19,2005,0.9,5,3,3,1,1,0,1,0.0,1,2,1,1,1,6,0
990,Rasmus Højlund,dk,FW,,Manchester Utd,Premier League,21,2003,7.6,1,0,0,0,1,0,1,0.0,1,2,0,2,1,2,3
991,Pablo Ibáñez,es,MF,,Osasuna,La Liga,26,1998,5.5,7,3,4,2,1,3,13,23.1,10,10,4,6,10,17,14
992,Arijon Ibrahimović,de,FW,,Bayern Munich,Bundesliga,19,2005,0.0,0,0,0,0,0,0,0,,0,0,0,0,0,0,0
993,Stanis Idumbo,be,FW,,Sevilla,La Liga,19,2005,1.5,5,3,3,1,1,2,4,50.0,2,2,0,2,3,8,0
994,Jay Idzes,id,DF,,Venezia,Serie A,24,2000,13.7,21,14,13,6,2,7,13,53.8,6,23,11,12,10,31,43
995,Iglesias,es,DF,,Getafe,La Liga,26,1998,13.9,42,26,20,19,3,23,46,50.0,23,20,3,17,28,70,57
996,Borja Iglesias,es,FW,,Celta Vigo,La Liga,31,1993,9.2,4,4,1,2,1,0,5,0.0,5,5,2,3,3,7,4
997,Igor,br,DF,,Brighton,Premier League,26,1998,8.3,3,3,1,1,1,3,6,50.0,3,19,11,8,2,5,38
998,Kelechi Iheanacho,ng,FW,,Sevilla,La Liga,28,1996,4.4,1,0,0,1,0,1,3,33.3,2,0,0,0,0,1,1
999,Jonathan Ikone,fr,FW,MF,Fiorentina,Serie A,26,1998,3.0,4,2,3,1,0,2,4,50.0,2,3,0,3,0,4,1
1000,George Ilenikhena,fr,FW,,Monaco,Ligue 1,18,2006,6.1,1,1,0,1,0,0,1,0.0,1,0,0,0,1,2,0
1001,Ivan Ilić,rs,MF,,Torino,Serie A,23,2001,6.4,2,1,0,1,1,0,4,0.0,4,0,0,0,4,6,3
1002,Rareş Ilie,ro,MF,,Nice,Ligue 1,21,2003,0.1,1,1,1,0,0,1,1,100.0,0,0,0,0,0,1,0
1003,Samuel Iling-Junior,eng,FW,MF,Bologna,Serie A,21,2003,1.2,3,2,1,1,1,0,1,0.0,1,0,0,0,2,5,1
1004,Danny Ings,eng,FW,,West Ham,Premier League,32,1992,2.0,2,1,2,0,0,1,2,50.0,1,0,0,0,1,3,2
1005,Alessio Iovine,it,DF,FW,Como,Serie A,33,1991,3.4,3,1,1,2,0,2,4,50.0,2,6,1,5,2,5,18
1006,Tim Iroegbunam,eng,MF,,Everton,Premier League,21,2003,4.3,18,9,9,4,5,7,12,58.3,5,6,0,6,8,26,5
1007,Jackson Irvine,au,MF,,St. Pauli,Bundesliga,31,1993,14.0,29,13,12,14,3,10,22,45.5,12,13,2,11,22,51,36
1008,Andy Irving,sct,MF,,West Ham,Premier League,24,2000,0.6,4,3,1,2,1,1,4,25.0,3,1,0,1,0,4,2
1009,Alexander Isak,se,FW,,Newcastle Utd,Premier League,25,1999,12.5,5,3,0,2,3,3,7,42.9,4,10,1,9,1,6,5
1010,Gustav Isaksen,dk,FW,,Lazio,Serie A,23,2001,9.8,8,3,4,4,0,3,13,23.1,10,3,0,3,4,12,6
1011,Isco,es,MF,,Betis,La Liga,32,1992,0.4,1,0,0,1,0,0,1,0.0,1,1,0,1,0,1,1
1012,Ismaily,br,DF,,Lille,Ligue 1,34,1990,0.9,2,0,0,1,1,0,1,0.0,1,4,0,4,0,2,2
1013,Ardian Ismajli,al,DF,,Empoli,Serie A,28,1996,16.0,12,11,9,3,0,6,9,66.7,3,23,18,5,33,45,139
1014,Yanis Issoufou,fr,FW,MF,Montpellier,Ligue 1,18,2006,0.8,5,3,4,1,0,3,5,60.0,2,1,0,1,0,5,1
1015,Ko Itakura,jp,DF,,Gladbach,Bundesliga,27,1997,14.0,21,14,11,9,1,12,18,66.7,6,16,8,8,12,33,65
1016,Junya Ito,jp,FW,,Reims,Ligue 1,31,1993,14.6,20,15,6,9,5,6,29,20.7,23,18,0,18,6,26,3
1017,Marko Ivezić,rs,DF,,Holstein Kiel,Bundesliga,23,2001,10.0,21,13,14,4,3,11,24,45.8,13,14,8,6,14,35,41
1018,Alex Iwobi,ng,FW,,Fulham,Premier League,28,1996,15.4,21,12,9,9,3,8,14,57.1,6,12,1,11,6,27,19
1019,Armando Izzo,it,DF,,Monza,Serie A,32,1992,13.3,23,11,16,7,0,10,21,47.6,11,21,15,6,23,46,37
1020,Fellipe Jack,br,DF,,Como,Serie A,18,2006,0.1,0,0,0,0,0,0,0,,0,1,1,0,1,1,2
1021,Nicolas Jackson,sn,FW,,Chelsea,Premier League,23,2001,13.1,10,6,2,4,4,1,5,20.0,4,8,1,7,2,12,12
1022,Lee Jae-sung,kr,MF,,Mainz 05,Bundesliga,32,1992,12.2,16,7,4,9,3,6,14,42.9,8,14,1,13,17,33,15
1023,Kristijan Jakić,hr,MF,,Augsburg,Bundesliga,27,1997,10.4,21,9,7,13,1,8,18,44.4,10,21,3,18,13,34,21
1024,Karl Jakob Hein,ee,GK,,Valladolid,La Liga,22,2002,17.0,0,0,0,0,0,0,1,0.0,1,0,0,0,0,0,13
1025,Ismail Jakobs,sn,DF,,Monaco,Ligue 1,25,1999,2.0,5,5,3,0,2,3,5,60.0,2,0,0,0,2,7,6
1026,Jordan James,wls,MF,,Rennes,Ligue 1,20,2004,3.4,6,3,3,2,1,5,7,71.4,2,4,0,4,4,10,4
1027,Reece James,eng,DF,,Chelsea,Premier League,25,1999,2.7,2,2,2,0,0,1,3,33.3,2,4,2,2,3,5,5
1028,Vitaly Janelt,de,MF,,Brentford,Premier League,26,1998,12.8,17,10,7,6,4,9,18,50.0,9,19,4,15,11,28,32
1029,Adnan Januzaj,be,FW,MF,Las Palmas,La Liga,29,1995,2.8,3,2,1,2,0,1,2,50.0,1,2,0,2,0,3,2
1030,Vitezslav Jaros,cz,GK,,Liverpool,Premier League,23,2001,0.1,0,0,0,0,0,0,0,,0,0,0,0,0,0,0
1031,Ali Jasim,iq,FW,DF,Como,Serie A,20,2004,0.1,1,0,1,0,0,1,1,100.0,0,0,0,0,0,1,0
1032,Mikel Jauregizar,es,MF,,Athletic Club,La Liga,21,2003,10.0,33,18,8,17,8,18,32,56.3,14,8,1,7,12,45,11
1033,Dominik Javorček,sk,DF,,Holstein Kiel,Bundesliga,22,2002,0.9,1,0,1,0,0,1,2,50.0,1,1,1,0,2,3,4
1034,Gaby Jean,fr,DF,,Lecce,Serie A,24,2000,2.3,2,1,1,0,1,0,1,0.0,1,4,3,1,0,2,12
1035,Daniel Jebbison,eng,FW,,Bournemouth,Premier League,21,2003,0.3,0,0,0,0,0,0,1,0.0,1,0,0,0,0,0,1
1036,Fredrik Jensen,fi,MF,DF,Augsburg,Bundesliga,27,1997,1.3,1,1,0,0,1,1,1,100.0,0,2,0,2,0,1,1
1037,Mathias Jensen,dk,MF,,Brentford,Premier League,28,1996,5.3,4,3,2,1,1,2,6,33.3,4,7,1,6,4,8,6
1038,Moritz Jenz,de,DF,,Mainz 05,Bundesliga,25,1999,7.0,14,6,6,8,0,5,8,62.5,3,9,7,2,9,23,51
1039,Gabriel Jesus,br,FW,,Arsenal,Premier League,27,1997,3.0,5,4,4,1,0,3,5,60.0,2,5,1,4,3,8,2
1040,Juan Jesus,br,DF,,Napoli,Serie A,33,1991,0.9,0,0,0,0,0,0,0,,0,0,0,0,0,0,3
1041,Alejandro Jiménez,es,DF,,Milan,Serie A,19,2005,1.0,1,1,1,0,0,1,2,50.0,1,2,0,2,0,1,1
1042,Raúl Jiménez,mx,FW,,Fulham,Premier League,33,1991,10.8,16,9,2,10,4,3,9,33.3,6,5,1,4,5,21,7
1043,João Pedro,br,MF,FW,Brighton,Premier League,23,2001,7.5,7,4,1,4,2,1,3,33.3,2,4,0,4,4,11,5
1044,John Joe,ie,MF,FW,Getafe,La Liga,21,2003,0.5,0,0,0,0,0,0,0,,0,1,1,0,0,0,1
1045,Joelinton,br,MF,FW,Newcastle Utd,Premier League,28,1996,14.7,33,19,13,13,7,13,24,54.2,11,22,3,19,12,45,26
1046,Jofre,es,MF,FW,Espanyol,La Liga,23,2001,11.2,7,7,4,3,0,4,9,44.4,5,3,0,3,9,16,11
1047,Þórir Jóhann Helgason,is,MF,FW,Lecce,Serie A,24,2000,0.4,2,1,1,1,0,1,1,100.0,0,1,0,1,1,3,2
1048,Carl Johansson,se,DF,,Holstein Kiel,Bundesliga,30,1994,3.9,4,2,4,0,0,3,6,50.0,3,7,6,1,6,10,23
1049,Ben Johnson,eng,DF,FW,Ipswich Town,Premier League,24,2000,5.6,22,13,14,7,1,13,21,61.9,8,9,3,6,9,31,10
1050,Brennan Johnson,wls,FW,,Tottenham,Premier League,23,2001,13.0,26,16,4,14,8,11,21,52.4,10,13,2,11,3,29,8
1051,Karl-Johan Johnsson,se,GK,,Strasbourg,Ligue 1,34,1990,3.0,0,0,0,0,0,0,1,0.0,1,0,0,0,0,0,3
1052,Sam Johnstone,eng,GK,,Wolves,Premier League,31,1993,7.0,0,0,0,0,0,0,1,0.0,1,0,0,0,0,0,7
1053,Paul Joly,fr,DF,,Auxerre,Ligue 1,24,2000,5.7,20,13,14,6,0,11,23,47.8,12,6,0,6,14,34,19
1054,Curtis Jones,eng,MF,,Liverpool,Premier League,23,2001,7.1,13,6,2,9,2,5,10,50.0,5,8,4,4,1,14,5
1055,Frenkie de Jong,nl,MF,,Barcelona,La Liga,27,1997,2.6,1,1,0,1,0,0,1,0.0,1,3,0,3,1,2,0
1056,Joan Jordán,es,MF,,Alavés,La Liga,30,1994,5.8,16,9,7,7,2,7,15,46.7,8,7,0,7,3,19,8
1057,Jorginho,it,MF,,Arsenal,Premier League,32,1991,4.4,8,3,1,5,2,5,11,45.5,6,0,0,0,5,13,1
1058,Jesse Joronen,fi,GK,,Venezia,Serie A,31,1993,7.0,0,0,0,0,0,0,0,,0,0,0,0,0,0,3
1059,Jota,pt,FW,MF,Rennes,Ligue 1,25,1999,3.7,5,2,2,3,0,4,7,57.1,3,1,0,1,3,8,2
1060,Diogo Jota,pt,FW,,Liverpool,Premier League,28,1996,5.6,4,2,0,3,1,3,7,42.9,4,1,0,1,3,7,3
1061,Antoine Joujou,fr,MF,FW,Le Havre,Ligue 1,21,2003,3.9,6,5,4,1,1,2,4,50.0,2,8,2,6,3,9,3
1062,Luka Jović,rs,FW,,Milan,Serie A,26,1997,0.9,0,0,0,0,0,0,0,,0,0,0,0,1,1,0
1063,Juanmi,es,FW,MF,Betis,La Liga,31,1993,2.1,6,3,3,2,1,3,5,60.0,2,4,0,4,1,7,4
1064,Juanpe,es,DF,,Girona,La Liga,33,1991,3.6,7,4,4,3,0,6,7,85.7,1,7,3,4,4,11,23
1065,Jubal,br,DF,,Auxerre,Ligue 1,31,1993,12.4,27,19,24,3,0,13,22,59.1,9,29,14,15,9,36,71
1066,Abdulai Juma Bah,sl,DF,,Valladolid,La Liga,18,2006,7.1,7,6,4,3,0,2,4,50.0,2,11,7,4,7,14,48
1067,Anthony Jung,de,DF,,Werder Bremen,Bundesliga,33,1991,9.4,12,8,10,2,0,6,10,60.0,4,6,2,4,14,26,35
1068,Luiz Lúcio Reis Júnior,br,GK,,Villarreal,La Liga,23,2001,1.2,0,0,0,0,0,0,0,,0,0,0,0,0,0,2
1069,Hamed Junior Traorè,ci,MF,,Auxerre,Ligue 1,24,2000,11.1,20,10,5,9,6,6,28,21.4,22,5,0,5,4,24,7
1070,Vinicius Júnior,br,FW,,Real Madrid,La Liga,24,2000,12.2,11,6,4,2,5,3,7,42.9,4,5,0,5,0,11,1
1071,Josip Juranović,hr,DF,,Union Berlin,Bundesliga,29,1995,0.2,1,0,1,0,0,0,0,,0,1,0,1,0,1,0
1072,David Jurásek,cz,DF,FW,Hoffenheim,Bundesliga,24,2000,1.7,2,1,1,0,1,0,0,,0,2,0,2,2,4,5
1073,Stanko Jurić,hr,MF,,Valladolid,La Liga,28,1996,10.7,28,15,15,12,1,14,33,42.4,19,16,5,11,12,40,41
1074,James Justin,eng,DF,,Leicester City,Premier League,26,1998,14.9,35,21,19,12,4,19,33,57.6,14,23,6,17,24,59,62
1075,Filip Jørgensen,dk,GK,,Chelsea,Premier League,22,2002,1.0,0,0,0,0,0,0,0,,0,0,0,0,0,0,0
1076,Mohamed Kaba,fr,MF,,Lecce,Serie A,23,2001,1.0,6,3,2,4,0,4,5,80.0,1,3,1,2,0,6,2
1077,Yusuf Kabadayı,de,FW,MF,Augsburg,Bundesliga,20,2004,0.8,1,0,0,1,0,0,0,,0,1,0,1,0,1,0
1078,Almugera Kabar,de,DF,,Dortmund,Bundesliga,18,2006,0.5,2,2,0,2,0,0,0,,0,1,0,1,1,3,2
1079,Christian Kabasele,be,DF,,Udinese,Serie A,33,1991,7.2,9,5,5,4,0,4,5,80.0,1,8,2,6,7,16,27
1080,Yaya Kader Fofana,ml,MF,FW,Reims,Ligue 1,20,2004,7.0,17,11,8,5,4,4,12,33.3,8,11,2,9,3,20,2
1081,Pavel Kadeřábek,cz,DF,,Hoffenheim,Bundesliga,32,1992,7.6,14,7,7,2,5,8,16,50.0,8,7,2,5,10,24,20
1082,Tino Kadewere,zw,MF,FW,Nantes,Ligue 1,28,1996,5.3,13,7,4,3,6,6,12,50.0,6,3,0,3,5,18,8
1083,Ferdi Kadioglu,tr,DF,MF,Brighton,Premier League,25,1999,4.3,10,6,4,5,1,6,15,40.0,9,2,2,0,8,18,17
1084,Arnaud Kalimuendo,fr,FW,,Rennes,Ligue 1,22,2002,12.1,6,4,2,2,2,2,3,66.7,1,4,1,3,1,7,2
1085,Pierre Kalulu,fr,DF,,Juventus,Serie A,24,2000,12.0,11,7,8,3,0,7,8,87.5,1,13,8,5,7,18,23
1086,Daichi Kamada,jp,MF,,Crystal Palace,Premier League,28,1996,7.2,20,10,7,11,2,5,18,27.8,13,9,2,7,8,28,8
1087,Waren Kamanzi,no,DF,MF,Toulouse,Ligue 1,24,2000,7.6,23,11,9,11,3,12,21,57.1,9,2,0,2,5,28,17
1088,Boubacar Kamara,fr,MF,,Aston Villa,Premier League,25,1999,3.8,6,3,2,3,1,3,11,27.3,8,5,3,2,6,12,10
1089,Glen Kamara,fi,MF,,Rennes,Ligue 1,29,1995,7.4,23,11,10,11,2,11,17,64.7,6,7,0,7,7,30,7
1090,Hassane Kamara,ci,DF,,Udinese,Serie A,30,1994,7.3,15,10,5,8,2,4,10,40.0,6,9,2,7,9,24,15
1091,Willy Kambwala,fr,DF,,Villarreal,La Liga,20,2004,1.0,4,2,3,0,1,2,2,100.0,0,1,1,0,0,4,6
1092,Jakub Kamiński,pl,DF,MF,Wolfsburg,Bundesliga,22,2002,7.4,11,5,5,2,4,5,16,31.3,11,12,6,6,8,19,13
1093,Kevin Kampl,si,MF,,RB Leipzig,Bundesliga,34,1990,8.3,11,7,3,4,4,7,13,53.8,6,11,2,9,12,23,12
1094,Nordine Kandil,fr,MF,,Strasbourg,Ligue 1,23,2001,0.1,0,0,0,0,0,0,0,,0,0,0,0,0,0,1
1095,Harry Kane,eng,FW,,Bayern Munich,Bundesliga,31,1993,10.7,2,2,0,1,1,0,2,0.0,2,3,0,3,0,2,5
1096,Lee Kang-in,kr,FW,MF,Paris S-G,Ligue 1,23,2001,9.8,15,10,5,5,5,13,21,61.9,8,2,0,2,1,16,3
1097,Yann Karamoh,fr,FW,MF,Torino,Serie A,26,1998,2.1,3,1,2,0,1,3,5,60.0,2,2,1,1,0,3,1
1098,Atakan Karazor,,MF,,Stuttgart,Bundesliga,28,1996,11.7,24,9,5,12,7,14,25,56.0,11,13,1,12,13,37,12
1099,Jesper Karlsson,se,FW,,Bologna,Serie A,26,1998,3.3,1,0,0,0,1,0,2,0.0,2,4,0,4,0,1,3
1100,Jesper Karlström,se,MF,,Udinese,Serie A,29,1995,15.1,27,13,14,10,3,10,22,45.5,12,10,6,4,21,48,38
1101,Lior Kasa,il,MF,,Genoa,Serie A,19,2005,0.2,0,0,0,0,0,0,0,,0,0,0,0,1,1,0
1102,Grigoris Kastanos,cy,MF,FW,Hellas Verona,Serie A,26,1998,5.3,10,5,3,2,5,4,9,44.4,5,10,1,9,5,15,2
1103,Mikkel Kaufmann,dk,FW,,Heidenheim,Bundesliga,23,2001,3.6,5,3,1,2,2,1,3,33.3,2,5,2,3,1,6,7
1104,Michael Kayode,it,DF,FW,Fiorentina,Serie A,20,2004,0.4,1,1,1,0,0,0,0,,0,2,1,1,0,1,4
1105,Moise Kean,it,FW,,Fiorentina,Serie A,24,2000,12.5,5,3,0,2,3,2,3,66.7,1,4,0,4,0,5,8
1106,Michael Keane,eng,DF,,Everton,Premier League,31,1993,9.0,10,7,7,2,1,7,10,70.0,3,9,6,3,10,20,50
1107,Yassine Kechta,ma,MF,FW,Le Havre,Ligue 1,22,2002,10.7,30,19,14,13,3,15,39,38.5,24,13,2,11,12,42,7
1108,Thilo Kehrer,de,DF,,Monaco,Ligue 1,28,1996,12.0,26,18,19,7,0,15,25,60.0,10,7,5,2,12,38,59
1109,Abdoulaye Keita,es,FW,MF,Getafe,La Liga,22,2002,0.9,2,2,0,1,1,2,3,66.7,1,1,0,1,0,2,2
1110,Mandela Keita,be,MF,,Parma,Serie A,22,2002,4.2,9,3,1,7,1,1,4,25.0,3,4,2,2,4,13,5
1111,Yannik Keitel,de,MF,FW,Stuttgart,Bundesliga,24,2000,0.1,0,0,0,0,0,0,0,,0,1,0,1,0,0,1
1112,Andu Kelati,de,MF,,Holstein Kiel,Bundesliga,22,2002,1.1,1,1,1,0,0,0,1,0.0,1,1,0,1,2,3,1
1113,Caoimhín Kelleher,ie,GK,,Liverpool,Premier League,26,1998,8.0,0,0,0,0,0,0,0,,0,0,0,0,0,0,0
1114,Lloyd Kelly,eng,DF,,Newcastle Utd,Premier League,26,1998,3.3,5,4,4,1,0,1,1,100.0,0,6,4,2,1,6,16
1115,Aljoscha Kemlein,de,MF,,Union Berlin,Bundesliga,20,2004,6.7,7,2,3,3,1,4,11,36.4,7,9,1,8,4,11,8
1116,Marc-Oliver Kempf,de,DF,,Como,Serie A,29,1995,13.0,12,10,4,7,1,4,8,50.0,4,9,4,5,22,34,51
1117,Kenedy,br,MF,FW,Valladolid,La Liga,28,1996,0.1,0,0,0,0,0,0,0,,0,1,0,1,0,0,0
1118,Luca Kerber,de,MF,DF,Heidenheim,Bundesliga,22,2002,1.8,5,3,4,1,0,2,4,50.0,2,3,1,2,0,5,6
1119,Milos Kerkez,hu,DF,,Bournemouth,Premier League,21,2003,15.2,22,11,8,12,2,10,16,62.5,6,14,6,8,16,38,41
1120,Reda Khadra,de,MF,FW,Reims,Ligue 1,23,2001,0.9,1,1,1,0,0,0,1,0.0,1,0,0,0,0,1,1
1121,Bilal El Khannouss,ma,MF,FW,Leicester City,Premier League,20,2004,5.7,15,6,5,7,3,4,7,57.1,3,4,0,4,3,18,2
1122,Wahbi Khazri,tn,FW,MF,Montpellier,Ligue 1,33,1991,7.2,15,10,4,8,3,4,10,40.0,6,5,1,4,4,19,4
1123,Rani Khedira,de,MF,,Union Berlin,Bundesliga,30,1994,13.6,27,18,8,17,2,10,15,66.7,5,14,5,9,22,49,13
1124,Abdukodir Khusanov,uz,DF,,Lens,Ligue 1,20,2004,10.8,15,11,9,5,1,7,11,63.6,4,17,11,6,26,41,57
1125,Kialonda,ao,DF,,Lecce,Serie A,27,1997,15.0,24,7,18,6,0,10,12,83.3,2,30,21,9,17,41,73
1126,Kiké,es,FW,,Alavés,La Liga,35,1989,10.4,6,6,1,4,1,1,3,33.3,2,1,1,0,0,6,9
1127,Max Kilman,eng,DF,,West Ham,Premier League,27,1997,16.0,16,7,7,7,2,11,15,73.3,4,30,20,10,20,36,90
1128,Joshua Kimmich,de,MF,,Bayern Munich,Bundesliga,29,1995,14.0,24,16,6,14,4,16,24,66.7,8,7,0,7,10,34,14
1129,Joshua King,eng,MF,,Fulham,Premier League,17,2007,0.1,2,1,0,2,0,0,1,0.0,1,0,0,0,1,3,0
1130,Joshua King,no,FW,MF,Toulouse,Ligue 1,32,1992,9.1,6,6,2,2,2,2,6,33.3,4,5,2,3,2,8,10
1131,Cédric Kipré,ci,DF,,Reims,Ligue 1,28,1996,9.8,22,15,17,5,0,17,22,77.3,5,15,7,8,15,37,57
1132,Jakub Kiwior,pl,DF,,Arsenal,Premier League,24,2000,3.6,4,2,3,1,0,3,5,60.0,2,5,2,3,1,5,16
1133,Tim Kleindienst,de,FW,,Gladbach,Bundesliga,29,1995,13.7,13,6,1,6,6,5,17,29.4,12,19,2,17,6,19,25
1134,Lukas Klostermann,de,DF,,RB Leipzig,Bundesliga,28,1996,8.4,11,7,7,3,1,5,10,50.0,5,18,9,9,10,21,39
1135,Justin Kluivert,nl,MF,FW,Bournemouth,Premier League,25,1999,10.9,13,8,3,6,4,3,8,37.5,5,11,0,11,8,21,13
1136,Ansgar Knauff,de,MF,DF,Eint Frankfurt,Bundesliga,22,2002,7.3,22,12,10,7,5,4,6,66.7,2,12,1,11,7,29,9
1137,Magnus Knudsen,no,MF,,Holstein Kiel,Bundesliga,23,2001,10.2,28,17,14,9,5,16,23,69.6,7,11,4,7,8,36,15
1138,Gregor Kobel,ch,GK,,Dortmund,Bundesliga,27,1997,12.0,0,0,0,0,0,0,0,,0,0,0,0,0,0,5
1139,Robin Koch,de,DF,,Eint Frankfurt,Bundesliga,28,1996,13.8,8,3,5,3,0,3,9,33.3,6,28,17,11,12,20,72
1140,Magnus Kofod Andersen,dk,MF,,Venezia,Serie A,25,1999,6.4,9,2,2,6,1,2,6,33.3,4,4,1,3,5,14,10
1141,Derrick Köhn,de,DF,,Werder Bremen,Bundesliga,25,1999,7.9,7,4,3,3,1,3,4,75.0,1,13,4,9,4,11,15
1142,Philipp Köhn,ch,GK,,Monaco,Ligue 1,26,1998,8.0,0,0,0,0,0,0,1,0.0,1,0,0,0,0,0,4
1143,Dominik Kohr,de,DF,,Mainz 05,Bundesliga,30,1994,12.8,29,23,18,8,3,16,26,61.5,10,21,10,11,20,49,62
1144,Koke,es,MF,,Atlético Madrid,La Liga,32,1992,12.4,27,19,10,11,6,15,27,55.6,12,14,0,14,12,39,17
1145,Sead Kolašinac,ba,DF,,Atalanta,Serie A,31,1993,9.5,16,9,8,8,0,6,12,50.0,6,4,1,3,14,30,18
1146,Randal Kolo Muani,fr,FW,,Paris S-G,Ligue 1,26,1998,4.0,4,4,1,1,2,0,2,0.0,2,1,0,1,0,4,5
1147,Marco Komenda,hr,DF,,Holstein Kiel,Bundesliga,28,1996,2.2,6,4,3,2,1,4,4,100.0,0,3,1,2,0,6,10
1148,Mert Kömür,de,MF,,Augsburg,Bundesliga,19,2005,1.5,1,0,1,0,0,0,0,,0,3,2,1,3,4,1
1149,Ibrahima Konaté,fr,DF,,Liverpool,Premier League,25,1999,10.8,14,10,10,3,1,9,12,75.0,3,13,5,8,4,18,44
1150,Ismael Konate,ci,FW,DF,Empoli,Serie A,18,2006,0.1,0,0,0,0,0,0,0,,0,0,0,0,0,0,0
1151,Geoffrey Kondogbia,cf,DF,MF,Marseille,Ligue 1,31,1993,12.2,34,20,20,13,1,21,24,87.5,3,11,1,10,11,45,36
1152,Abdoul Koné,fr,DF,,Reims,Ligue 1,19,2005,1.2,5,3,4,1,0,3,5,60.0,2,2,1,1,1,6,4
1153,Amadou Koné,ml,MF,,Reims,Ligue 1,19,2005,5.2,21,14,12,9,0,10,13,76.9,3,9,2,7,6,27,7
1154,Ismaël Koné,ca,MF,FW,Marseille,Ligue 1,22,2002,3.5,6,3,3,2,1,2,3,66.7,1,4,1,3,3,9,2
1155,Manu Koné,fr,MF,,Roma,Serie A,23,2001,10.9,18,12,7,7,4,12,24,50.0,12,4,0,4,12,30,7
1156,Ezri Konsa,eng,DF,,Aston Villa,Premier League,27,1997,13.1,19,11,11,4,4,11,13,84.6,2,6,3,3,10,29,42
1157,Teun Koopmeiners,nl,MF,FW,Juventus,Serie A,26,1998,9.9,14,10,3,9,2,5,15,33.3,10,9,3,6,4,18,8
1158,Odilon Kossounou,ci,DF,,Atalanta,Serie A,23,2001,6.0,8,5,6,2,0,3,6,50.0,3,10,2,8,5,13,9
1159,Christian Kouamé,ci,FW,MF,Fiorentina,Serie A,27,1997,6.3,12,7,4,3,5,0,3,0.0,3,2,0,2,2,14,9
1160,Henri Koudossou,de,DF,,Augsburg,Bundesliga,25,1999,3.8,7,6,2,4,1,6,9,66.7,3,3,2,1,5,12,20
1161,Konstantinos Koulierakis,gr,DF,,Wolfsburg,Bundesliga,21,2003,10.3,16,7,10,4,2,9,15,60.0,6,17,9,8,12,28,56
1162,Emmanuel Koum Mbondo,fr,DF,,Marseille,Ligue 1,18,2006,0.1,0,0,0,0,0,0,0,,0,0,0,0,0,0,0
1163,Jules Koundé,fr,DF,,Barcelona,La Liga,26,1998,15.9,39,27,17,17,5,32,42,76.2,10,19,3,16,7,46,39
1164,Boubakar Kouyaté,ml,DF,,Montpellier,Ligue 1,27,1997,1.2,4,1,3,1,0,3,5,60.0,2,0,0,0,3,7,5
1165,Mateo Kovačić,hr,MF,,Manchester City,Premier League,30,1994,10.0,22,14,5,12,5,11,25,44.0,14,11,0,11,5,27,6
1166,Matej Kovar,cz,GK,,Leverkusen,Bundesliga,24,2000,1.0,0,0,0,0,0,0,0,,0,0,0,0,0,0,0
1167,Mateusz Kowalski,pl,MF,,Parma,Serie A,19,2005,0.6,0,0,0,0,0,0,0,,0,1,0,1,0,0,1
1168,Caleb Kporha,eng,DF,,Crystal Palace,Premier League,18,2006,0.0,0,0,0,0,0,0,0,,0,0,0,0,0,0,0
1169,Emil Krafth,se,DF,,Newcastle Utd,Premier League,30,1994,2.7,2,1,0,1,1,1,2,50.0,1,5,4,1,2,4,10
1170,Alex Král,cz,MF,,Espanyol,La Liga,26,1998,15.4,38,26,21,17,0,9,16,56.3,7,20,8,12,15,53,25
1171,Andrej Kramarić,hr,MF,FW,Hoffenheim,Bundesliga,33,1991,12.0,6,3,1,5,0,3,6,50.0,3,5,2,3,0,6,6
1172,Frans Krätzig,de,DF,,Stuttgart,Bundesliga,21,2003,0.6,2,1,1,0,1,1,3,33.3,2,2,1,1,0,2,1
1173,Ladislav Krejčí,cz,DF,,Girona,La Liga,25,1999,8.1,7,4,6,1,0,3,9,33.3,6,9,7,2,15,22,26
1174,Rasmus Kristensen,dk,DF,,Eint Frankfurt,Bundesliga,27,1997,10.4,19,10,15,2,2,15,28,53.6,13,15,4,11,10,29,33
1175,Thomas Kristensen,dk,DF,,Udinese,Serie A,22,2002,4.1,5,3,3,2,0,3,6,50.0,3,2,2,0,3,8,14
1176,Nikola Krstović,me,FW,,Lecce,Serie A,24,2000,15.0,11,5,4,3,4,5,10,50.0,5,8,5,3,5,16,9
1177,Lukas Kübler,de,DF,,Freiburg,Bundesliga,32,1992,11.8,23,10,11,10,2,16,24,66.7,8,22,9,13,28,51,31
1178,Takefusa Kubo,jp,MF,FW,Real Sociedad,La Liga,23,2001,12.9,20,13,7,7,6,12,23,52.2,11,26,1,25,8,28,5
1179,Mohammed Kudus,gh,MF,FW,West Ham,Premier League,24,2000,10.0,14,10,4,6,4,4,13,30.8,9,13,1,12,1,15,1
1180,Dejan Kulusevski,se,MF,FW,Tottenham,Premier League,24,2000,13.7,17,9,5,4,8,6,21,28.6,15,15,3,12,8,25,8
1181,Sael Kumbedi,fr,DF,,Lyon,Ligue 1,19,2005,2.0,5,2,1,3,1,4,5,80.0,1,0,0,0,4,9,5
1182,Marash Kumbulla,al,DF,,Espanyol,La Liga,24,2000,12.2,17,11,12,3,2,9,17,52.9,8,25,18,7,12,29,77
1183,Daler Kuzyaev,ru,MF,,Le Havre,Ligue 1,31,1993,5.7,12,7,6,4,2,2,9,22.2,7,7,4,3,9,21,7
1184,Khvicha Kvaratskhelia,ge,FW,MF,Napoli,Serie A,23,2001,12.1,14,8,4,9,1,4,13,30.8,9,12,0,12,2,16,7
1185,Moritz-Broni Kwarteng,gh,MF,FW,Bochum,Bundesliga,26,1998,1.9,4,3,1,1,2,1,2,50.0,1,0,0,0,0,4,1
1186,Giorgos Kyriakopoulos,gr,DF,,Monza,Serie A,28,1996,16.0,29,18,13,14,2,19,35,54.3,16,20,5,15,16,45,43
1187,Luca de la Torre,us,MF,,Celta Vigo,La Liga,26,1998,0.0,0,0,0,0,0,0,0,,0,0,0,0,0,0,0
1188,Rémy Labeau Lascary,gp,FW,MF,Lens,Ligue 1,21,2003,7.1,16,10,7,6,3,5,11,45.5,6,5,0,5,1,17,7
1189,Gaëtan Laborde,fr,FW,,Nice,Ligue 1,30,1994,4.3,6,4,4,2,0,4,10,40.0,6,5,0,5,2,8,3
1190,Nediljko Labrović,hr,GK,,Augsburg,Bundesliga,25,1999,14.0,0,0,0,0,0,0,0,,0,0,0,0,0,0,12
1191,Alexandre Lacazette,fr,FW,,Lyon,Ligue 1,33,1991,10.5,5,2,1,3,1,3,10,30.0,7,5,0,5,3,8,1
1192,Maxence Lacroix,fr,DF,,Crystal Palace,Premier League,24,2000,13.0,27,16,20,6,1,12,20,60.0,8,17,6,11,24,51,69
1193,Alban Lafont,fr,GK,,Nantes,Ligue 1,25,1999,12.0,1,1,1,0,0,1,1,100.0,0,2,0,2,0,1,8
1194,Konrad Laimer,at,DF,,Bayern Munich,Bundesliga,27,1997,4.6,15,8,3,9,3,6,16,37.5,10,5,0,5,1,16,8
1195,Stefan Lainer,at,DF,,Gladbach,Bundesliga,32,1992,3.4,8,3,6,2,0,3,3,100.0,0,4,3,1,4,12,11
1196,Kenny Lala,mg,DF,,Brest,Ligue 1,33,1991,11.8,33,21,19,10,4,23,36,63.9,13,18,8,10,11,44,26
1197,Adam Lallana,eng,MF,,Southampton,Premier League,36,1988,3.5,6,5,3,3,0,2,8,25.0,6,4,1,3,4,10,5
1198,Mathis Lambourde,fr,FW,MF,Hellas Verona,Serie A,18,2006,0.4,3,1,2,1,0,1,3,33.3,2,1,0,1,0,3,0
1199,Mohamed Lamine Bayo,gn,FW,MF,Lille,Ligue 1,26,1998,2.4,0,0,0,0,0,0,0,,0,0,0,0,0,0,1
1200,Tariq Lamptey,gh,DF,,Brighton,Premier League,24,2000,2.6,4,4,2,2,0,2,7,28.6,5,6,1,5,3,7,7
1201,Will Lankshear,eng,FW,,Tottenham,Premier League,19,2005,0.1,0,0,0,0,0,0,0,,0,0,0,0,0,0,0
1202,Gianluca Lapadula,pe,FW,MF,Cagliari,Serie A,34,1990,2.7,2,0,1,0,1,0,0,,0,0,0,0,0,2,1
1203,Cyle Larin,ca,FW,,Mallorca,La Liga,29,1995,10.0,5,2,1,2,2,0,2,0.0,2,7,1,6,1,6,4
1204,Gautier Larsonneur,fr,GK,,Saint-Étienne,Ligue 1,27,1997,15.0,1,0,1,0,0,0,1,0.0,1,0,0,0,0,1,11
1205,Hugo Larsson,se,MF,,Eint Frankfurt,Bundesliga,20,2004,10.3,15,7,8,5,2,10,23,43.5,13,17,6,11,14,29,16
1206,Juanmi Latasa,es,FW,,Valladolid,La Liga,23,2001,5.8,1,0,0,1,0,0,2,0.0,2,2,1,1,0,1,6
1207,Toni Lato,es,DF,,Mallorca,La Liga,27,1997,2.9,7,5,2,1,4,3,5,60.0,2,3,0,3,3,10,10
1208,Roméo Lavia,be,MF,,Chelsea,Premier League,20,2004,5.3,15,9,5,7,3,6,13,46.2,7,6,0,6,11,26,5
1209,Valentino Lazaro,at,DF,,Torino,Serie A,28,1996,11.9,17,7,9,6,2,10,14,71.4,4,11,3,8,3,20,17
1210,Darko Lazović,rs,FW,MF,Hellas Verona,Serie A,34,1990,12.5,18,9,4,12,2,9,21,42.9,12,14,2,12,8,26,27
1211,Manuel Lazzari,it,DF,,Lazio,Serie A,31,1993,8.9,11,10,5,5,1,7,12,58.3,5,4,3,1,4,15,8
1212,Julien Le Cardinal,fr,DF,,Brest,Ligue 1,27,1997,8.8,14,9,8,6,0,6,10,60.0,4,11,8,3,24,38,39
1213,Jérémy Le Douaron,fr,FW,,Brest,Ligue 1,26,1998,1.1,1,0,0,0,1,0,1,0.0,1,1,0,1,0,1,0
1214,Enzo Le Fée,fr,MF,,Roma,Serie A,24,2000,3.5,7,4,5,2,0,2,6,33.3,4,9,3,6,5,12,2
1215,Robin Le Normand,es,DF,,Atlético Madrid,La Liga,28,1996,7.1,11,8,11,0,0,3,5,60.0,2,3,2,1,2,13,26
1216,Nicola Leali,it,GK,,Genoa,Serie A,31,1993,9.0,0,0,0,0,0,0,0,,0,0,0,0,0,0,5
1217,Rafael Leão,pt,FW,,Milan,Serie A,25,1999,11.1,7,6,1,4,2,5,10,50.0,5,8,0,8,4,11,0
1218,Benjamin Lecomte,fr,GK,,Montpellier,Ligue 1,33,1991,12.0,0,0,0,0,0,0,0,,0,0,0,0,0,0,7
1219,Pierre Lees-Melou,fr,MF,,Brest,Ligue 1,31,1993,3.9,11,7,3,5,3,7,10,70.0,3,4,2,2,4,15,2
1220,Jordan Lefort,fr,DF,,Angers,Ligue 1,31,1993,15.0,26,17,19,6,1,15,25,60.0,10,25,12,13,15,41,80
1221,Diogo Leite,pt,DF,,Union Berlin,Bundesliga,25,1999,12.1,36,18,22,11,3,16,27,59.3,11,30,9,21,25,61,53
1222,Maxim Leitsch,de,DF,,Mainz 05,Bundesliga,26,1998,6.1,11,3,6,3,2,7,8,87.5,1,9,4,5,8,19,34
1223,Florian Lejeune,fr,DF,,Rayo Vallecano,La Liga,33,1991,15.9,22,14,13,7,2,8,16,50.0,8,17,13,4,11,33,73
1224,Iñigo Lekue,es,DF,,Athletic Club,La Liga,31,1993,4.1,6,4,4,2,0,3,6,50.0,3,2,1,1,3,9,14
1225,Nunzio Lella,it,MF,,Venezia,Serie A,24,2000,0.1,0,0,0,0,0,0,0,,0,0,0,0,0,0,0
1226,Thomas Lemar,fr,MF,,Atlético Madrid,La Liga,29,1995,0.1,0,0,0,0,0,0,1,0.0,1,0,0,0,0,0,0
1227,Félix Lemaréchal,fr,MF,FW,Strasbourg,Ligue 1,21,2003,3.1,8,6,1,5,2,2,3,66.7,1,6,0,6,4,12,2
1228,Mario Lemina,ga,MF,DF,Wolves,Premier League,31,1993,14.8,49,30,27,18,4,19,28,67.9,9,12,7,5,27,76,49
1229,Clément Lenglet,fr,DF,,Atlético Madrid,La Liga,29,1995,7.3,6,4,5,1,0,2,3,66.7,1,7,5,2,9,15,33
1230,Bernd Leno,de,GK,,Fulham,Premier League,32,1992,16.0,0,0,0,0,0,0,0,,0,1,0,1,0,0,3
1231,Donovan Léon,gf,GK,,Auxerre,Ligue 1,32,1992,15.0,0,0,0,0,0,0,2,0.0,2,0,0,0,0,0,9
1232,Giovanni Leoni,it,DF,,Parma,Serie A,17,2006,3.1,1,0,0,1,0,0,0,,0,7,2,5,5,6,8
1233,Esteban Lepaul,fr,FW,MF,Angers,Ligue 1,24,2000,2.5,1,1,0,0,1,0,5,0.0,5,6,1,5,2,3,2
1234,Johann Lepenant,fr,MF,,Nantes,Ligue 1,22,2002,9.7,27,14,10,11,6,9,25,36.0,16,10,2,8,10,37,8
1235,Jefferson Lerma,co,MF,,Crystal Palace,Premier League,30,1994,8.4,10,3,4,5,1,6,12,50.0,6,15,9,6,15,25,16
1236,Louis Leroux,fr,MF,FW,Nantes,Ligue 1,18,2006,0.2,1,1,1,0,0,1,1,100.0,0,0,0,0,0,1,0
1237,Robert Lewandowski,pl,FW,,Barcelona,La Liga,36,1988,15.4,6,3,1,4,1,2,5,40.0,3,9,2,7,1,7,17
1238,Jamie Leweling,de,FW,MF,Stuttgart,Bundesliga,23,2001,7.3,5,2,2,0,3,3,9,33.3,6,10,0,10,4,9,7
1239,Rico Lewis,eng,DF,MF,Manchester City,Premier League,20,2004,11.4,22,12,10,9,3,7,10,70.0,3,14,2,12,10,32,23
1240,Keane Lewis-Potter,eng,DF,FW,Brentford,Premier League,23,2001,13.3,20,9,7,9,4,10,16,62.5,6,10,4,6,7,27,26
1241,Myles Lewis-Skelly,eng,DF,,Arsenal,Premier League,18,2006,0.9,3,2,3,0,0,1,1,100.0,0,0,0,0,0,3,1
1242,Ben Lhassine Kone,ci,MF,,Como,Serie A,24,2000,0.1,0,0,0,0,0,0,0,,0,0,0,0,0,0,1
1243,Mattia Liberali,it,MF,,Milan,Serie A,17,2007,0.7,2,1,0,1,1,2,2,100.0,0,0,0,0,0,2,0
1244,Philipp Lienhart,at,DF,,Freiburg,Bundesliga,28,1996,13.2,11,9,7,4,0,8,15,53.3,7,14,9,5,20,31,42
1245,Matthijs de Ligt,nl,DF,,Manchester Utd,Premier League,25,1999,12.7,13,7,9,4,0,10,14,71.4,4,14,11,3,20,33,38
1246,Victor Lindelöf,se,DF,MF,Manchester Utd,Premier League,30,1994,0.7,3,0,3,0,0,1,1,100.0,0,1,0,1,2,5,4
1247,Jesper Lindstrøm,dk,FW,,Everton,Premier League,24,2000,5.8,18,9,7,11,0,9,25,36.0,16,9,3,6,3,21,4
1248,Karol Linetty,pl,MF,,Torino,Serie A,29,1995,11.2,25,17,10,15,0,13,24,54.2,11,12,4,8,7,32,17
1249,Samuel Lino,br,MF,DF,Atlético Madrid,La Liga,24,1999,7.9,9,3,6,2,1,6,21,28.6,15,12,1,11,4,13,4
1250,Pol Lirola,es,DF,,Marseille,Ligue 1,27,1997,4.0,8,5,4,4,0,3,9,33.3,6,4,2,2,0,8,5
1251,Dailon Livramento,cv,FW,MF,Hellas Verona,Serie A,23,2001,5.5,10,8,1,4,5,4,9,44.4,5,5,1,4,2,12,3
1252,Valentino Livramento,eng,DF,,Newcastle Utd,Premier League,22,2002,12.6,21,14,15,5,1,15,24,62.5,9,17,6,11,12,33,45
1253,Javier Llabrés,es,FW,,Mallorca,La Liga,22,2002,0.6,0,0,0,0,0,0,0,,0,1,0,1,0,0,0
1254,Diego Llorente,es,DF,,Betis,La Liga,31,1993,15.6,19,8,10,8,1,11,19,57.9,8,17,11,6,27,46,79
1255,Marcos Llorente,es,DF,MF,Atlético Madrid,La Liga,29,1995,10.1,25,18,16,7,2,14,19,73.7,5,7,1,6,10,35,19
1256,Gautier Lloris,fr,DF,,Le Havre,Ligue 1,29,1995,15.0,36,24,25,11,0,20,31,64.5,11,13,5,8,7,43,77
1257,Giovani Lo Celso,ar,MF,,Betis,La Liga,28,1996,8.7,23,12,5,12,6,12,16,75.0,4,8,1,7,3,26,2
1258,Stanislav Lobotka,sk,MF,,Napoli,Serie A,30,1994,11.0,23,15,4,12,7,8,11,72.7,3,9,3,6,7,30,15
1259,Manuel Locatelli,it,MF,,Juventus,Serie A,26,1998,12.3,29,22,15,13,1,11,22,50.0,11,23,8,15,8,37,27
1260,Ruben Loftus-Cheek,eng,MF,,Milan,Serie A,28,1996,7.6,14,6,3,7,4,4,7,57.1,3,1,0,1,2,16,9
1261,Enzo Loiodice,fr,MF,,Las Palmas,La Liga,24,2000,3.0,5,2,4,1,0,2,7,28.6,5,3,0,3,4,9,2
1262,Sean Longstaff,eng,MF,,Newcastle Utd,Premier League,27,1997,7.6,27,16,10,9,8,18,26,69.2,8,13,2,11,5,32,4
1263,Ademola Lookman,ng,FW,MF,Atalanta,Serie A,27,1997,9.7,15,7,7,6,2,7,12,58.3,5,11,0,11,1,16,1
1264,David López,es,DF,,Girona,La Liga,35,1989,15.4,16,10,10,4,2,11,20,55.0,9,16,9,7,9,25,58
1265,Diego López,es,MF,FW,Valencia,La Liga,22,2002,12.4,11,7,2,6,3,7,20,35.0,13,9,0,9,4,15,4
1266,Fer López,,FW,,Celta Vigo,La Liga,,,0.5,3,1,0,3,0,0,1,0.0,1,1,0,1,1,4,0
1267,Fermin López,es,MF,FW,Barcelona,La Liga,21,2003,3.7,6,5,3,1,2,2,8,25.0,6,1,0,1,3,9,1
1268,Javi López,es,DF,,Real Sociedad,La Liga,22,2002,9.6,18,8,9,7,2,8,15,53.3,7,8,3,5,3,21,27
1269,Roberto López,es,MF,,Leganés,La Liga,24,2000,4.0,7,5,4,3,0,4,13,30.8,9,4,0,4,1,8,7
1270,Unai López,es,MF,,Rayo Vallecano,La Liga,29,1995,8.2,9,6,4,3,2,3,11,27.3,8,8,1,7,13,22,8
1271,Iker Losada,es,MF,FW,Betis,La Liga,23,2001,3.7,10,7,2,4,4,5,10,50.0,5,2,0,2,3,13,2
1272,Anthony Losilla,fr,MF,,Bochum,Bundesliga,38,1986,9.7,24,16,14,9,1,12,25,48.0,13,17,7,10,11,35,15
1273,Jordan Lotomba,ch,MF,DF,Nice,Ligue 1,26,1998,0.4,0,0,0,0,0,0,0,,0,0,0,0,0,0,1
1274,Tom Louchet,fr,DF,MF,Nice,Ligue 1,21,2003,5.3,18,12,12,2,4,12,14,85.7,2,8,3,5,6,24,13
1275,Sandi Lovrić,si,MF,,Udinese,Serie A,26,1998,10.2,21,11,12,6,3,10,18,55.6,8,16,2,14,13,34,11
1276,Pol Lozano,es,MF,,Espanyol,La Liga,25,1999,9.1,29,20,10,15,4,13,26,50.0,13,12,2,10,9,38,11
1277,Lorenzo Lucca,it,FW,,Udinese,Serie A,24,2000,11.3,7,4,1,2,4,3,5,60.0,2,6,0,6,2,9,12
1278,Jhon Lucumí,co,DF,,Bologna,Serie A,26,1998,10.4,16,9,8,8,0,6,12,50.0,6,14,8,6,5,21,34
1279,Yannik Lührs,de,DF,,Dortmund,Bundesliga,21,2003,0.4,1,1,1,0,0,0,0,,0,0,0,0,1,2,3
1280,José Luis Gayà,es,DF,,Valencia,La Liga,29,1995,3.6,7,6,2,4,1,6,10,60.0,4,1,0,1,5,12,9
1281,José Luis Palomino,ar,DF,,Cagliari,Serie A,34,1990,3.2,5,4,0,3,2,2,3,66.7,1,4,4,0,6,11,8
1282,Douglas Luiz,br,MF,,Juventus,Serie A,26,1998,3.3,7,3,3,3,1,4,6,66.7,2,3,0,3,2,9,0
1283,Romelu Lukaku,be,FW,,Napoli,Serie A,31,1993,11.6,1,1,0,1,0,0,2,0.0,2,1,1,0,0,1,8
1284,Castello Lukeba,fr,DF,,RB Leipzig,Bundesliga,22,2002,8.1,17,7,7,7,3,6,9,66.7,3,13,6,7,4,21,29
1285,Dodi Lukebakio,be,FW,,Sevilla,La Liga,27,1997,15.1,10,7,3,5,2,5,13,38.5,8,8,0,8,2,12,7
1286,Saša Lukić,rs,MF,,Fulham,Premier League,28,1996,9.7,24,10,9,14,1,7,21,33.3,14,11,5,6,13,37,10
1287,Milos Lukovic,rs,FW,MF,Strasbourg,Ligue 1,19,2005,0.1,0,0,0,0,0,0,0,,0,0,0,0,0,0,0
1288,Joe Lumley,eng,GK,,Southampton,Premier League,29,1995,3.0,0,0,0,0,0,0,0,,0,0,0,0,0,0,3
1289,Daniel Luna,co,MF,,Mallorca,La Liga,21,2003,0.2,0,0,0,0,0,0,0,,0,1,0,1,0,0,0
1290,Andriy Lunin,ua,GK,,Real Madrid,La Liga,25,1999,3.0,0,0,0,0,0,0,0,,0,0,0,0,0,0,1
1291,Massimo Luongo,au,MF,,Ipswich Town,Premier League,32,1992,1.6,5,3,5,0,0,4,6,66.7,2,3,2,1,2,7,2
1292,Sebastiano Luperto,it,DF,,Cagliari,Serie A,28,1996,16.0,25,12,18,6,1,8,13,61.5,5,11,7,4,15,40,73
1293,Zito Luvumbo,ao,FW,MF,Cagliari,Serie A,22,2002,11.0,5,2,1,3,1,2,10,20.0,8,2,0,2,1,6,4
1294,Charalambos Lykogiannis,gr,DF,,Bologna,Serie A,31,1993,4.6,5,2,3,2,0,3,7,42.9,4,1,1,0,3,8,14
1295,Senne Lynen,be,MF,,Werder Bremen,Bundesliga,25,1999,12.6,30,14,14,12,4,20,27,74.1,7,23,7,16,24,54,27
1296,Othmane Maamma,ma,FW,MF,Montpellier,Ligue 1,19,2005,0.7,0,0,0,0,0,0,1,0.0,1,2,0,2,0,0,1
1297,Ian Maatsen,nl,DF,,Aston Villa,Premier League,22,2002,3.2,11,7,5,5,1,4,6,66.7,2,2,0,2,3,14,7
1298,Alexis Mac Allister,ar,MF,,Liverpool,Premier League,25,1998,11.0,39,27,12,22,5,22,42,52.4,20,28,0,28,4,43,10
1299,Deiver Machado,co,DF,MF,Lens,Ligue 1,31,1993,6.0,13,10,8,4,1,9,10,90.0,1,7,1,6,5,18,7
1300,Shuto Machino,jp,FW,MF,Holstein Kiel,Bundesliga,25,1999,7.0,4,3,2,1,1,3,6,50.0,3,2,0,2,3,7,2
1301,Darwin Machís,ve,FW,MF,Valladolid,La Liga,31,1993,3.4,3,2,2,1,0,2,6,33.3,4,3,0,3,2,5,7
1302,Yvann Macon,fr,DF,,Saint-Étienne,Ligue 1,26,1998,3.2,4,3,0,3,1,1,5,20.0,4,7,2,5,0,4,6
1303,James Maddison,eng,MF,,Tottenham,Premier League,28,1996,11.4,17,10,5,9,3,8,21,38.1,13,7,3,4,8,25,15
1304,Eros Maddy,nl,DF,,Auxerre,Ligue 1,23,2001,0.1,0,0,0,0,0,0,0,,0,0,0,0,0,0,0
1305,Noni Madueke,eng,FW,,Chelsea,Premier League,22,2002,11.4,14,10,6,7,1,9,21,42.9,12,11,0,11,5,19,5
1306,Pablo Maffeo,es,DF,,Mallorca,La Liga,27,1997,11.2,22,12,16,5,1,12,17,70.6,5,14,6,8,12,34,32
1307,Gabriel Magalhães,br,DF,,Arsenal,Premier League,26,1997,13.1,11,7,5,5,1,5,9,55.6,4,26,19,7,7,18,43
1308,Soungoutou Magassa,fr,MF,,Monaco,Ligue 1,21,2003,6.3,21,11,5,14,2,14,25,56.0,11,4,0,4,10,31,9
1309,Edmond-Paris Maghoma,eng,MF,,Brentford,Premier League,23,2001,0.3,0,0,0,0,0,0,0,,0,1,1,0,1,1,0
1310,Giangiacomo Magnani,it,DF,,Hellas Verona,Serie A,29,1995,10.4,20,15,14,6,0,7,7,100.0,0,16,9,7,13,33,60
1311,Hugo Magnetti,fr,MF,,Brest,Ligue 1,26,1998,11.3,20,12,7,12,1,8,19,42.1,11,9,3,6,7,27,11
1312,Frank Magri,cm,FW,MF,Toulouse,Ligue 1,25,1999,3.9,1,0,0,0,1,1,4,25.0,3,8,0,8,1,2,4
1313,Harry Maguire,eng,DF,,Manchester Utd,Premier League,31,1993,5.0,7,4,5,2,0,5,5,100.0,0,4,3,1,14,21,15
1314,Jon Magunacelaya,es,MF,,Real Sociedad,La Liga,24,2000,0.1,1,1,1,0,0,0,0,,0,0,0,0,0,1,0
1315,Arne Maier,de,MF,,Augsburg,Bundesliga,25,1999,4.9,6,2,1,5,0,4,8,50.0,4,9,1,8,1,7,5
1316,Mike Maignan,fr,GK,,Milan,Serie A,29,1995,15.0,0,0,0,0,0,0,0,,0,0,0,0,0,0,8
1317,Patrick Mainka,de,DF,,Heidenheim,Bundesliga,30,1994,14.0,27,13,17,10,0,16,25,64.0,9,28,15,13,29,56,64
1318,Kobbie Mainoo,eng,MF,,Manchester Utd,Premier League,19,2005,9.1,22,16,13,6,3,14,21,66.7,7,9,2,7,15,37,5
1319,Ainsley Maitland-Niles,eng,DF,MF,Lyon,Ligue 1,27,1997,11.4,36,21,15,12,9,24,35,68.6,11,17,2,15,15,51,26
1320,Radosław Majecki,pl,GK,,Monaco,Ligue 1,25,1999,7.0,0,0,0,0,0,0,0,,0,0,0,0,0,0,5
1321,Lovro Majer,hr,MF,,Wolfsburg,Bundesliga,26,1998,1.6,0,0,0,0,0,0,2,0.0,2,2,0,2,0,0,1
1322,Jordy Makengo,fr,DF,MF,Freiburg,Bundesliga,23,2001,0.8,5,3,4,1,0,3,3,100.0,0,0,0,0,0,5,5
1323,Antoine Makoumbou,cg,MF,,Cagliari,Serie A,26,1998,8.4,13,7,8,4,1,5,8,62.5,3,11,2,9,6,19,6
1324,Nikola Maksimović,rs,DF,,Montpellier,Ligue 1,33,1991,5.7,9,5,6,3,0,6,7,85.7,1,5,4,1,6,15,24
1325,Tyrell Malacia,nl,DF,,Manchester Utd,Premier League,25,1999,0.5,1,0,1,0,0,0,0,,0,0,0,0,1,2,0
1326,Julián Malatini,ar,DF,,Werder Bremen,Bundesliga,23,2001,4.8,10,9,4,5,1,4,10,40.0,6,6,3,3,7,17,16
1327,Daniel Maldini,it,MF,,Monza,Serie A,23,2001,11.0,14,6,5,9,0,6,10,60.0,4,7,2,5,4,18,10
1328,Youssef Maleh,ma,MF,,Empoli,Serie A,26,1998,9.5,15,7,5,8,2,4,12,33.3,8,18,5,13,6,21,12
1329,Donyell Malen,nl,FW,MF,Dortmund,Bundesliga,25,1999,6.0,0,0,0,0,0,0,1,0.0,1,2,0,2,3,3,6
1330,Ruslan Malinovskyi,ua,MF,FW,Genoa,Serie A,31,1993,2.5,8,6,2,5,1,2,3,66.7,1,1,0,1,1,9,3
1331,Lennard Maloney,us,MF,,Heidenheim,Bundesliga,25,1999,8.4,20,11,12,7,1,14,23,60.9,9,9,2,7,14,34,38
1332,Giorgi Mamardashvili,ge,GK,,Valencia,La Liga,24,2000,14.0,0,0,0,0,0,0,0,,0,0,0,0,0,0,4
1333,Dennis Man,ro,FW,MF,Parma,Serie A,26,1998,13.9,5,3,3,1,1,4,15,26.7,11,7,2,5,8,13,7
1334,Hianga Mananga Mbock,fr,MF,,Brest,Ligue 1,24,1999,0.2,0,0,0,0,0,0,0,,0,0,0,0,1,1,0
1335,Gianluca Mancini,it,DF,,Roma,Serie A,28,1996,14.4,18,10,10,6,2,10,12,83.3,2,9,6,3,16,34,25
1336,Steve Mandanda,fr,GK,,Rennes,Ligue 1,39,1985,14.5,0,0,0,0,0,0,1,0.0,1,0,0,0,0,0,5
1337,Reinildo Mandava,mz,DF,,Atlético Madrid,La Liga,30,1994,7.2,16,10,8,7,1,9,16,56.3,7,7,3,4,10,26,25
1338,Aïssa Mandi,dz,DF,,Lille,Ligue 1,33,1991,9.5,16,9,4,10,2,9,13,69.2,4,13,8,5,6,22,21
1339,Rolando Mandragora,it,MF,,Fiorentina,Serie A,27,1997,3.4,2,0,1,0,1,0,1,0.0,1,3,1,2,6,8,5
1340,Orel Mangala,be,MF,,Everton,Premier League,26,1998,7.5,11,5,1,10,0,4,6,66.7,2,3,1,2,13,24,10
1341,Orel Mangala,be,MF,,Lyon,Ligue 1,26,1998,0.7,1,0,0,0,1,0,1,0.0,1,2,0,2,0,1,1
1342,Ryan Manning,ie,DF,,Southampton,Premier League,28,1996,7.3,15,10,7,6,2,8,14,57.1,6,11,7,4,8,23,13
1343,Javier Manquillo,es,DF,,Celta Vigo,La Liga,30,1994,5.5,7,5,4,3,0,2,9,22.2,7,5,3,2,7,14,13
1344,Johan Manzambi,ch,FW,,Freiburg,Bundesliga,19,2005,0.1,0,0,0,0,0,0,0,,0,0,0,0,0,0,0
1345,Alberto Manzoni,it,MF,,Atalanta,Serie A,19,2005,0.1,0,0,0,0,0,0,0,,0,0,0,0,0,0,0
1346,Sekou Mara,fr,FW,MF,Strasbourg,Ligue 1,22,2002,6.5,8,5,0,4,4,2,7,28.6,5,6,0,6,3,11,2
1347,Alessandro Marcandalli,it,DF,,Genoa,Serie A,22,2002,0.5,1,0,1,0,0,0,0,,0,0,0,0,0,1,2
1348,Marcão,br,DF,,Sevilla,La Liga,28,1996,5.1,9,6,6,3,0,2,3,66.7,1,9,6,3,6,15,26
1349,Filip Marchwiński,pl,MF,,Lecce,Serie A,22,2002,0.2,0,0,0,0,0,0,0,,0,0,0,0,0,0,0
1350,Óscar de Marcos,es,DF,,Athletic Club,La Liga,35,1989,11.1,22,10,12,9,1,16,27,59.3,11,10,1,9,11,33,24
1351,Alberto Marí,es,FW,,Valencia,La Liga,23,2001,0.1,0,0,0,0,0,0,0,,0,0,0,0,0,0,0
1352,Pablo Marí,es,DF,,Monza,Serie A,31,1993,16.0,21,12,12,9,0,9,19,47.4,10,21,19,2,35,56,77
1353,José María Giménez,uy,DF,,Atlético Madrid,La Liga,29,1995,13.3,17,12,12,5,0,12,19,63.2,7,18,12,6,16,33,60
1354,Luca Marianucci,it,DF,MF,Empoli,Serie A,20,2004,0.4,2,1,2,0,0,1,3,33.3,2,0,0,0,0,2,3
1355,Mirko Marić,hr,FW,MF,Monza,Serie A,29,1995,1.0,1,0,1,0,0,1,2,50.0,1,1,1,0,1,2,1
1356,Pablo Marín,es,MF,,Real Sociedad,La Liga,21,2003,0.9,3,2,1,2,0,1,2,50.0,1,0,0,0,0,3,1
1357,Răzvan Marin,ro,MF,,Cagliari,Serie A,28,1996,9.9,14,8,5,8,1,8,16,50.0,8,4,0,4,2,16,15
1358,Guillermo Maripán,cl,DF,,Torino,Serie A,30,1994,4.0,6,2,3,2,1,3,4,75.0,1,3,0,3,8,14,21
1359,Mika Màrmol,es,DF,,Las Palmas,La Liga,22,2002,8.7,22,9,12,9,1,12,17,70.6,5,21,8,13,13,35,33
1360,Omar Marmoush,eg,FW,MF,Eint Frankfurt,Bundesliga,25,1999,13.1,10,6,0,3,7,3,6,50.0,3,7,1,6,1,11,2
1361,Mario Maroto,es,MF,,Valladolid,La Liga,21,2003,0.2,0,0,0,0,0,0,1,0.0,1,0,0,0,2,2,1
1362,Marquinhos,br,DF,,Paris S-G,Ligue 1,30,1994,10.3,17,12,6,7,4,13,16,81.3,3,15,6,9,6,23,30
1363,Aarón Martín,es,DF,,Genoa,Serie A,27,1997,14.2,33,24,16,15,2,17,23,73.9,6,14,5,9,8,41,29
1364,Carlos Martín,es,FW,MF,Alavés,La Liga,22,2002,6.3,18,9,8,7,3,5,23,21.7,18,11,1,10,1,19,8
1365,Gerard Martín,es,DF,,Barcelona,La Liga,22,2002,4.3,10,4,4,3,3,7,10,70.0,3,9,2,7,4,14,9
1366,Iván Martín,es,MF,,Girona,La Liga,25,1999,10.6,15,8,9,5,1,6,16,37.5,10,12,1,11,5,20,3
1367,Jon Martin,es,DF,,Real Sociedad,La Liga,18,2006,1.0,0,0,0,0,0,0,0,,0,1,1,0,1,1,6
1368,Jonas Martin,fr,MF,,Brest,Ligue 1,34,1990,5.1,11,5,8,2,1,5,10,50.0,5,3,0,3,6,17,11
1369,Mario Martín,es,MF,,Valladolid,La Liga,20,2004,8.2,25,12,12,12,1,11,24,45.8,13,12,3,9,8,33,25
1370,Gabriel Martinelli,br,MF,FW,Arsenal,Premier League,23,2001,9.5,10,8,1,3,6,5,12,41.7,7,4,0,4,1,11,10
1371,Arnau Martinez,es,DF,MF,Girona,La Liga,21,2003,11.9,19,12,11,4,4,13,20,65.0,7,5,3,2,4,23,26
1372,Emiliano Martínez,ar,GK,,Aston Villa,Premier League,32,1992,15.5,1,1,1,0,0,0,0,,0,0,0,0,0,1,9
1373,Iñigo Martínez,es,DF,,Barcelona,La Liga,33,1991,16.8,15,8,12,3,0,9,9,100.0,0,8,5,3,13,28,58
1374,Javi Martínez,es,MF,,Osasuna,La Liga,24,1999,0.1,0,0,0,0,0,0,0,,0,0,0,0,0,0,0
1375,Lautaro Martínez,ar,FW,,Inter,Serie A,27,1997,12.0,8,4,3,3,2,3,8,37.5,5,5,1,4,5,13,3
1376,Lisandro Martínez,ar,DF,,Manchester Utd,Premier League,26,1998,12.8,23,14,15,5,3,12,23,52.2,11,14,4,10,26,49,35
1377,Lucas Martínez Quarta,ar,DF,,Fiorentina,Serie A,28,1996,3.9,12,7,9,3,0,8,13,61.5,5,5,2,3,3,15,25
1378,Toni Martínez,es,FW,,Alavés,La Liga,27,1997,5.5,5,3,0,3,2,0,1,0.0,1,5,2,3,0,5,7
1379,Kevin Martins,it,DF,,Monza,Serie A,19,2005,0.0,0,0,0,0,0,0,0,,0,0,0,0,0,0,0
1380,Javi Martón,es,FW,MF,Athletic Club,La Liga,25,1999,0.6,0,0,0,0,0,0,0,,0,0,0,0,0,0,0
1381,Adam Marušić,me,DF,,Lazio,Serie A,32,1992,9.5,15,8,9,6,0,7,13,53.8,6,5,2,3,5,20,23
1382,Marvin,es,DF,FW,Las Palmas,La Liga,24,2000,5.5,11,5,5,4,2,5,17,29.4,12,7,3,4,5,16,16
1383,Omar Mascarell,gq,MF,,Mallorca,La Liga,31,1993,9.1,14,7,7,7,0,8,14,57.1,6,14,8,6,22,36,30
1384,Adam Masina,ma,DF,,Torino,Serie A,30,1994,14.5,24,10,17,6,1,17,32,53.1,15,20,13,7,16,40,56
1385,Patrizio Masini,it,MF,FW,Genoa,Serie A,23,2001,0.9,6,3,2,4,0,1,1,100.0,0,4,0,4,0,6,4
1386,Erhan Mašović,rs,DF,MF,Bochum,Bundesliga,26,1998,6.2,7,6,5,2,0,6,14,42.9,8,11,7,4,8,15,27
1387,Clinton Mata,ao,DF,,Lyon,Ligue 1,32,1992,11.1,20,12,11,8,1,16,19,84.2,3,10,6,4,18,38,22
1388,Jaime Mata,es,FW,,Las Palmas,La Liga,36,1988,3.9,4,0,1,3,0,3,8,37.5,5,4,1,3,1,5,5
1389,Igor Matanovic,hr,FW,MF,Eint Frankfurt,Bundesliga,21,2003,2.9,1,0,0,1,0,0,1,0.0,1,2,0,2,1,2,7
1390,Pape Matar Sarr,sn,MF,,Tottenham,Premier League,22,2002,9.5,27,20,9,16,2,5,12,41.7,7,14,2,12,16,43,11
1391,Eliot Matazo,be,MF,,Monaco,Ligue 1,22,2002,0.7,3,2,0,3,0,0,0,,0,0,0,0,1,4,2
1392,Jean-Philippe Mateta,fr,FW,,Crystal Palace,Premier League,27,1997,13.0,7,6,2,4,1,0,6,0.0,6,7,1,6,1,8,13
1393,Nemanja Matić,rs,MF,,Lyon,Ligue 1,36,1988,10.3,19,17,5,12,2,9,18,50.0,9,15,6,9,9,28,13
1394,Chrislain Matsima,fr,DF,,Augsburg,Bundesliga,22,2002,8.5,4,3,4,0,0,2,6,33.3,4,19,11,8,20,24,42
1395,Jean Mattéo Bahoya,fr,MF,DF,Eint Frankfurt,Bundesliga,19,2005,2.1,6,6,4,2,0,4,8,50.0,4,1,0,1,1,7,3
1396,Alan Matturro,uy,DF,,Genoa,Serie A,20,2004,7.2,9,4,4,5,0,3,12,25.0,9,5,2,3,11,20,25
1397,Azor Matusiwa,nl,MF,,Rennes,Ligue 1,26,1998,12.2,38,21,18,19,1,21,27,77.8,6,15,5,10,17,55,25
1398,Neal Maupay,fr,FW,,Marseille,Ligue 1,28,1996,6.7,7,3,1,5,1,3,3,100.0,0,4,0,4,0,7,0
1399,Maurides,br,FW,,St. Pauli,Bundesliga,30,1994,0.0,0,0,0,0,0,0,0,,0,0,0,0,0,0,0
1400,Stephy Mavididi,eng,FW,MF,Leicester City,Premier League,26,1998,8.4,16,11,7,5,4,7,21,33.3,14,15,1,14,2,18,4
1401,Konstantinos Mavropanos,gr,DF,,West Ham,Premier League,27,1997,10.6,18,13,13,4,1,8,12,66.7,4,16,12,4,20,38,49
1402,Christian Mawissa,fr,DF,,Monaco,Ligue 1,19,2005,5.2,18,11,8,8,2,13,20,65.0,7,10,1,9,13,31,6
1403,Keke Maximilian Topp,de,FW,MF,Werder Bremen,Bundesliga,20,2004,2.2,2,1,0,1,1,1,2,50.0,1,0,0,0,1,3,1
1404,Borja Mayoral,es,FW,,Getafe,La Liga,27,1997,1.4,1,1,1,0,0,0,0,,0,1,0,1,0,1,1
1405,Senny Mayulu,fr,MF,DF,Paris S-G,Ligue 1,18,2006,2.1,9,5,4,4,1,3,6,50.0,3,5,3,2,2,11,3
1406,Noussair Mazraoui,ma,DF,,Manchester Utd,Premier League,27,1997,12.9,53,30,27,17,9,30,46,65.2,16,17,4,13,14,67,39
1407,Luca Mazzitelli,it,MF,,Como,Serie A,29,1995,3.5,9,6,4,5,0,5,7,71.4,2,5,2,3,3,12,10
1408,Pasquale Mazzocchi,it,DF,FW,Napoli,Serie A,29,1995,4.3,5,2,3,1,1,2,6,33.3,4,3,1,2,3,8,12
1409,Samuel Mbangula,be,FW,,Juventus,Serie A,20,2004,3.9,11,8,7,3,1,5,8,62.5,3,4,0,4,1,12,2
1410,Ethan Mbappé,fr,MF,FW,Lille,Ligue 1,17,2006,0.9,1,0,0,1,0,0,2,0.0,2,4,0,4,0,1,0
1411,Kylian Mbappé,fr,FW,,Real Madrid,La Liga,25,1998,14.2,2,2,0,2,0,0,0,,0,2,0,2,0,2,0
1412,Ibrahim Mbaye,fr,FW,MF,Paris S-G,Ligue 1,16,2008,1.0,0,0,0,0,0,0,3,0.0,3,0,0,0,0,0,0
1413,Bryan Mbeumo,cm,FW,,Brentford,Premier League,25,1999,15.9,19,10,7,7,5,8,12,66.7,4,10,2,8,5,24,23
1414,James Mcatee,eng,FW,MF,Manchester City,Premier League,22,2002,0.0,0,0,0,0,0,0,0,,0,1,0,1,0,0,0
1415,Kasey McAteer,ie,FW,MF,Leicester City,Premier League,23,2001,3.7,10,7,6,3,1,5,12,41.7,7,7,1,6,1,11,8
1416,Oliver McBurnie,sct,FW,,Las Palmas,La Liga,28,1996,8.1,6,4,2,3,1,2,5,40.0,3,4,1,3,4,10,9
1417,Alex McCarthy,eng,GK,,Southampton,Premier League,35,1989,4.0,0,0,0,0,0,0,0,,0,0,0,0,0,0,1
1418,John McGinn,sct,FW,MF,Aston Villa,Premier League,30,1994,10.9,13,9,4,7,2,4,8,50.0,4,9,0,9,4,17,3
1419,Scott McKenna,sct,DF,,Las Palmas,La Liga,28,1996,12.1,9,7,7,2,0,4,5,80.0,1,19,15,4,5,14,70
1420,Weston McKennie,us,MF,FW,Juventus,Serie A,26,1998,6.0,6,3,2,4,0,1,2,50.0,1,3,0,3,4,10,2
1421,Mark McKenzie,us,DF,,Toulouse,Ligue 1,25,1999,12.7,21,14,12,9,0,14,21,66.7,7,14,10,4,10,31,52
1422,Dwight McNeil,eng,MF,FW,Everton,Premier League,25,1999,12.7,10,6,5,3,2,7,16,43.8,9,7,0,7,5,15,1
1423,Scott McTominay,sct,MF,,Manchester Utd,Premier League,28,1996,0.2,0,0,0,0,0,0,1,0.0,1,0,0,0,0,0,1
1424,Scott McTominay,sct,MF,,Napoli,Serie A,28,1996,12.1,19,11,5,12,2,11,20,55.0,9,7,0,7,11,30,13
1425,Jakov Medić,hr,DF,,Bochum,Bundesliga,26,1998,10.0,7,6,4,2,1,4,8,50.0,4,23,15,8,12,19,53
1426,Facundo Medina,ar,DF,MF,Lens,Ligue 1,25,1999,13.7,28,19,14,12,2,13,21,61.9,8,13,4,9,18,46,30
1427,Ben Mee,eng,DF,MF,Brentford,Premier League,35,1989,0.1,1,1,0,1,0,1,1,100.0,0,1,1,0,1,2,1
1428,Jayden Meghoma,eng,DF,,Brentford,Premier League,18,2006,0.1,0,0,0,0,0,0,0,,0,0,0,0,0,0,0
1429,Henrik Meister,dk,FW,,Rennes,Ligue 1,21,2003,0.7,2,0,0,2,0,0,0,,0,4,0,4,1,3,0
1430,Bamo Meïté,ci,DF,MF,Marseille,Ligue 1,23,2001,0.3,0,0,0,0,0,0,0,,0,0,0,0,0,0,1
1431,Mohamed Meité,fr,FW,,Rennes,Ligue 1,17,2007,0.1,0,0,0,0,0,0,0,,0,0,0,0,0,0,0
1432,Mateo Mejía,es,FW,,Sevilla,La Liga,21,2003,0.1,0,0,0,0,0,0,0,,0,0,0,0,0,0,0
1433,Farid El Melali,dz,FW,,Angers,Ligue 1,27,1997,10.5,18,8,8,5,5,7,21,33.3,14,9,1,8,7,25,8
1434,Filippo Melegoni,it,MF,FW,Genoa,Serie A,25,1999,1.0,1,1,1,0,0,0,4,0.0,4,0,0,0,0,1,2
1435,Nuno Mendes,pt,DF,,Paris S-G,Ligue 1,22,2002,7.0,13,9,5,7,1,9,15,60.0,6,10,5,5,5,18,12
1436,Brais Méndez,es,MF,,Real Sociedad,La Liga,27,1997,10.3,15,10,5,6,4,7,16,43.8,9,9,1,8,3,18,12
1437,Antoine Mendy,fr,DF,,Nice,Ligue 1,20,2004,4.5,19,13,10,9,0,12,18,66.7,6,6,2,4,4,23,15
1438,Ferland Mendy,fr,DF,,Real Madrid,La Liga,29,1995,8.5,15,12,6,5,4,8,11,72.7,3,10,3,7,9,24,6
1439,Nampalys Mendy,sn,MF,,Lens,Ligue 1,32,1992,1.2,4,2,3,1,0,2,5,40.0,3,2,1,1,1,5,0
1440,Gideon Mensah,gh,DF,,Auxerre,Ligue 1,26,1998,9.3,26,17,16,7,3,13,28,46.4,15,7,1,6,21,47,27
1441,Alex Meret,it,GK,,Napoli,Serie A,27,1997,12.4,0,0,0,0,0,0,0,,0,1,0,1,0,0,5
1442,Mikel Merino,es,MF,,Arsenal,Premier League,28,1996,5.3,15,10,5,4,6,4,11,36.4,7,12,5,7,8,23,7
1443,Quentin Merlin,fr,DF,MF,Marseille,Ligue 1,22,2002,6.2,6,5,4,1,1,2,6,33.3,4,3,1,2,7,13,6
1444,Víctor Meseguer,es,MF,,Valladolid,La Liga,25,1999,4.6,10,6,4,4,2,2,10,20.0,8,3,0,3,2,12,4
1445,Rafik Messali,fr,MF,,Toulouse,Ligue 1,21,2003,0.0,0,0,0,0,0,0,0,,0,0,0,0,0,0,0
1446,Junior Messias,br,MF,FW,Genoa,Serie A,33,1991,3.4,4,1,3,1,0,1,2,50.0,1,1,1,0,4,8,7
1447,Connor Metcalfe,au,MF,,St. Pauli,Bundesliga,25,1999,2.5,1,0,0,1,0,0,3,0.0,3,3,0,3,2,3,4
1448,Karol Mets,ee,DF,,St. Pauli,Bundesliga,31,1993,10.0,13,8,6,7,0,4,7,57.1,3,9,3,6,12,25,60
1449,Thomas Meunier,be,DF,,Lille,Ligue 1,33,1991,6.9,14,10,10,3,1,8,13,61.5,5,9,3,6,12,26,24
1450,Alexander Meyer,de,GK,,Dortmund,Bundesliga,33,1991,2.0,0,0,0,0,0,0,0,,0,0,0,0,0,0,0
1451,Florian Micheler,at,MF,,Hoffenheim,Bundesliga,19,2005,0.4,0,0,0,0,0,0,2,0.0,2,0,0,0,0,0,0
1452,Miguel,es,FW,,Leganés,La Liga,25,1999,11.6,10,3,5,3,2,4,10,40.0,6,10,2,8,3,13,10
1453,Valentin Mihaila,ro,FW,MF,Parma,Serie A,24,2000,9.0,24,12,7,11,6,7,14,50.0,7,13,0,13,3,27,3
1454,Georges Mikautadze,ge,FW,,Lyon,Ligue 1,24,2000,6.4,5,4,1,2,2,2,5,40.0,3,2,0,2,1,6,0
1455,Nikola Milenković,rs,DF,,Nott'ham Forest,Premier League,27,1997,15.0,16,13,11,5,0,5,6,83.3,1,20,12,8,13,29,56
1456,Vanja Milinković-Savić,rs,GK,,Torino,Serie A,27,1997,15.0,0,0,0,0,0,0,2,0.0,2,0,0,0,0,0,7
1457,Éder Militão,br,DF,,Real Madrid,La Liga,26,1998,10.4,19,17,14,5,0,7,12,58.3,5,13,8,5,12,31,35
1458,Luis Milla,es,MF,,Getafe,La Liga,30,1994,16.8,33,23,18,13,2,17,36,47.2,19,19,0,19,13,46,12
1459,Pere Milla,es,MF,FW,Espanyol,La Liga,32,1992,2.5,3,1,2,0,1,0,10,0.0,10,9,2,7,2,5,2
1460,Enzo Millot,fr,MF,FW,Stuttgart,Bundesliga,22,2002,10.4,15,9,7,6,2,6,18,33.3,12,15,0,15,7,22,2
1461,James Milner,eng,MF,,Brighton,Premier League,38,1986,1.9,5,2,1,3,1,3,3,100.0,0,4,2,2,2,7,2
1462,Kim Min-jae,kr,DF,,Bayern Munich,Bundesliga,28,1996,13.4,18,10,7,8,3,3,10,30.0,7,14,7,7,19,37,40
1463,Yerry Mina,co,DF,,Cagliari,Serie A,30,1994,12.1,27,10,17,9,1,20,25,80.0,5,28,16,12,13,40,64
1464,Takumi Minamino,jp,MF,FW,Monaco,Ligue 1,29,1995,10.5,11,6,2,5,4,3,13,23.1,10,9,1,8,4,15,8
1465,Lucas Mincarelli,fr,DF,,Montpellier,Ligue 1,20,2004,2.8,4,4,1,2,1,1,5,20.0,4,1,1,0,1,5,8
1466,Tyrone Mings,eng,DF,,Aston Villa,Premier League,31,1993,1.0,1,1,1,0,0,0,0,,0,1,1,0,0,1,6
1467,Óscar Mingueza,es,MF,DF,Celta Vigo,La Liga,25,1999,14.2,19,11,9,7,3,15,31,48.4,16,15,4,11,8,27,19
1468,Kim Minsu,kr,MF,FW,Girona,La Liga,18,2006,0.2,1,0,0,1,0,0,0,,0,0,0,0,0,1,0
1469,Yankuba Minteh,gm,FW,MF,Brighton,Premier League,20,2004,5.7,8,5,2,1,5,3,11,27.3,8,10,0,10,3,11,5
1470,Bojan Miovski,mk,FW,,Girona,La Liga,25,1999,7.1,6,4,1,2,3,2,7,28.6,5,4,0,4,2,8,7
1471,Rafa Mir,es,MF,FW,Valencia,La Liga,27,1997,3.3,6,3,4,2,0,1,3,33.3,2,1,0,1,0,6,5
1472,Juan Miranda,es,DF,,Bologna,Serie A,24,2000,9.5,16,10,8,5,3,7,15,46.7,8,11,1,10,12,28,14
1473,Fabio Miretti,it,MF,FW,Genoa,Serie A,21,2003,7.1,16,9,4,6,6,11,14,78.6,3,6,1,5,2,18,5
1474,Tyrick Mitchell,eng,DF,,Crystal Palace,Premier League,25,1999,15.4,41,29,27,11,3,10,21,47.6,11,34,4,30,7,48,41
1475,Kaoru Mitoma,jp,FW,MF,Brighton,Premier League,27,1997,15.1,22,14,5,9,8,10,29,34.5,19,23,2,21,7,29,3
1476,Maximilian Mittelstädt,de,DF,,Stuttgart,Bundesliga,27,1997,12.0,28,20,18,9,1,20,30,66.7,10,18,8,10,14,42,36
1477,Koji Miyoshi,jp,MF,FW,Bochum,Bundesliga,27,1997,3.8,5,4,0,1,4,3,7,42.9,4,8,1,7,2,7,2
1478,Henrikh Mkhitaryan,am,MF,,Inter,Serie A,35,1989,13.6,22,13,7,10,5,10,21,47.6,11,8,1,7,11,33,16
1479,Jakub Moder,pl,MF,,Brighton,Premier League,25,1999,0.1,0,0,0,0,0,0,2,0.0,2,0,0,0,0,0,2
1480,Rui Modesto,ao,DF,,Udinese,Serie A,25,1999,0.4,1,1,0,1,0,1,1,100.0,0,0,0,0,1,2,0
1481,Luka Modrić,hr,MF,,Real Madrid,La Liga,39,1985,9.0,8,4,5,2,1,6,12,50.0,6,6,1,5,10,18,8
1482,Max Moerstedt,de,FW,,Hoffenheim,Bundesliga,,,1.9,3,3,1,2,0,1,1,100.0,0,1,0,1,0,3,3
1483,Mostafa Mohamed,eg,FW,,Nantes,Ligue 1,27,1997,5.4,8,5,3,4,1,2,7,28.6,5,2,0,2,2,10,10
1484,Johan Mojica,co,DF,,Mallorca,La Liga,32,1992,14.5,18,12,13,2,3,10,17,58.8,7,4,2,2,17,35,40
1485,Alberto Moleiro,es,FW,MF,Las Palmas,La Liga,21,2003,14.3,17,9,7,9,1,13,28,46.4,15,17,0,17,8,25,5
1486,Nahuel Molina,ar,DF,,Atlético Madrid,La Liga,26,1998,8.2,19,9,10,9,0,14,27,51.9,13,8,0,8,7,26,21
1487,Florent Mollet,fr,MF,FW,Nantes,Ligue 1,33,1991,1.8,1,1,1,0,0,1,1,100.0,0,2,0,2,1,2,2
1488,Jon Moncayola,es,MF,,Osasuna,La Liga,26,1998,11.3,33,17,7,21,5,13,27,48.1,14,17,1,16,8,41,12
1489,Gonzalo Montiel,ar,DF,MF,Sevilla,La Liga,27,1997,1.2,4,2,3,1,0,3,4,75.0,1,0,0,0,2,6,11
1490,Lorenzo Montipò,it,GK,,Hellas Verona,Serie A,28,1996,15.0,1,0,1,0,0,1,3,33.3,2,0,0,0,0,1,8
1491,Mikey Moore,eng,FW,,Tottenham,Premier League,17,2007,0.9,0,0,0,0,0,0,0,,0,0,0,0,1,1,0
1492,Álvaro Morata,es,FW,MF,Milan,Serie A,32,1992,9.1,8,6,2,5,1,3,6,50.0,3,4,1,3,5,13,4
1493,Morato,br,DF,,Nott'ham Forest,Premier League,23,2001,1.9,5,4,4,0,1,2,3,66.7,1,3,3,0,4,9,21
1494,Diego Moreira,pt,DF,MF,Strasbourg,Ligue 1,20,2004,13.2,20,14,6,10,4,9,19,47.4,10,8,1,7,14,34,31
1495,Alberto Moreno,es,DF,,Como,Serie A,32,1992,13.2,19,9,12,7,0,9,16,56.3,7,9,1,8,11,30,23
1496,Álex Moreno,es,DF,,Nott'ham Forest,Premier League,31,1993,8.8,24,18,19,5,0,14,34,41.2,20,9,4,5,14,38,32
1497,Gerard Moreno,es,FW,,Villarreal,La Liga,32,1992,3.5,4,3,1,1,2,2,3,66.7,1,0,0,0,2,6,1
1498,Tete Morente,es,FW,MF,Lecce,Serie A,28,1996,6.6,10,7,3,5,2,2,16,12.5,14,7,0,7,6,16,6
1499,Mateu Morey,es,DF,,Mallorca,La Liga,24,2000,2.9,6,5,3,3,0,3,8,37.5,5,5,0,5,8,14,8
1500,Ilaix Moriba,gn,MF,,Celta Vigo,La Liga,21,2003,8.7,26,20,8,16,2,15,27,55.6,12,8,2,6,6,32,10
1501,Manu Morlanes,es,MF,,Mallorca,La Liga,25,1999,11.5,32,20,14,13,5,15,23,65.2,8,18,7,11,23,55,15
1502,Nikola Moro,hr,MF,,Bologna,Serie A,26,1998,7.4,21,17,6,11,4,15,19,78.9,4,13,6,7,7,28,10
1503,Raúl Moro,es,FW,MF,Valladolid,La Liga,22,2002,12.7,14,8,11,2,1,8,20,40.0,12,6,0,6,9,23,6
1504,Sam Morsy,eg,MF,,Ipswich Town,Premier League,33,1991,14.9,36,20,18,14,4,15,37,40.5,22,15,5,10,17,53,25
1505,Gabriel Moscardo,br,MF,,Reims,Ligue 1,19,2005,0.4,2,0,2,0,0,1,3,33.3,2,1,1,0,0,2,0
1506,Cristhian Mosquera,es,DF,,Valencia,La Liga,20,2004,14.9,12,7,9,3,0,3,7,42.9,4,14,8,6,19,31,48
1507,Daniel Mosquera,co,FW,MF,Hellas Verona,Serie A,25,1999,5.8,4,2,1,1,2,0,2,0.0,2,4,1,3,0,4,4
1508,Yerson Mosquera,co,DF,,Wolves,Premier League,23,2001,4.9,11,7,9,2,0,9,14,64.3,5,13,10,3,10,21,14
1509,Dany Mota,pt,MF,FW,Monza,Serie A,26,1998,9.7,7,1,2,0,5,2,4,50.0,2,10,0,10,7,14,9
1510,Yael Mouanga,fr,DF,,Montpellier,Ligue 1,19,2005,1.0,2,2,2,0,0,1,1,100.0,0,3,3,0,0,2,7
1511,Aimen Moueffek,fr,MF,,Saint-Étienne,Ligue 1,23,2001,5.3,11,6,3,7,1,3,11,27.3,8,6,3,3,2,13,17
1512,Youssoufa Moukoko,de,FW,MF,Nice,Ligue 1,20,2004,2.0,1,0,1,0,0,0,1,0.0,1,0,0,0,0,1,0
1513,Steve Mounié,bj,FW,MF,Augsburg,Bundesliga,30,1994,2.4,3,3,0,1,2,0,1,0.0,1,1,1,0,0,3,3
1514,Mason Mount,eng,MF,FW,Manchester Utd,Premier League,25,1999,2.7,6,2,3,3,0,5,7,71.4,2,4,1,3,0,6,0
1515,Santiago Mouriño,uy,DF,,Alavés,La Liga,22,2002,7.0,15,11,11,4,0,8,15,53.3,7,6,0,6,11,26,28
1516,Louis Mouton,fr,MF,,Saint-Étienne,Ligue 1,22,2002,6.0,15,8,6,5,4,4,9,44.4,5,4,1,3,6,21,10
1517,Mykhailo Mudryk,ua,FW,,Chelsea,Premier League,23,2001,1.7,2,2,2,0,0,0,0,,0,3,1,2,0,2,1
1518,Ngal'Ayel Mukau,cd,MF,,Lille,Ligue 1,20,2004,6.1,19,11,5,12,2,12,19,63.2,7,7,0,7,10,29,11
1519,Nordi Mukiele,fr,DF,,Leverkusen,Bundesliga,27,1997,1.3,3,2,0,2,1,2,2,100.0,0,1,0,1,2,5,5
1520,Florian Müller,de,GK,,Freiburg,Bundesliga,27,1997,2.0,0,0,0,0,0,0,0,,0,0,0,0,0,0,0
1521,Kevin Müller,de,GK,,Heidenheim,Bundesliga,33,1991,14.0,1,1,1,0,0,1,1,100.0,0,0,0,0,0,1,4
1522,Thomas Müller,de,MF,FW,Bayern Munich,Bundesliga,35,1989,6.1,4,2,1,2,1,2,6,33.3,4,5,0,5,0,4,7
1523,Abdul Mumin,gh,DF,,Rayo Vallecano,La Liga,26,1998,14.0,16,9,12,4,0,6,15,40.0,9,23,14,9,18,34,85
1524,Marshall Munetsi,zw,MF,,Reims,Ligue 1,28,1996,13.8,22,12,13,5,4,14,25,56.0,11,18,3,15,15,37,16
1525,Rodrigo Muniz,br,FW,,Fulham,Premier League,23,2001,5.2,3,1,1,1,1,2,2,100.0,0,3,1,2,3,6,5
1526,Aihen Muñoz,es,DF,,Real Sociedad,La Liga,27,1997,3.9,5,4,3,2,0,4,12,33.3,8,2,1,1,7,12,18
1527,Álex Muñoz,es,DF,,Las Palmas,La Liga,30,1994,10.2,28,22,16,11,1,15,24,62.5,9,20,7,13,14,42,45
1528,Daniel Muñoz,co,DF,,Crystal Palace,Premier League,28,1996,15.0,56,38,26,21,9,25,44,56.8,19,14,2,12,16,72,43
1529,Iker Muñoz,es,MF,,Osasuna,La Liga,22,2002,2.0,2,0,1,1,0,1,2,50.0,1,3,0,3,1,3,2
1530,Javier Muñoz,es,MF,,Las Palmas,La Liga,29,1995,12.1,23,17,8,9,6,9,22,40.9,13,14,1,13,15,38,19
1531,Arijanet Muric,xk,GK,,Ipswich Town,Premier League,26,1998,15.0,0,0,0,0,0,0,2,0.0,2,0,0,0,0,0,10
1532,Murillo,br,DF,,Nott'ham Forest,Premier League,22,2002,15.7,20,12,14,5,1,11,22,50.0,11,29,21,8,10,30,93
1533,Vedat Muriqi,xk,FW,,Mallorca,La Liga,30,1994,11.0,1,0,0,1,0,0,1,0.0,1,1,0,1,4,5,20
1534,Jacob Murphy,eng,FW,,Newcastle Utd,Premier League,29,1995,7.9,9,6,4,4,1,6,11,54.5,5,11,0,11,3,12,6
1535,Yunus Musah,us,MF,FW,Milan,Serie A,22,2002,6.0,11,10,5,4,2,3,4,75.0,1,4,1,3,4,15,3
1536,Jamal Musiala,de,MF,,Bayern Munich,Bundesliga,21,2003,10.2,17,10,4,8,5,5,14,35.7,9,13,0,13,6,23,4
1537,Florent Muslija,xk,FW,MF,Freiburg,Bundesliga,26,1998,1.9,5,4,3,1,1,2,2,100.0,0,0,0,0,1,6,1
1538,Juan Musso,ar,GK,,Atalanta,Serie A,30,1994,1.0,0,0,0,0,0,0,0,,0,0,0,0,0,0,0
1539,Juan Musso,ar,GK,,Atlético Madrid,La Liga,30,1994,1.0,0,0,0,0,0,0,0,,0,0,0,0,0,0,0
1540,Kingstone Mutandwa,zm,MF,FW,Cagliari,Serie A,21,2003,0.5,0,0,0,0,0,0,0,,0,0,0,0,0,0,0
1541,Junior Mwanga,fr,MF,,Strasbourg,Ligue 1,21,2003,3.3,17,9,9,7,1,5,9,55.6,4,2,0,2,2,19,2
1542,Phillipp Mwene,at,DF,,Mainz 05,Bundesliga,30,1994,13.8,24,15,8,13,3,6,15,40.0,9,17,4,13,15,39,25
1543,Vitaliy Mykolenko,ua,DF,,Everton,Premier League,25,1999,12.3,19,14,13,3,3,10,20,50.0,10,7,3,4,12,31,46
1544,Joakim Mæhle,dk,DF,,Wolfsburg,Bundesliga,27,1997,6.4,4,2,3,1,0,2,6,33.3,4,8,1,7,6,10,12
1545,Obite N'Dicka,ci,DF,,Roma,Serie A,25,1999,16.0,14,12,7,7,0,8,10,80.0,2,19,14,5,20,34,54
1546,Nathan N'Goumou,fr,FW,,Gladbach,Bundesliga,24,2000,3.0,6,6,3,2,1,2,4,50.0,2,7,2,5,2,8,4
1547,Stanley N'Soki,fr,DF,,Hoffenheim,Bundesliga,25,1999,6.1,7,5,5,2,0,4,6,66.7,2,8,2,6,15,22,27
1548,Mickael Nade,fr,DF,,Saint-Étienne,Ligue 1,25,1999,6.6,21,15,13,8,0,10,10,100.0,0,12,4,8,8,29,26
1549,Bilal Nadir,fr,MF,,Marseille,Ligue 1,21,2003,0.2,1,0,0,1,0,0,0,,0,0,0,0,0,1,0
1550,Mahamadou Nagida,cm,DF,,Rennes,Ligue 1,19,2005,3.6,6,5,4,1,1,3,3,100.0,0,3,0,3,8,14,5
1551,Keito Nakamura,jp,FW,,Reims,Ligue 1,24,2000,12.9,15,10,6,5,4,7,15,46.7,8,10,0,10,7,22,7
1552,Sebastian Nanasi,se,FW,MF,Strasbourg,Ligue 1,22,2002,12.0,10,8,3,5,2,4,12,33.3,8,10,1,9,3,13,8
1553,Yael Nandjou,fr,DF,,Nice,Ligue 1,19,2005,1.7,4,1,2,1,1,4,8,50.0,4,4,1,3,4,8,7
1554,Matija Nastasić,rs,DF,,Leganés,La Liga,31,1993,10.9,13,7,12,1,0,8,13,61.5,5,24,17,7,11,24,77
1555,Natan,br,DF,,Betis,La Liga,23,2001,9.1,13,10,10,2,1,10,10,100.0,0,10,5,5,13,26,46
1556,Pau Navarro,es,DF,,Villarreal,La Liga,19,2005,2.4,6,5,3,3,0,5,8,62.5,3,3,2,1,0,6,12
1557,Roberto Navarro,es,MF,FW,Mallorca,La Liga,22,2002,9.6,22,16,10,8,4,6,12,50.0,6,12,0,12,11,33,7
1558,Jesús Navas,es,FW,MF,Sevilla,La Liga,39,1985,4.4,5,2,3,0,2,0,2,0.0,2,1,0,1,4,9,6
1559,Michel Ndary Adopo,fr,MF,,Cagliari,Serie A,24,2000,8.1,18,10,5,13,0,5,9,55.6,4,6,0,6,7,25,5
1560,Youssouf Ndayishimiye,bi,DF,MF,Nice,Ligue 1,26,1998,6.5,16,7,12,3,1,7,11,63.6,4,8,5,3,7,23,32
1561,Iliman Ndiaye,sn,FW,,Everton,Premier League,24,2000,13.0,28,15,12,8,8,11,24,45.8,13,13,3,10,15,43,10
1562,Junior Ndiaye,fr,FW,MF,Montpellier,Ligue 1,19,2005,0.8,1,0,1,0,0,0,0,,0,1,1,0,0,1,1
1563,Rassoul Ndiaye,sn,MF,,Le Havre,Ligue 1,23,2001,6.6,16,12,9,7,0,2,12,16.7,10,6,1,5,6,22,7
1564,Wilfred Ndidi,ng,MF,,Leicester City,Premier League,28,1996,13.5,48,28,26,19,3,15,33,45.5,18,32,12,20,9,57,47
1565,Tanguy Ndombele,fr,MF,,Nice,Ligue 1,27,1996,9.5,27,18,8,16,3,11,17,64.7,6,9,0,9,8,35,7
1566,Dan Ndoye,ch,FW,,Bologna,Serie A,24,2000,9.2,8,7,2,2,4,5,12,41.7,7,10,0,10,3,11,2
1567,Paul Nebel,de,MF,,Mainz 05,Bundesliga,22,2002,7.7,11,6,2,5,4,4,10,40.0,6,12,1,11,7,18,8
1568,Kosta Nedeljković,rs,DF,,Aston Villa,Premier League,19,2005,1.1,7,5,1,3,3,2,3,66.7,1,1,0,1,0,7,3
1569,Loïc Nego,hu,DF,FW,Le Havre,Ligue 1,33,1991,8.7,19,11,10,7,2,14,22,63.6,8,6,0,6,14,33,19
1570,Reiss Nelson,eng,FW,,Arsenal,Premier League,25,1999,0.0,1,0,0,1,0,0,1,0.0,1,0,0,0,0,1,1
1571,Reiss Nelson,eng,FW,,Fulham,Premier League,25,1999,5.4,8,6,3,3,2,5,13,38.5,8,11,0,11,5,13,2
1572,David Nemeth,at,DF,,St. Pauli,Bundesliga,23,2001,4.0,6,4,5,1,0,5,9,55.6,4,4,2,2,2,8,10
1573,David Neres,br,FW,MF,Napoli,Serie A,27,1997,3.6,5,2,1,2,2,2,4,50.0,2,2,0,2,1,6,0
1574,Neto,br,GK,,Bournemouth,Premier League,35,1989,2.0,0,0,0,0,0,0,0,,0,0,0,0,0,0,1
1575,Pedro Neto,pt,FW,,Chelsea,Premier League,24,2000,8.1,10,5,3,6,1,4,8,50.0,4,7,0,7,5,15,2
1576,Luca Netz,de,DF,,Gladbach,Bundesliga,21,2003,6.1,13,6,9,3,1,5,10,50.0,5,9,2,7,7,20,13
1577,Manuel Neuer,de,GK,,Bayern Munich,Bundesliga,38,1986,11.0,1,0,1,0,0,1,1,100.0,0,0,0,0,0,1,5
1578,Florian Neuhaus,de,MF,FW,Gladbach,Bundesliga,27,1997,1.0,2,0,1,1,0,1,6,16.7,5,5,0,5,2,4,0
1579,João Neves,pt,MF,,Paris S-G,Ligue 1,20,2004,11.4,46,24,14,22,10,20,32,62.5,12,15,3,12,8,54,8
1580,Yvan Neyou,cm,MF,,Leganés,La Liga,27,1997,11.4,26,18,9,15,2,11,21,52.4,10,16,0,16,13,39,18
1581,Cyril Ngonge,be,FW,DF,Napoli,Serie A,24,2000,1.2,4,3,1,3,0,1,3,33.3,2,0,0,0,0,4,3
1582,Mikayil Ngor Faye,sn,DF,,Rennes,Ligue 1,20,2004,5.7,11,8,8,2,1,6,6,100.0,0,4,2,2,8,19,21
1583,Steve Ngoura,fr,FW,,Le Havre,Ligue 1,19,2005,3.2,4,2,1,1,2,3,3,100.0,0,2,1,1,0,4,2
1584,Moussa Niakhate,sn,DF,,Lyon,Ligue 1,28,1996,12.0,24,15,21,3,0,11,14,78.6,3,13,8,5,8,32,43
1585,Abdoulaye Niakhate Ndiaye,sn,DF,,Brest,Ligue 1,22,2002,4.6,11,7,8,3,0,7,8,87.5,1,6,2,4,4,15,29
1586,Ibrahima Niane,sn,FW,,Angers,Ligue 1,25,1999,7.4,5,2,3,2,0,3,3,100.0,0,5,1,4,2,7,3
1587,Tanguy Nianzou,fr,DF,,Sevilla,La Liga,22,2002,5.8,7,5,6,0,1,5,6,83.3,1,1,0,1,8,15,27
1588,Rasmus Nicolaisen,dk,DF,,Toulouse,Ligue 1,27,1997,6.9,6,3,4,2,0,3,5,60.0,2,10,5,5,10,16,25
1589,Moritz Nicolas,de,GK,,Gladbach,Bundesliga,27,1997,11.0,0,0,0,0,0,0,0,,0,1,0,1,1,1,7
1590,Hans Nicolussi Caviglia,it,MF,,Venezia,Serie A,24,2000,10.9,20,11,3,12,5,15,23,65.2,8,10,2,8,7,27,15
1591,Saúl Ñíguez,es,MF,,Sevilla,La Liga,30,1994,5.2,11,8,3,5,3,2,8,25.0,6,8,1,7,7,18,9
1592,Eybi Nije,se,FW,MF,Torino,Serie A,19,2005,3.2,5,1,3,1,1,0,2,0.0,2,3,0,3,0,5,0
1593,Justin Njinmah,de,MF,FW,Werder Bremen,Bundesliga,24,2000,5.1,2,1,1,1,0,2,3,66.7,1,2,0,2,2,4,0
1594,Eddie Nketiah,eng,MF,FW,Crystal Palace,Premier League,25,1999,6.1,11,5,6,2,3,4,8,50.0,4,6,0,6,1,12,5
1595,Niels Nkounkou,fr,DF,MF,Eint Frankfurt,Bundesliga,24,2000,3.4,6,5,2,1,3,1,4,25.0,3,4,2,2,5,11,6
1596,Christopher Nkunku,fr,FW,,Chelsea,Premier League,27,1997,3.4,3,3,0,1,2,2,2,100.0,0,4,1,3,2,5,6
1597,Felix Nmecha,de,MF,,Dortmund,Bundesliga,24,2000,8.7,18,13,0,12,6,5,10,50.0,5,8,3,5,11,29,15
1598,Lukas Nmecha,de,FW,,Wolfsburg,Bundesliga,26,1998,1.0,0,0,0,0,0,0,0,,0,0,0,0,1,1,3
1599,Arnaud Nordin,fr,FW,,Montpellier,Ligue 1,26,1998,12.2,23,14,6,15,2,10,18,55.6,8,11,0,11,5,28,7
1600,Brooke Norton-Cuffy,eng,DF,MF,Genoa,Serie A,20,2004,1.1,1,0,0,1,0,0,1,0.0,1,1,0,1,1,2,0
1601,Tijjani Noslin,nl,FW,MF,Lazio,Serie A,25,1999,5.9,3,2,0,1,2,0,3,0.0,3,13,1,12,0,3,7
1602,Hugo Novoa,es,DF,FW,Alavés,La Liga,21,2003,2.5,8,5,4,3,1,5,5,100.0,0,2,1,1,0,8,6
1603,Randy Nteka,ao,FW,,Rayo Vallecano,La Liga,27,1997,6.0,9,5,2,5,2,4,6,66.7,2,6,1,5,2,11,6
1604,Ernest Nuamah,gh,FW,MF,Lyon,Ligue 1,21,2003,3.8,9,3,6,2,1,7,11,63.6,4,2,0,2,2,11,3
1605,Alexander Nübel,de,GK,,Stuttgart,Bundesliga,28,1996,14.0,0,0,0,0,0,0,0,,0,0,0,0,0,0,4
1606,Matheus Nunes,pt,MF,FW,Manchester City,Premier League,26,1998,5.9,17,9,9,5,3,7,14,50.0,7,8,2,6,4,21,7
1607,Darwin Núñez,uy,FW,,Liverpool,Premier League,25,1999,7.2,15,13,9,2,4,5,12,41.7,7,3,0,3,1,16,7
1608,Unai Núñez,es,DF,,Athletic Club,La Liga,27,1997,3.0,2,2,1,1,0,0,1,0.0,1,2,2,0,12,14,13
1609,Antonio Nusa,no,MF,DF,RB Leipzig,Bundesliga,19,2005,10.7,16,10,10,4,2,9,22,40.9,13,13,2,11,7,23,7
1610,Ethan Nwaneri,eng,MF,FW,Arsenal,Premier League,17,2007,1.2,1,0,0,1,0,0,5,0.0,5,4,1,3,0,1,1
1611,Ørjan Nyland,no,GK,,Sevilla,La Liga,34,1990,10.7,1,1,1,0,0,1,1,100.0,0,0,0,0,0,1,6
1612,Allan Nyom,cm,DF,MF,Getafe,La Liga,36,1988,5.7,9,5,4,4,1,8,10,80.0,2,2,1,1,2,11,14
1613,Rabby Nzingoula,cg,MF,,Montpellier,Ligue 1,19,2005,8.0,29,17,11,13,5,12,24,50.0,12,9,2,7,12,41,10
1614,M'Bala Nzola,ao,FW,,Lens,Ligue 1,28,1996,8.4,3,2,0,0,3,2,5,40.0,3,3,1,2,2,5,5
1615,Marwann Nzuzi,fr,DF,,Saint-Étienne,Ligue 1,20,2004,1.4,2,2,1,0,1,1,2,50.0,1,0,0,0,2,4,6
1616,Christian Nørgaard,dk,MF,,Brentford,Premier League,30,1994,11.8,36,23,16,18,2,21,31,67.7,10,20,6,14,17,53,27
1617,Jake O'Brien,ie,DF,,Everton,Premier League,23,2001,0.4,2,2,1,1,0,2,2,100.0,0,1,0,1,0,2,0
1618,Matt O'Riley,dk,MF,,Brighton,Premier League,24,2000,2.5,5,4,1,4,0,2,5,40.0,3,1,0,1,4,9,3
1619,Dara O'Shea,ie,DF,,Ipswich Town,Premier League,25,1999,12.7,18,11,11,6,1,6,9,66.7,3,25,21,4,18,36,71
1620,Adam Obert,sk,DF,,Cagliari,Serie A,22,2002,4.1,12,8,4,8,0,6,12,50.0,6,8,4,4,11,23,18
1621,Jan Oblak,si,GK,,Atlético Madrid,La Liga,31,1993,16.0,0,0,0,0,0,0,0,,0,0,0,0,0,0,3
1622,Lucas Ocampos,ar,FW,,Sevilla,La Liga,30,1994,1.9,3,2,2,0,1,1,2,50.0,1,2,0,2,0,3,2
1623,Jens Odgaard,dk,MF,FW,Bologna,Serie A,25,1999,8.7,11,10,2,8,1,3,8,37.5,5,7,1,6,5,16,6
1624,Wilson Odobert,fr,FW,,Tottenham,Premier League,20,2004,1.8,5,2,2,2,1,4,6,66.7,2,1,0,1,0,5,1
1625,Álvaro Odriozola,es,DF,,Real Sociedad,La Liga,29,1995,0.5,1,1,1,0,0,0,0,,0,0,0,0,0,1,1
1626,Tim Oermann,de,DF,,Bochum,Bundesliga,21,2003,6.8,9,5,7,2,0,4,9,44.4,5,7,4,3,8,17,14
1627,Chiedozie Ogbene,ie,FW,,Ipswich Town,Premier League,27,1997,2.6,7,3,1,2,4,2,4,50.0,2,1,0,1,1,8,3
1628,Ifechukwu Ogbus,ch,DF,,Freiburg,Bundesliga,19,2005,0.2,1,1,0,0,1,0,1,0.0,1,0,0,0,1,2,2
1629,Hamzat Ojediran,ng,MF,,Lens,Ligue 1,21,2003,3.2,17,10,5,10,2,4,11,36.4,7,8,2,6,9,26,5
1630,Noah Okafor,ch,FW,,Milan,Serie A,24,2000,4.6,2,1,0,0,2,0,1,0.0,1,1,0,1,2,4,1
1631,Caleb Okoli,it,DF,,Leicester City,Premier League,23,2001,8.7,18,10,6,11,1,9,12,75.0,3,18,11,7,10,28,56
1632,Yllan Okou,fr,DF,,Hellas Verona,Serie A,21,2002,0.0,0,0,0,0,0,0,0,,0,1,0,1,0,0,0
1633,Maduka Okoye,ng,GK,,Udinese,Serie A,25,1999,14.0,0,0,0,0,0,0,0,,0,0,0,0,0,0,4
1634,Joseph Okumu,ke,DF,,Reims,Ligue 1,27,1997,6.3,16,8,13,3,0,9,13,69.2,4,13,9,4,11,27,29
1635,Olasagasti,es,MF,,Real Sociedad,La Liga,24,2000,1.7,6,2,3,2,1,2,7,28.6,5,2,1,1,2,8,1
1636,Ben Old,nz,MF,FW,Saint-Étienne,Ligue 1,22,2002,4.2,4,4,3,1,0,2,8,25.0,6,5,1,4,1,5,1
1637,Michael Olise,fr,FW,MF,Bayern Munich,Bundesliga,23,2001,9.6,18,11,6,10,2,7,14,50.0,7,11,0,11,2,20,6
1638,Brian Oliván,es,DF,,Espanyol,La Liga,30,1994,7.2,7,6,5,2,0,2,9,22.2,7,5,2,3,6,13,18
1639,Lucas Oliveira Rosa,br,DF,,Valladolid,La Liga,24,2000,16.0,43,27,33,9,1,30,43,69.8,13,20,9,11,24,67,45
1640,Mathías Olivera,uy,DF,,Napoli,Serie A,27,1997,13.4,39,22,20,14,5,19,30,63.3,11,16,5,11,16,55,32
1641,Dani Olmo,es,MF,FW,Barcelona,La Liga,26,1998,6.6,9,6,4,3,2,2,7,28.6,5,3,2,1,1,10,5
1642,Robin Olsen,se,GK,,Aston Villa,Premier League,34,1990,0.5,1,0,1,0,0,1,1,100.0,0,0,0,0,0,1,1
1643,Warmed Omari,km,DF,,Lyon,Ligue 1,24,2000,0.1,0,0,0,0,0,0,0,,0,0,0,0,0,0,1
1644,Becir Omeragic,ch,DF,,Montpellier,Ligue 1,22,2002,8.3,16,6,11,4,1,9,14,64.3,5,8,4,4,5,21,29
1645,Jonas Omlin,ch,GK,,Gladbach,Bundesliga,30,1994,3.0,0,0,0,0,0,0,0,,0,0,0,0,0,0,0
1646,Ado Onaiwu,jp,MF,FW,Auxerre,Ligue 1,29,1995,5.5,5,4,0,5,0,2,6,33.3,4,1,0,1,1,6,6
1647,Amadou Onana,be,MF,,Aston Villa,Premier League,23,2001,8.0,25,15,13,10,2,8,16,50.0,8,9,5,4,16,41,17
1648,André Onana,cm,GK,,Manchester Utd,Premier League,28,1996,16.0,1,1,1,0,0,1,2,50.0,1,0,0,0,0,1,7
1649,Karim Onisiwo,at,MF,FW,Mainz 05,Bundesliga,32,1992,1.2,1,1,0,0,1,0,0,,0,0,0,0,0,1,0
1650,Paul Onuachu,ng,FW,,Southampton,Premier League,30,1994,1.3,0,0,0,0,0,0,0,,0,1,0,1,1,1,1
1651,Frank Onyeka,ng,MF,,Brentford,Premier League,26,1998,0.3,0,0,0,0,0,0,0,,0,0,0,0,0,0,0
1652,Frank Onyeka,ng,MF,,Augsburg,Bundesliga,26,1998,11.7,24,19,8,12,4,10,21,47.6,11,14,4,10,17,41,13
1653,Loïs Openda,be,FW,,RB Leipzig,Bundesliga,24,2000,13.0,6,3,2,4,0,1,4,25.0,3,8,1,7,1,7,3
1654,Christopher Operi,ci,DF,FW,Le Havre,Ligue 1,27,1997,13.0,13,9,6,2,5,7,12,58.3,5,20,6,14,14,27,30
1655,Victor Orakpo,ng,FW,,Nice,Ligue 1,18,2006,0.4,0,0,0,0,0,0,0,,0,0,0,0,0,0,0
1656,Gift Orban,ng,FW,DF,Lyon,Ligue 1,22,2002,2.1,0,0,0,0,0,0,1,0.0,1,0,0,0,0,0,0
1657,Willi Orban,hu,DF,,RB Leipzig,Bundesliga,32,1992,11.9,22,13,12,10,0,12,16,75.0,4,23,18,5,9,31,68
1658,Ivan Ordets,ua,DF,,Bochum,Bundesliga,32,1992,7.0,7,3,6,1,0,4,6,66.7,2,11,6,5,15,22,41
1659,Gaetano Oristanio,it,MF,FW,Venezia,Serie A,22,2002,13.0,8,6,3,4,1,3,7,42.9,4,13,0,13,5,13,4
1660,Aimar Oroz,es,MF,FW,Osasuna,La Liga,23,2001,15.4,18,9,8,6,4,7,22,31.8,15,17,2,15,15,33,2
1661,Riccardo Orsolini,it,FW,,Bologna,Serie A,27,1997,8.9,6,6,1,3,2,2,5,40.0,3,10,0,10,3,9,5
1662,Stefan Ortega,de,GK,,Manchester City,Premier League,32,1992,3.0,0,0,0,0,0,0,0,,0,0,0,0,0,0,4
1663,Gabriel Osei Misehouy,nl,FW,MF,Girona,La Liga,19,2005,2.5,1,1,0,1,0,0,0,,0,0,0,0,0,1,0
1664,Gabriel Osho,ng,DF,,Auxerre,Ligue 1,26,1998,11.1,12,8,10,1,1,6,11,54.5,5,22,14,8,11,23,52
1665,Yordan Osorio,ve,DF,,Parma,Serie A,30,1994,1.9,5,3,4,1,0,2,2,100.0,0,3,1,2,4,9,6
1666,Patrick Osterhage,de,MF,,Freiburg,Bundesliga,24,2000,11.1,25,16,9,15,1,6,14,42.9,8,11,1,10,14,39,11
1667,William Osula,dk,FW,MF,Newcastle Utd,Premier League,21,2003,0.3,0,0,0,0,0,0,0,,0,0,0,0,0,0,0
1668,Jibril Othman,tn,FW,,Saint-Étienne,Ligue 1,20,2004,0.1,0,0,0,0,0,0,0,,0,0,0,0,0,0,0
1669,David Otorbi,es,MF,,Valencia,La Liga,17,2007,0.2,0,0,0,0,0,0,0,,0,1,0,1,0,0,0
1670,Dango Ouattara,bf,FW,DF,Bournemouth,Premier League,22,2002,6.8,19,16,5,7,7,11,23,47.8,12,13,3,10,6,25,15
1671,Guimissongui Ouattara,fr,FW,MF,Strasbourg,Ligue 1,19,2005,0.8,1,1,0,0,1,0,0,,0,2,0,2,1,2,0
1672,Kassoum Ouattara,fr,DF,FW,Monaco,Ligue 1,20,2004,3.0,8,6,4,4,0,4,12,33.3,8,4,0,4,4,12,1
1673,Remi Oudin,fr,MF,FW,Lecce,Serie A,28,1996,3.0,3,1,1,1,1,2,4,50.0,2,5,2,3,1,4,0
1674,Assan Ouedraogo,de,MF,,RB Leipzig,Bundesliga,18,2006,0.6,0,0,0,0,0,0,0,,0,1,0,1,0,0,0
1675,Zinédine Ould Khaled,fr,MF,,Angers,Ligue 1,24,2000,0.6,1,1,1,0,0,0,1,0.0,1,2,0,2,0,1,1
1676,Beres Owusu,fr,DF,,Saint-Étienne,Ligue 1,21,2003,1.0,2,2,1,1,0,2,2,100.0,0,2,2,0,0,2,5
1677,Elisha Owusu,gh,MF,,Auxerre,Ligue 1,27,1997,13.4,43,25,16,26,1,20,31,64.5,11,17,3,14,22,65,20
1678,Mikel Oyarzabal,es,FW,MF,Real Sociedad,La Liga,27,1997,11.5,10,5,3,4,3,4,9,44.4,5,6,0,6,0,10,6
1679,Salih Özcan,tr,MF,,Wolfsburg,Bundesliga,26,1998,3.7,2,2,1,0,1,1,5,20.0,4,5,1,4,7,9,4
1680,Cenk Özkacar,tr,DF,,Valladolid,La Liga,24,2000,2.2,3,3,2,1,0,2,5,40.0,3,4,2,2,7,10,18
1681,Jon Pacheco,es,DF,,Real Sociedad,La Liga,23,2001,4.3,4,3,3,1,0,2,3,66.7,1,5,4,1,4,8,21
1682,Willian Pacho,ec,DF,,Paris S-G,Ligue 1,23,2001,12.3,32,18,20,12,0,14,20,70.0,6,18,10,8,22,54,44
1683,Alex Padilla,es,GK,,Athletic Club,La Liga,21,2003,3.6,0,0,0,0,0,0,0,,0,0,0,0,0,0,2
1684,Exequiel Palacios,ar,MF,,Leverkusen,Bundesliga,26,1998,2.9,1,1,0,0,1,1,3,33.3,2,4,0,4,2,3,1
1685,Tiago Palacios,ar,DF,,Inter,Serie A,21,2003,0.1,0,0,0,0,0,0,0,,0,0,0,0,1,1,0
1686,Isaac Palazón Camacho,es,FW,MF,Rayo Vallecano,La Liga,29,1994,10.5,14,11,5,5,4,6,18,33.3,12,9,1,8,5,19,4
1687,Alberto Paleari,it,GK,,Torino,Serie A,32,1992,1.0,0,0,0,0,0,0,0,,0,0,0,0,0,0,2
1688,Marco Palestra,it,DF,,Atalanta,Serie A,19,2005,0.7,2,1,1,1,0,1,1,100.0,0,0,0,0,0,2,0
1689,João Palhinha,pt,MF,,Bayern Munich,Bundesliga,29,1995,3.9,7,7,1,5,1,4,7,57.1,3,5,0,5,3,10,4
1690,Nicolas Pallois,fr,DF,,Nantes,Ligue 1,37,1987,9.0,22,9,15,6,1,13,23,56.5,10,12,4,8,12,34,59
1691,Cole Palmer,eng,MF,,Chelsea,Premier League,22,2002,15.4,11,7,6,4,1,4,13,30.8,9,10,1,9,5,16,7
1692,Emerson Palmieri,it,DF,,West Ham,Premier League,30,1994,12.3,37,20,23,12,2,14,24,58.3,10,18,4,14,12,49,26
1693,Mats Pannewig,de,MF,,Bochum,Bundesliga,20,2004,1.1,2,2,1,1,0,0,4,0.0,4,4,0,4,0,2,4
1694,Lucas Paquetá,br,MF,,West Ham,Premier League,27,1997,12.5,25,17,13,10,2,8,22,36.4,14,19,2,17,9,34,21
1695,Aitor Paredes,es,DF,,Athletic Club,La Liga,24,2000,10.4,8,7,6,2,0,4,9,44.4,5,14,6,8,15,23,61
1696,Leandro Paredes,ar,MF,,Roma,Serie A,30,1994,3.4,7,5,3,3,1,2,5,40.0,3,3,1,2,6,13,5
1697,Daniel Parejo,es,MF,,Villarreal,La Liga,35,1989,12.8,23,18,14,7,2,11,25,44.0,14,10,3,7,10,33,17
1698,Fabiano Parisi,it,DF,,Fiorentina,Serie A,24,2000,1.9,6,4,1,3,2,1,2,50.0,1,1,0,1,2,8,4
1699,Thomas Partey,gh,MF,DF,Arsenal,Premier League,31,1993,13.5,40,28,15,13,12,22,38,57.9,16,10,5,5,15,55,27
1700,Mario Pašalić,hr,MF,,Atalanta,Serie A,29,1995,10.3,12,8,5,6,1,5,13,38.5,8,7,1,6,6,18,14
1701,Álvaro Pascual,es,FW,,Sevilla,La Liga,22,2002,0.5,1,0,0,0,1,1,2,50.0,1,0,0,0,1,2,0
1702,Felix Passlack,de,DF,,Bochum,Bundesliga,26,1998,12.6,32,17,21,8,3,21,38,55.3,17,23,8,15,9,41,28
1703,Patric,es,DF,,Lazio,Serie A,31,1993,6.5,7,4,5,2,0,4,8,50.0,4,1,1,0,3,10,18
1704,Nathan Patterson,sct,DF,,Everton,Premier League,23,2001,0.2,1,0,0,1,0,1,1,100.0,0,0,0,0,0,1,0
1705,Benjamin Pavard,fr,DF,,Inter,Serie A,28,1996,8.5,16,8,7,6,3,10,14,71.4,4,7,5,2,10,26,18
1706,Aleksandar Pavlovic,de,MF,,Bayern Munich,Bundesliga,20,2004,6.1,13,7,2,7,4,6,11,54.5,5,9,1,8,1,14,6
1707,Strahinja Pavlović,rs,DF,,Milan,Serie A,23,2001,7.3,17,10,11,6,0,10,19,52.6,9,4,2,2,4,21,28
1708,Leonardo Pavoletti,it,FW,MF,Cagliari,Serie A,36,1988,1.9,0,0,0,0,0,0,0,,0,1,1,0,0,0,1
1709,Martín Payero,ar,MF,,Udinese,Serie A,26,1998,6.4,8,5,1,3,4,5,9,55.6,4,8,1,7,5,13,5
1710,Nicolás Paz,ar,MF,FW,Como,Serie A,20,2004,12.9,22,14,6,10,6,9,17,52.9,8,22,2,20,11,33,8
1711,Mads Pedersen,dk,DF,,Augsburg,Bundesliga,28,1996,2.4,6,5,4,1,1,3,4,75.0,1,4,0,4,2,8,5
1712,Marcus Pedersen,no,DF,,Torino,Serie A,24,2000,7.8,7,5,2,4,1,5,9,55.6,4,6,2,4,2,9,15
1713,Pedri,es,MF,,Barcelona,La Liga,22,2002,14.8,26,14,7,16,3,12,35,34.3,23,21,2,19,12,38,11
1714,Pedro,es,FW,MF,Lazio,Serie A,37,1987,4.9,8,5,1,4,3,4,8,50.0,4,3,0,3,0,8,1
1715,Kévin Pedro,fr,DF,,Saint-Étienne,Ligue 1,18,2006,0.1,3,0,2,1,0,3,3,100.0,0,1,0,1,2,5,1
1716,Adrià Pedrosa,es,DF,,Sevilla,La Liga,26,1998,11.2,31,21,22,4,5,19,32,59.4,13,20,4,16,9,40,36
1717,Jordan Pefok,us,FW,,Union Berlin,Bundesliga,28,1996,6.9,6,4,5,0,1,1,4,25.0,3,4,1,3,4,10,12
1718,Pejiño,es,FW,,Las Palmas,La Liga,28,1996,0.2,1,1,0,1,0,1,1,100.0,0,0,0,0,0,1,0
1719,Pietro Pellegri,it,FW,,Empoli,Serie A,23,2001,4.6,7,2,0,6,1,2,4,50.0,2,2,0,2,0,7,3
1720,Lorenzo Pellegrini,it,MF,,Roma,Serie A,28,1996,9.9,11,7,2,6,3,3,8,37.5,5,2,0,2,0,11,10
1721,Luca Pellegrini,it,DF,,Lazio,Serie A,25,1999,3.9,5,3,1,4,0,2,5,40.0,3,4,0,4,5,10,8
1722,Théo Pellenard,fr,DF,,Auxerre,Ligue 1,30,1994,0.5,3,2,2,1,0,1,3,33.3,2,1,0,1,0,3,3
1723,Andy Pelmard,fr,DF,,Lecce,Serie A,24,2000,1.4,6,6,5,1,0,4,4,100.0,0,1,0,1,0,6,5
1724,Timothee Pembele,fr,DF,FW,Le Havre,Ligue 1,22,2002,6.5,12,9,6,5,1,4,8,50.0,4,11,4,7,4,16,23
1725,Faris Pemi Moumbagna,cm,FW,,Marseille,Ligue 1,24,2000,0.1,0,0,0,0,0,0,0,,0,0,0,0,0,0,0
1726,Iñaki Peña,es,GK,,Barcelona,La Liga,25,1999,12.5,0,0,0,0,0,0,2,0.0,2,0,0,0,0,0,18
1727,Rubén Peña,es,FW,MF,Osasuna,La Liga,33,1991,5.0,6,0,1,1,4,1,12,8.3,11,8,0,8,4,10,7
1728,Nicolas Pépé,ci,FW,MF,Villarreal,La Liga,29,1995,6.3,4,1,1,1,2,0,3,0.0,3,3,1,2,3,7,3
1729,Peque,es,MF,FW,Sevilla,La Liga,22,2002,7.8,9,3,3,5,1,3,11,27.3,8,11,0,11,7,16,4
1730,Óscar Perea,co,MF,,Strasbourg,Ligue 1,19,2005,0.1,0,0,0,0,0,0,0,,0,0,0,0,0,0,0
1731,Andreas Pereira,br,MF,,Fulham,Premier League,28,1996,11.2,10,4,3,4,3,5,20,25.0,15,6,1,5,4,14,3
1732,Mathias Pereira Lage,pt,FW,MF,Brest,Ligue 1,28,1996,5.7,11,8,6,3,2,4,9,44.4,5,6,1,5,6,17,10
1733,Pedro Pereira,pt,DF,,Monza,Serie A,26,1998,11.4,16,8,8,7,1,8,19,42.1,11,10,4,6,7,23,26
1734,Ricardo Pereira,pt,DF,,Leicester City,Premier League,31,1993,1.6,3,2,0,1,2,1,4,25.0,3,3,1,2,1,4,0
1735,Gastón Pereiro,uy,MF,,Genoa,Serie A,29,1995,0.3,1,0,0,1,0,1,1,100.0,0,0,0,0,0,1,1
1736,Daniel Peretz,il,GK,,Bayern Munich,Bundesliga,24,2000,2.0,0,0,0,0,0,0,1,0.0,1,0,0,0,0,0,1
1737,Ayoze Pérez,es,FW,,Villarreal,La Liga,31,1993,7.2,8,5,2,5,1,2,8,25.0,6,7,0,7,2,10,7
1738,Carles Pérez,es,MF,FW,Getafe,La Liga,26,1998,11.6,22,16,6,10,6,15,30,50.0,15,12,1,11,6,28,13
1739,Francisco Perez,es,MF,,Valencia,La Liga,22,2002,0.9,1,1,0,1,0,0,1,0.0,1,1,0,1,0,1,1
1740,Kike Pérez,es,MF,,Valladolid,La Liga,27,1997,10.9,33,22,13,18,2,13,24,54.2,11,14,3,11,7,40,15
1741,Luis Pérez,es,DF,,Valladolid,La Liga,29,1995,16.6,27,18,16,6,5,17,26,65.4,9,18,5,13,20,47,53
1742,Nehuén Pérez,ar,DF,,Udinese,Serie A,24,2000,2.0,1,1,0,0,1,0,1,0.0,1,2,2,0,1,2,7
1743,Simone Perilli,it,GK,,Hellas Verona,Serie A,29,1995,1.0,0,0,0,0,0,0,0,,0,0,0,0,0,0,1
1744,Mattia Perin,it,GK,,Juventus,Serie A,32,1992,5.0,0,0,0,0,0,0,0,,0,0,0,0,0,0,2
1745,Romain Perraud,fr,DF,,Betis,La Liga,27,1997,13.1,23,15,10,9,4,15,36,41.7,21,10,2,8,15,38,40
1746,Lucas Perri,br,GK,,Lyon,Ligue 1,27,1997,15.0,1,1,1,0,0,0,3,0.0,3,1,0,1,0,1,9
1747,Gaëtan Perrin,fr,MF,FW,Auxerre,Ligue 1,28,1996,11.3,31,15,15,8,8,17,28,60.7,11,5,0,5,6,37,2
1748,Máximo Perrone,ar,MF,,Como,Serie A,21,2003,7.3,14,9,8,5,1,4,19,21.1,15,4,0,4,6,20,16
1749,Matteo Pessina,it,MF,,Monza,Serie A,27,1997,9.5,15,4,3,11,1,9,14,64.3,5,6,0,6,12,27,7
1750,Andrea Petagna,it,FW,,Monza,Serie A,29,1995,2.0,0,0,0,0,0,0,0,,0,0,0,0,1,1,1
1751,Léo Pétrot,fr,DF,,Saint-Étienne,Ligue 1,27,1997,10.5,35,22,22,12,1,21,24,87.5,3,20,7,13,19,54,37
1752,Đorđe Petrović,rs,GK,,Strasbourg,Ligue 1,25,1999,12.0,0,0,0,0,0,0,0,,0,0,0,0,0,0,9
1753,Giuseppe Pezzella,it,DF,FW,Empoli,Serie A,27,1997,12.3,25,16,17,7,1,17,31,54.8,14,11,4,7,5,30,42
1754,Maximilian Philipp,de,FW,,Freiburg,Bundesliga,30,1994,0.0,0,0,0,0,0,0,0,,0,0,0,0,0,0,0
1755,Kalvin Phillips,eng,MF,,Ipswich Town,Premier League,29,1995,6.0,14,6,4,9,1,8,18,44.4,10,16,3,13,7,21,11
1756,Jaden Philogene Bidace,eng,FW,MF,Aston Villa,Premier League,22,2002,3.7,11,5,4,7,0,4,6,66.7,2,5,0,5,3,14,2
1757,Pica,es,DF,,Alavés,La Liga,22,2002,4.5,7,6,6,1,0,3,8,37.5,5,6,5,1,7,14,19
1758,Roberto Piccoli,it,FW,,Cagliari,Serie A,23,2001,14.8,4,2,2,1,1,1,2,50.0,1,6,2,4,1,5,13
1759,Benedikt Pichler,at,FW,,Holstein Kiel,Bundesliga,27,1997,8.0,5,2,1,0,4,2,4,50.0,2,4,2,2,2,7,11
1760,Jordan Pickford,eng,GK,,Everton,Premier League,30,1994,15.0,1,0,1,0,0,1,1,100.0,0,0,0,0,1,2,18
1761,Amos Pieper,de,DF,,Werder Bremen,Bundesliga,26,1998,3.5,7,2,5,1,1,3,6,50.0,3,7,3,4,10,17,14
1762,Marvin Pieringer,de,FW,,Heidenheim,Bundesliga,25,1999,9.4,10,5,3,4,3,2,4,50.0,2,11,1,10,3,13,12
1763,Nicholas Pierini,it,MF,,Venezia,Serie A,26,1998,0.9,0,0,0,0,0,0,1,0.0,1,2,0,2,0,0,0
1764,Santiago Pierotti,ar,FW,,Lecce,Serie A,23,2001,6.7,13,9,8,4,1,9,17,52.9,8,7,2,5,5,18,8
1765,Balthazar Pierret,fr,MF,,Lecce,Serie A,24,2000,5.8,16,8,10,6,0,3,8,37.5,5,6,1,5,3,19,7
1766,Andrea Pinamonti,it,FW,,Genoa,Serie A,25,1999,13.5,5,3,0,4,1,0,3,0.0,3,9,2,7,1,6,16
1767,Ethan Pinnock,jm,DF,,Brentford,Premier League,31,1993,16.0,29,16,14,12,3,12,17,70.6,5,25,16,9,18,47,105
1768,Yeremi Pino,es,MF,,Villarreal,La Liga,22,2002,7.7,16,11,5,8,3,9,19,47.4,10,11,1,10,4,20,4
1769,Niccolò Pisilli,it,MF,,Roma,Serie A,20,2004,7.1,12,7,7,4,1,6,9,66.7,3,8,1,7,5,17,7
1770,Semuel Pizzignacco,it,GK,,Monza,Serie A,23,2001,3.0,0,0,0,0,0,0,0,,0,0,0,0,0,0,1
1771,Alassane Pléa,fr,MF,FW,Gladbach,Bundesliga,31,1993,10.6,4,2,0,1,3,2,5,40.0,3,5,0,5,2,6,2
1772,Tommaso Pobega,it,MF,,Bologna,Serie A,25,1999,4.5,15,9,7,5,3,9,13,69.2,4,9,2,7,7,22,6
1773,Daniel Podence,pt,MF,FW,Wolves,Premier League,29,1995,0.5,0,0,0,0,0,0,1,0.0,1,0,0,0,0,0,0
1774,Joel Pohjanpalo,fi,FW,,Venezia,Serie A,30,1994,12.7,2,2,1,1,0,0,2,0.0,2,3,2,1,4,6,16
1775,Matteo Politano,it,FW,MF,Napoli,Serie A,31,1993,13.5,10,5,5,5,0,7,20,35.0,13,10,1,9,5,15,19
1776,Alfie Pond,eng,DF,,Wolves,Premier League,20,2004,0.0,0,0,0,0,0,0,0,,0,0,0,0,0,0,0
1777,Marin Pongračić,hr,DF,,Fiorentina,Serie A,27,1997,1.1,1,1,1,0,0,1,3,33.3,2,0,0,0,2,3,6
1778,Nick Pope,eng,GK,,Newcastle Utd,Premier League,32,1992,15.0,0,0,0,0,0,0,0,,0,1,0,1,1,1,16
1779,Finn Porath,de,DF,MF,Holstein Kiel,Bundesliga,27,1997,10.7,29,17,16,9,4,18,31,58.1,13,17,6,11,10,39,26
1780,Pedro Porro,es,DF,,Tottenham,Premier League,25,1999,15.0,28,20,11,10,7,19,35,54.3,16,24,9,15,17,45,40
1781,Portu,es,FW,MF,Girona,La Liga,32,1992,2.4,4,2,2,1,1,2,2,100.0,0,4,0,4,0,4,1
1782,Stefan Posch,at,DF,,Bologna,Serie A,27,1997,7.0,22,14,11,7,4,13,22,59.1,9,18,4,14,5,27,19
1783,Tom Pouilly,fr,DF,,Lens,Ligue 1,21,2003,0.5,2,2,1,1,0,1,1,100.0,0,1,0,1,1,3,3
1784,Yussuf Poulsen,dk,FW,MF,RB Leipzig,Bundesliga,30,1994,2.2,5,3,1,4,0,3,6,50.0,3,4,2,2,0,5,4
1785,Beñat Prados,es,MF,,Athletic Club,La Liga,23,2001,8.6,16,12,6,8,2,5,21,23.8,16,12,1,11,18,34,16
1786,Alexander Prass,at,DF,,Hoffenheim,Bundesliga,23,2001,11.3,23,13,13,7,3,13,36,36.1,23,17,3,14,3,26,24
1787,Matteo Prati,it,MF,,Cagliari,Serie A,20,2003,2.6,5,2,1,3,1,2,6,33.3,4,0,0,0,2,7,3
1788,Abdón Prats,es,FW,MF,Mallorca,La Liga,32,1992,2.4,1,1,1,0,0,0,0,,0,2,1,1,1,2,3
1789,Grischa Prömel,de,MF,,Hoffenheim,Bundesliga,29,1995,1.9,0,0,0,0,0,0,1,0.0,1,1,1,0,2,2,4
1790,Ivan Provedel,it,GK,,Lazio,Serie A,30,1994,16.0,0,0,0,0,0,0,0,,0,1,0,1,0,0,7
1791,Ivan Prtajin,hr,FW,,Union Berlin,Bundesliga,28,1996,0.1,0,0,0,0,0,0,0,,0,0,0,0,0,0,0
1792,Javi Puado,es,FW,MF,Espanyol,La Liga,26,1998,13.2,12,10,7,3,2,4,5,80.0,1,7,0,7,3,15,9
1793,Tymoteusz Puchacz,pl,DF,,Holstein Kiel,Bundesliga,25,1999,4.4,9,4,6,3,0,5,7,71.4,2,4,1,3,3,12,11
1794,Diego Pugno,it,FW,,Juventus,Serie A,18,2006,0.1,0,0,0,0,0,0,0,,0,0,0,0,0,0,0
1795,Christian Pulisic,us,MF,FW,Milan,Serie A,26,1998,10.9,20,12,6,7,7,6,14,42.9,8,9,1,8,0,20,5
1796,Jarell Quansah,eng,DF,,Liverpool,Premier League,21,2003,1.9,8,6,6,2,0,4,5,80.0,1,2,2,0,3,11,10
1797,Leopold Querfeld,at,DF,,Union Berlin,Bundesliga,20,2003,5.2,6,2,4,2,0,3,6,50.0,3,8,1,7,6,12,28
1798,Dani Raba,es,FW,MF,Leganés,La Liga,29,1995,4.4,14,8,7,5,2,6,14,42.9,8,5,0,5,6,20,5
1799,Adrien Rabiot,fr,MF,,Marseille,Ligue 1,29,1995,8.6,20,14,9,8,3,10,14,71.4,4,9,0,9,10,30,14
1800,Hamza Rafia,tn,MF,,Lecce,Serie A,25,1999,8.8,30,17,12,15,3,10,24,41.7,14,7,2,5,4,34,11
1801,Antonio Raillo,es,DF,,Mallorca,La Liga,33,1991,16.6,14,8,6,5,3,6,7,85.7,1,22,17,5,22,36,72
1802,Antonio Raimondo,it,FW,DF,Venezia,Serie A,20,2004,1.0,2,1,1,1,0,0,0,,0,0,0,0,0,2,0
1803,Ylber Ramadani,al,MF,,Lecce,Serie A,28,1996,13.6,32,18,14,18,0,19,27,70.4,8,22,8,14,12,44,21
1804,Benito Ramírez,es,DF,MF,Las Palmas,La Liga,29,1995,3.4,7,3,3,4,0,7,14,50.0,7,6,3,3,1,8,11
1805,Sandro Ramírez,es,FW,MF,Las Palmas,La Liga,29,1995,9.9,16,12,6,9,1,9,18,50.0,9,5,0,5,10,26,13
1806,Gonçalo Ramos,pt,FW,,Paris S-G,Ligue 1,23,2001,2.0,4,3,2,1,1,2,2,100.0,0,1,0,1,0,4,2
1807,Aaron Ramsdale,eng,GK,,Southampton,Premier League,26,1998,9.0,0,0,0,0,0,0,1,0.0,1,0,0,0,2,2,6
1808,Jacob Ramsey,eng,FW,MF,Aston Villa,Premier League,23,2001,7.0,7,3,3,3,1,3,5,60.0,2,8,2,6,5,12,2
1809,Luca Ranieri,it,DF,,Fiorentina,Serie A,25,1999,13.3,12,7,9,2,1,5,9,55.6,4,22,15,7,9,21,51
1810,Grant Ranos,am,FW,,Gladbach,Bundesliga,21,2003,0.1,1,0,0,1,0,0,1,0.0,1,1,0,1,0,1,0
1811,Lilian Raolisoa,fr,DF,FW,Angers,Ligue 1,24,2000,2.5,5,3,2,1,2,1,6,16.7,5,2,1,1,2,7,5
1812,Raphinha,br,FW,MF,Barcelona,La Liga,28,1996,16.6,21,13,6,12,3,8,15,53.3,7,12,2,10,5,26,16
1813,Marcus Rashford,eng,FW,MF,Manchester Utd,Premier League,27,1997,10.9,7,4,2,2,3,3,9,33.3,6,8,0,8,4,11,7
1814,Giacomo Raspadori,it,FW,MF,Napoli,Serie A,24,2000,2.9,3,1,2,1,0,2,4,50.0,2,5,1,4,2,5,1
1815,Andrei Ratiu,ro,DF,,Rayo Vallecano,La Liga,26,1998,13.9,29,19,19,5,5,19,23,82.6,4,13,2,11,11,40,27
1816,Raúl,es,FW,MF,Osasuna,La Liga,24,2000,4.6,4,3,0,2,2,1,2,50.0,1,3,0,3,0,4,2
1817,David Raum,de,DF,,RB Leipzig,Bundesliga,26,1998,5.4,11,8,5,4,2,2,6,33.3,4,5,1,4,2,13,10
1818,Federico Ravaglia,it,GK,,Bologna,Serie A,25,1999,5.0,0,0,0,0,0,0,0,,0,0,0,0,0,0,2
1819,Rayan Raveloson,mg,MF,DF,Auxerre,Ligue 1,27,1997,8.0,6,5,2,4,0,5,15,33.3,10,8,7,1,5,11,22
1820,David Raya,es,GK,,Arsenal,Premier League,29,1995,16.0,0,0,0,0,0,0,1,0.0,1,0,0,0,1,1,8
1821,Abderrahman Rebbach,dz,FW,MF,Alavés,La Liga,26,1998,4.3,3,2,3,0,0,0,6,0.0,6,4,0,4,0,3,6
1822,Ante Rebić,hr,FW,MF,Lecce,Serie A,31,1993,5.1,7,5,4,2,1,2,7,28.6,5,3,1,2,0,7,3
1823,Harrison Reed,eng,MF,,Fulham,Premier League,29,1995,0.7,5,2,2,2,1,0,2,0.0,2,1,0,1,1,6,2
1824,Bobby Reid,jm,FW,MF,Leicester City,Premier League,31,1993,2.7,3,2,0,3,0,2,6,33.3,4,4,1,3,0,3,4
1825,Tijjani Reijnders,nl,MF,,Milan,Serie A,26,1998,12.1,6,3,1,4,1,2,11,18.2,9,3,0,3,11,17,10
1826,Pepe Reina,es,GK,,Como,Serie A,42,1982,8.0,0,0,0,0,0,0,1,0.0,1,0,0,0,0,0,3
1827,Rocco Reitz,de,MF,,Gladbach,Bundesliga,22,2002,9.9,31,14,12,17,2,13,21,61.9,8,13,6,7,33,64,19
1828,Nicolai Remberg,de,MF,,Holstein Kiel,Bundesliga,24,2000,9.2,18,11,7,10,1,7,12,58.3,5,15,3,12,6,24,21
1829,Álex Remiro,es,GK,,Real Sociedad,La Liga,29,1995,17.0,0,0,0,0,0,0,1,0.0,1,0,0,0,0,0,7
1830,Guillaume Restes,fr,GK,,Toulouse,Ligue 1,19,2005,14.8,0,0,0,0,0,0,0,,0,0,0,0,0,0,10
1831,Mateo Retegui,it,FW,,Atalanta,Serie A,25,1999,10.4,8,4,0,4,4,2,6,33.3,4,1,0,1,1,9,6
1832,Elvis Rexhbeçaj,xk,MF,,Augsburg,Bundesliga,27,1997,10.9,14,10,5,7,2,9,25,36.0,16,23,4,19,11,25,12
1833,Gio Reyna,us,MF,,Dortmund,Bundesliga,22,2002,1.2,2,0,1,0,1,1,1,100.0,0,2,0,2,0,2,5
1834,Chadi Riad,ma,DF,,Crystal Palace,Premier League,21,2003,1.0,5,2,2,2,1,2,3,66.7,1,0,0,0,2,7,0
1835,Alexsandro Ribeiro,br,DF,,Lille,Ligue 1,25,1999,13.0,14,10,6,7,1,11,17,64.7,6,7,3,4,16,30,61
1836,Samuele Ricci,it,MF,,Torino,Serie A,23,2001,15.1,19,10,9,6,4,9,12,75.0,3,11,6,5,13,32,23
1837,Declan Rice,eng,MF,,Arsenal,Premier League,25,1999,12.9,22,11,6,13,3,8,14,57.1,6,12,7,5,10,32,19
1838,Chris Richards,us,DF,,Crystal Palace,Premier League,24,2000,3.9,10,5,5,4,1,6,11,54.5,5,7,1,6,3,13,18
1839,Amir Richardson,ma,MF,,Fiorentina,Serie A,22,2002,4.2,13,5,8,5,0,3,8,37.5,5,4,1,3,1,14,11
1840,Richarlison,br,FW,,Tottenham,Premier League,27,1997,1.0,1,1,0,0,1,0,0,,0,0,0,0,0,1,2
1841,Diego Rico,es,DF,,Getafe,La Liga,31,1993,15.0,41,20,23,15,3,21,37,56.8,16,14,1,13,17,58,27
1842,Fabian Rieder,ch,MF,FW,Stuttgart,Bundesliga,22,2002,6.8,10,9,3,4,3,6,20,30.0,14,8,1,7,6,16,3
1843,Luis Rioja,es,FW,,Alavés,La Liga,31,1993,0.3,2,1,0,1,1,1,2,50.0,1,2,0,2,0,2,0
1844,Luis Rioja,es,MF,,Valencia,La Liga,31,1993,12.5,17,10,2,11,4,8,20,40.0,12,13,0,13,11,28,11
1845,Rodrigo Riquelme,es,DF,MF,Atlético Madrid,La Liga,24,2000,4.5,8,3,3,5,0,4,9,44.4,5,2,0,2,1,9,3
1846,Alberto Risco,es,MF,FW,Getafe,La Liga,19,2005,0.8,4,4,2,0,2,1,6,16.7,5,2,0,2,0,4,0
1847,Mihailo Ristić,rs,MF,DF,Celta Vigo,La Liga,29,1995,1.4,3,3,2,1,0,1,2,50.0,1,0,0,0,0,3,4
1848,Lars Ritzka,de,DF,FW,St. Pauli,Bundesliga,26,1998,4.2,28,17,16,9,3,15,24,62.5,9,8,0,8,4,32,15
1849,Gorka Rivera Alonso,es,DF,MF,Getafe,La Liga,20,2004,0.2,2,0,0,2,0,2,2,100.0,0,0,0,0,0,2,0
1850,Sergi Roberto,es,MF,,Como,Serie A,32,1992,6.2,11,7,4,3,4,4,5,80.0,1,4,1,3,9,20,8
1851,Andrew Robertson,sct,DF,,Liverpool,Premier League,30,1994,11.6,18,10,12,3,3,14,24,58.3,10,2,1,1,6,24,17
1852,Antonee Robinson,us,DF,,Fulham,Premier League,27,1997,16.0,50,31,33,16,1,27,48,56.3,21,18,3,15,31,81,58
1853,Marc Roca,es,MF,,Betis,La Liga,28,1996,8.1,14,8,8,6,0,8,15,53.3,7,16,5,11,8,22,9
1854,Rodri,es,MF,,Manchester City,Premier League,28,1996,0.7,2,1,1,1,0,0,0,,0,1,0,1,1,3,0
1855,Rodri,es,FW,,Betis,La Liga,24,2000,1.3,2,1,1,1,0,1,2,50.0,1,2,1,1,1,3,1
1856,Álvaro Rodríguez,uy,FW,,Getafe,La Liga,20,2004,5.1,5,3,0,4,1,2,5,40.0,3,17,0,17,3,8,9
1857,Óscar Rodríguez Arnaiz,es,MF,,Leganés,La Liga,26,1998,6.8,17,7,7,7,3,6,15,40.0,9,4,1,3,9,26,10
1858,Damián Rodríguez,es,MF,,Celta Vigo,La Liga,21,2003,6.9,8,5,2,5,1,2,9,22.2,7,4,1,3,5,13,9
1859,Dani Rodríguez,es,MF,FW,Mallorca,La Liga,36,1988,10.5,21,15,9,8,4,7,9,77.8,2,9,1,8,4,25,13
1860,Guido Rodríguez,ar,MF,,West Ham,Premier League,30,1994,9.1,26,13,17,9,0,11,26,42.3,15,15,7,8,10,36,22
1861,James Rodríguez,co,MF,FW,Rayo Vallecano,La Liga,33,1991,1.6,3,2,1,2,0,0,2,0.0,2,2,0,2,1,4,0
1862,Javi Rodríguez,es,DF,,Celta Vigo,La Liga,21,2003,11.7,22,14,16,6,0,12,20,60.0,8,10,1,9,16,38,40
1863,Jesus Rodríguez,es,FW,,Betis,La Liga,19,2005,1.0,2,2,0,2,0,2,2,100.0,0,0,0,0,1,3,0
1864,Kirian Rodríguez,es,MF,,Las Palmas,La Liga,28,1996,15.0,26,13,11,13,2,18,36,50.0,18,21,4,17,7,33,16
1865,Ricardo Rodríguez,ch,DF,,Betis,La Liga,32,1992,3.7,9,7,6,1,2,5,9,55.6,4,2,0,2,3,12,12
1866,Rodrygo,br,FW,,Real Madrid,La Liga,23,2001,10.1,7,5,5,2,0,4,11,36.4,7,11,1,10,2,9,4
1867,Mads Roerslev,dk,DF,,Brentford,Premier League,25,1999,6.0,7,3,5,2,0,3,10,30.0,7,6,2,4,2,9,17
1868,Morgan Rogers,eng,MF,FW,Aston Villa,Premier League,22,2002,14.6,14,7,2,7,5,7,19,36.8,12,11,2,9,3,17,9
1869,Merlin Röhl,de,MF,FW,Freiburg,Bundesliga,22,2002,2.5,3,3,1,2,0,1,1,100.0,0,2,0,2,1,4,1
1870,Alessio Romagnoli,it,DF,,Lazio,Serie A,29,1995,10.4,18,11,8,10,0,9,11,81.8,2,8,5,3,12,30,26
1871,Leo Román,es,GK,,Mallorca,La Liga,24,2000,5.0,0,0,0,0,0,0,0,,0,0,0,0,0,0,0
1872,Carlos Romero,es,DF,MF,Espanyol,La Liga,23,2001,11.3,30,20,22,7,1,17,33,51.5,16,11,1,10,8,38,30
1873,Cristian Romero,ar,DF,,Tottenham,Premier League,26,1998,10.8,27,23,22,5,0,15,22,68.2,7,13,3,10,13,40,32
1874,Isaac Romero,es,FW,,Sevilla,La Liga,24,2000,11.9,5,2,0,2,3,1,8,12.5,7,11,1,10,1,6,14
1875,Luka Romero,ar,FW,MF,Alavés,La Liga,20,2004,2.2,4,4,1,1,2,2,3,66.7,1,2,0,2,1,5,0
1876,Oriol Romeu,es,MF,,Girona,La Liga,33,1991,8.5,23,13,9,11,3,10,14,71.4,4,12,3,9,3,26,8
1877,Valentin Rongier,fr,MF,DF,Marseille,Ligue 1,30,1994,5.4,17,11,8,8,1,8,13,61.5,5,14,5,9,11,28,14
1878,Marten de Roon,nl,MF,DF,Atalanta,Serie A,33,1991,15.5,35,20,13,21,1,15,30,50.0,15,21,2,19,17,52,28
1879,Vitor Roque,br,FW,,Betis,La Liga,19,2005,10.0,5,3,0,1,4,0,3,0.0,3,3,0,3,5,10,2
1880,Pablo Rosario,nl,MF,DF,Nice,Ligue 1,27,1997,12.8,15,9,4,9,2,6,12,50.0,6,12,7,5,22,37,29
1881,Lasse Rosenboom,de,DF,,Holstein Kiel,Bundesliga,22,2002,4.4,10,7,8,1,1,5,8,62.5,3,7,1,6,8,18,12
1882,Max Rosenfelder,de,DF,,Freiburg,Bundesliga,21,2003,5.8,16,10,11,5,0,9,10,90.0,1,6,2,4,3,19,34
1883,Valentin Rosier,fr,DF,,Leganés,La Liga,28,1996,11.7,36,29,26,9,1,22,35,62.9,13,15,2,13,17,53,60
1884,Tom Rothe,de,DF,MF,Union Berlin,Bundesliga,20,2004,9.3,26,14,19,7,0,15,27,55.6,12,20,3,17,7,33,26
1885,Anthony Rouault,fr,DF,,Stuttgart,Bundesliga,23,2001,8.7,10,8,7,1,2,8,11,72.7,3,14,6,8,13,23,39
1886,Jonas Rouhi,se,DF,,Juventus,Serie A,20,2004,2.1,4,1,1,3,0,0,1,0.0,1,1,0,1,3,7,2
1887,Jérôme Roussillon,fr,DF,,Union Berlin,Bundesliga,31,1993,0.1,0,0,0,0,0,0,0,,0,0,0,0,0,0,1
1888,Nicolò Rovella,it,MF,,Lazio,Serie A,23,2001,11.8,38,25,12,22,4,17,33,51.5,16,8,2,6,18,56,14
1889,Jon Rowe,eng,FW,MF,Marseille,Ligue 1,21,2003,4.3,6,6,0,2,4,4,6,66.7,2,1,1,0,1,7,0
1890,Amir Rrahmani,xk,DF,,Napoli,Serie A,30,1994,16.0,13,10,7,6,0,8,12,66.7,4,15,8,7,5,18,61
1891,Tommaso Rubino,it,MF,,Fiorentina,Serie A,18,2006,0.1,0,0,0,0,0,0,1,0.0,1,0,0,0,0,0,0
1892,Antonio Rüdiger,de,DF,,Real Madrid,La Liga,31,1993,16.1,12,7,7,5,0,8,10,80.0,2,18,11,7,7,19,67
1893,Matteo Ruggeri,it,DF,,Atalanta,Serie A,22,2002,12.3,24,15,9,8,7,15,19,78.9,4,16,1,15,14,38,24
1894,Aitor Ruibal,es,FW,DF,Betis,La Liga,28,1996,6.6,12,8,7,2,3,8,14,57.1,6,9,2,7,8,20,13
1895,Abel Ruiz,es,FW,,Girona,La Liga,24,2000,8.5,3,1,1,1,1,2,5,40.0,3,4,1,3,2,5,3
1896,Ferrán Ruiz,es,MF,,Girona,La Liga,21,2003,0.2,0,0,0,0,0,0,0,,0,2,1,1,1,1,0
1897,Fabián Ruiz Peña,es,MF,,Paris S-G,Ligue 1,28,1996,7.8,17,10,8,6,3,8,21,38.1,13,8,1,7,9,26,9
1898,Gerónimo Rulli,ar,GK,,Marseille,Ligue 1,32,1992,15.0,2,1,2,0,0,2,5,40.0,3,0,0,0,0,2,14
1899,Georginio Rutter,fr,FW,MF,Brighton,Premier League,22,2002,10.3,19,7,8,7,4,7,22,31.8,15,13,2,11,7,26,9
1900,Julian Ryerson,no,DF,,Dortmund,Bundesliga,27,1997,10.5,16,10,12,3,1,14,21,66.7,7,11,1,10,12,28,11
1901,Frederik Rønnow,dk,GK,,Union Berlin,Bundesliga,32,1992,14.0,0,0,0,0,0,0,1,0.0,1,0,0,0,0,0,6
1902,José Sá,pt,GK,,Wolves,Premier League,31,1993,9.0,0,0,0,0,0,0,0,,0,0,0,0,0,0,4
1903,Elias Saad,tn,FW,MF,St. Pauli,Bundesliga,24,1999,3.8,12,7,4,5,3,6,11,54.5,5,6,0,6,1,13,1
1904,Youssouf Sabaly,sn,DF,,Betis,La Liga,31,1993,9.2,20,15,10,8,2,10,15,66.7,5,10,2,8,6,26,24
1905,Emmanuel Sabbi,us,MF,FW,Le Havre,Ligue 1,26,1997,4.9,7,5,3,2,2,3,4,75.0,1,2,0,2,2,9,3
1906,Stefano Sabelli,it,DF,,Genoa,Serie A,31,1993,10.0,29,16,15,11,3,11,30,36.7,19,14,2,12,9,38,28
1907,Marcel Sabitzer,at,MF,FW,Dortmund,Bundesliga,30,1994,9.7,14,9,1,10,3,7,14,50.0,7,8,4,4,2,16,12
1908,Falaye Sacko,ml,DF,,Montpellier,Ligue 1,29,1995,9.4,13,7,9,3,1,8,15,53.3,7,14,5,9,11,24,9
1909,Umar Sadiq,ng,FW,,Real Sociedad,La Liga,27,1997,2.5,2,1,1,1,0,1,2,50.0,1,3,1,2,1,3,2
1910,Alexis Saelemaekers,be,FW,MF,Roma,Serie A,25,1999,2.7,7,2,4,2,1,4,4,100.0,0,3,1,2,1,8,1
1911,Alexis Saelemaekers,be,DF,FW,Milan,Serie A,25,1999,1.0,1,1,0,0,1,1,1,100.0,0,0,0,0,1,2,0
1912,Jorge Sáenz,es,DF,,Leganés,La Liga,28,1996,6.9,16,11,8,7,1,4,8,50.0,4,6,4,2,11,27,55
1913,Matvei Safonov,ru,GK,,Paris S-G,Ligue 1,25,1999,4.0,0,0,0,0,0,0,0,,0,1,0,1,1,1,0
1914,Modibo Sagnan,ml,DF,,Montpellier,Ligue 1,25,1999,12.3,26,14,16,7,3,15,26,57.7,11,12,7,5,17,43,53
1915,Richie Sagrado,be,DF,,Venezia,Serie A,20,2004,1.3,2,2,1,1,0,1,1,100.0,0,1,0,1,1,3,2
1916,Osame Sahraoui,ma,FW,MF,Lille,Ligue 1,23,2001,8.1,5,3,2,2,1,1,4,25.0,3,10,1,9,4,9,5
1917,Wesley Saïd,fr,FW,MF,Lens,Ligue 1,29,1995,4.2,3,2,1,2,0,1,2,50.0,1,0,0,0,0,3,1
1918,Théo Sainte-Luce,fr,MF,,Montpellier,Ligue 1,26,1998,0.2,0,0,0,0,0,0,0,,0,0,0,0,0,0,0
1919,Bukayo Saka,eng,FW,MF,Arsenal,Premier League,23,2001,13.8,22,13,5,10,7,9,19,47.4,10,16,0,16,2,24,7
1920,Faik Sakar,de,MF,,RB Leipzig,Bundesliga,16,2008,0.0,0,0,0,0,0,0,0,,0,0,0,0,0,0,0
1921,Marco Sala,it,DF,,Como,Serie A,25,1999,2.9,9,6,5,3,1,5,8,62.5,3,2,0,2,1,10,9
1922,Ibrahim Salah,ma,FW,,Brest,Ligue 1,23,2001,3.5,3,2,1,1,1,1,5,20.0,4,2,0,2,1,4,0
1923,Mohamed Salah,eg,FW,,Liverpool,Premier League,32,1992,14.6,9,6,3,3,3,3,4,75.0,1,1,0,1,4,13,4
1924,Amine Salama,fr,FW,,Reims,Ligue 1,24,2000,2.7,2,2,0,1,1,0,3,0.0,3,2,1,1,0,2,0
1925,Kike Salas,es,DF,,Sevilla,La Liga,22,2002,8.2,13,9,6,3,4,8,13,61.5,5,11,5,6,11,24,36
1926,Manolis Saliakas,gr,MF,DF,St. Pauli,Bundesliga,28,1996,10.7,19,7,8,8,3,11,18,61.1,7,15,2,13,10,29,24
1927,William Saliba,fr,DF,,Arsenal,Premier League,23,2001,14.3,36,22,24,12,0,15,19,78.9,4,10,5,5,10,46,43
1928,Mohammed Salisu,gh,DF,,Monaco,Ligue 1,25,1999,6.4,20,11,11,9,0,10,10,100.0,0,8,6,2,6,26,31
1929,Roland Sallai,hu,FW,MF,Freiburg,Bundesliga,27,1997,0.5,2,1,1,1,0,0,0,,0,0,0,0,1,3,0
1930,Yoann Salmier,gf,DF,,Le Havre,Ligue 1,32,1992,7.6,11,6,7,3,1,7,8,87.5,1,11,7,4,6,17,49
1931,Lazar Samardzic,rs,MF,FW,Atalanta,Serie A,22,2002,5.4,8,7,1,4,3,3,5,60.0,2,4,1,3,1,9,3
1932,Diadie Samassékou,ml,MF,,Hoffenheim,Bundesliga,28,1996,1.5,4,4,0,2,2,2,4,50.0,2,2,1,1,3,7,1
1933,Mama Samba Baldé,gw,FW,,Lyon,Ligue 1,29,1995,0.4,2,2,0,2,0,0,0,,0,0,0,0,1,3,1
1934,Mama Samba Baldé,gw,FW,,Brest,Ligue 1,29,1995,6.8,5,4,1,1,3,2,7,28.6,5,4,0,4,3,8,6
1935,Brice Samba,fr,GK,,Lens,Ligue 1,30,1994,15.0,0,0,0,0,0,0,0,,0,0,0,0,1,1,6
1936,Albert Sambi Lokonga,be,MF,,Sevilla,La Liga,25,1999,7.5,8,7,6,2,0,4,5,80.0,1,6,1,5,2,10,15
1937,Junior Sambia,fr,FW,MF,Empoli,Serie A,28,1996,0.4,2,2,1,1,0,2,2,100.0,0,0,0,0,0,2,0
1938,Chuky san jose,es,MF,FW,Valladolid,La Liga,20,2004,1.0,1,0,0,0,1,1,1,100.0,0,2,0,2,0,1,0
1939,Antonio Sanabria,py,FW,,Torino,Serie A,28,1996,10.0,2,2,1,0,1,1,4,25.0,3,5,0,5,0,2,9
1940,Oihan Sancet,es,MF,,Athletic Club,La Liga,24,2000,10.7,10,6,6,3,1,4,9,44.4,5,8,0,8,5,15,4
1941,Antonio Sánchez,es,DF,MF,Mallorca,La Liga,27,1997,7.9,14,8,11,2,1,9,14,64.3,5,10,2,8,9,23,19
1942,Iván Sánchez,es,MF,FW,Valladolid,La Liga,32,1992,7.6,16,9,8,4,4,6,15,40.0,9,8,2,6,7,23,3
1943,Javi Sánchez,es,DF,,Valladolid,La Liga,27,1997,9.8,12,9,9,3,0,10,13,76.9,3,16,12,4,8,20,50
1944,Juanlu Sánchez,es,MF,,Sevilla,La Liga,21,2003,6.4,9,7,4,3,2,7,9,77.8,2,2,0,2,7,16,8
1945,Manu Sánchez,es,DF,,Alavés,La Liga,24,2000,11.5,20,15,8,7,5,11,19,57.9,8,20,2,18,12,32,26
1946,Robert Sánchez,es,GK,,Chelsea,Premier League,27,1997,15.0,0,0,0,0,0,0,1,0.0,1,0,0,0,0,0,11
1947,Jadon Sancho,eng,FW,,Chelsea,Premier League,24,2000,6.4,1,1,1,0,0,1,4,25.0,3,1,0,1,0,1,0
1948,Philipp Sander,de,MF,,Gladbach,Bundesliga,26,1998,5.3,15,9,7,7,1,6,9,66.7,3,9,2,7,6,21,14
1949,Leroy Sané,de,FW,,Bayern Munich,Bundesliga,28,1996,5.3,8,5,1,4,3,1,3,33.3,2,2,0,2,1,9,1
1950,Arouna Sangante,sn,DF,,Le Havre,Ligue 1,22,2002,5.8,9,7,4,5,0,5,8,62.5,3,7,4,3,14,23,21
1951,Ibrahim Sangaré,ci,MF,,Nott'ham Forest,Premier League,27,1997,2.4,15,9,5,10,0,4,8,50.0,4,4,0,4,2,17,2
1952,Nhoa Sangui,fr,DF,,Reims,Ligue 1,18,2006,6.4,8,4,1,4,3,3,6,50.0,3,6,2,4,3,11,12
1953,Kaishu Sano,jp,MF,,Mainz 05,Bundesliga,23,2000,13.8,31,21,8,18,5,11,22,50.0,11,33,8,25,27,58,17
1954,Nicola Sansone,it,MF,FW,Lecce,Serie A,33,1991,0.6,0,0,0,0,0,0,0,,0,0,0,0,0,0,0
1955,Baptiste Santamaria,fr,MF,,Rennes,Ligue 1,29,1995,5.4,11,4,7,3,1,6,11,54.5,5,10,4,6,12,23,7
1956,Jesús Santiago,es,MF,,Getafe,La Liga,20,2004,3.2,11,7,5,6,0,4,7,57.1,3,4,1,3,0,11,2
1957,Andrey Santos,br,MF,,Strasbourg,Ligue 1,20,2004,13.7,54,36,26,24,4,25,42,59.5,17,15,4,11,13,67,19
1958,Kauã Santos,br,GK,,Eint Frankfurt,Bundesliga,21,2003,3.5,0,0,0,0,0,0,0,,0,0,0,0,0,0,2
1959,Tiago Santos,pt,DF,,Lille,Ligue 1,22,2002,4.5,12,7,4,5,3,6,9,66.7,3,2,0,2,2,14,4
1960,Pablo Sarabia,es,MF,FW,Wolves,Premier League,32,1992,2.0,5,3,2,2,1,3,5,60.0,2,3,0,3,2,7,2
1961,Jeremy Sarmiento,ec,MF,,Brighton,Premier League,22,2002,0.1,0,0,0,0,0,0,0,,0,0,0,0,0,0,0
1962,Amin Sarr,se,FW,,Hellas Verona,Serie A,23,2001,3.6,7,4,2,2,3,3,4,75.0,1,3,1,2,0,7,4
1963,Ismaila Sarr,sn,MF,FW,Crystal Palace,Premier League,26,1998,10.2,6,4,0,5,1,1,9,11.1,8,11,3,8,5,11,8
1964,Malang Sarr,fr,DF,,Lens,Ligue 1,25,1999,2.3,1,0,1,0,0,0,0,,0,4,1,3,5,6,3
1965,Mamadou Sarr,fr,DF,,Strasbourg,Ligue 1,19,2005,8.5,16,10,8,8,0,9,14,64.3,5,6,5,1,9,25,30
1966,Martin Satriano,uy,FW,DF,Lens,Ligue 1,23,2001,0.5,3,1,1,1,1,3,3,100.0,0,0,0,0,0,3,2
1967,Razvan Sava,ro,GK,,Udinese,Serie A,22,2002,2.0,0,0,0,0,0,0,0,,0,0,0,0,0,0,2
1968,Téji Savanier,fr,MF,,Montpellier,Ligue 1,32,1991,12.3,14,11,4,6,4,11,25,44.0,14,4,0,4,10,24,9
1969,Sávio,br,FW,MF,Manchester City,Premier League,20,2004,7.9,16,10,3,8,5,3,6,50.0,3,4,0,4,1,17,2
1970,Nicolò Savona,it,DF,,Juventus,Serie A,21,2003,9.4,17,9,8,8,1,8,12,66.7,4,2,0,2,6,23,4
1971,Saba Sazonov,ge,DF,,Torino,Serie A,22,2002,0.0,0,0,0,0,0,0,0,,0,1,1,0,0,0,0
1972,Joe Scally,us,DF,,Gladbach,Bundesliga,21,2002,13.0,22,16,15,7,0,13,24,54.2,11,20,8,12,9,31,32
1973,Giorgio Scalvini,it,DF,,Atalanta,Serie A,21,2003,0.1,1,1,1,0,0,1,1,100.0,0,0,0,0,0,1,1
1974,Oliver Scarles,eng,DF,,West Ham,Premier League,19,2005,0.2,1,0,1,0,0,1,1,100.0,0,0,0,0,0,1,0
1975,Kevin Schade,de,FW,MF,Brentford,Premier League,23,2001,7.5,18,14,7,5,6,9,11,81.8,2,6,1,5,1,19,8
1976,András Schäfer,hu,MF,,Union Berlin,Bundesliga,25,1999,6.8,20,9,8,9,3,12,18,66.7,6,14,1,13,10,30,12
1977,Fabian Schär,ch,DF,,Newcastle Utd,Premier League,32,1991,13.3,12,7,4,8,0,3,11,27.3,8,16,10,6,20,32,49
1978,Patrik Schick,cz,FW,,Leverkusen,Bundesliga,28,1996,4.7,2,2,0,1,1,0,0,,0,2,0,2,0,2,3
1979,Stefan Schimmer,de,FW,MF,Heidenheim,Bundesliga,30,1994,1.4,2,0,1,1,0,1,1,100.0,0,1,0,1,0,2,0
1980,Joël Schingtienne,be,DF,,Venezia,Serie A,22,2002,1.0,4,4,3,1,0,1,1,100.0,0,1,0,1,1,5,1
1981,Xaver Schlager,at,MF,,RB Leipzig,Bundesliga,27,1997,1.2,1,0,0,1,0,0,1,0.0,1,4,0,4,0,1,1
1982,Keven Schlotterbeck,de,DF,,Augsburg,Bundesliga,27,1997,11.4,11,10,4,7,0,6,10,60.0,4,11,5,6,10,21,56
1983,Nico Schlotterbeck,de,DF,,Dortmund,Bundesliga,25,1999,12.8,30,19,16,13,1,23,34,67.6,11,20,10,10,16,46,44
1984,Jeffrey Schlupp,gh,MF,DF,Crystal Palace,Premier League,31,1992,1.0,2,0,1,0,1,0,3,0.0,3,5,0,5,0,2,2
1985,Romano Schmid,at,MF,,Werder Bremen,Bundesliga,24,2000,13.8,20,9,4,12,4,11,26,42.3,15,20,1,19,10,30,5
1986,Niklas Schmidt,de,MF,,Toulouse,Ligue 1,26,1998,2.3,6,4,1,5,0,4,7,57.1,3,0,0,0,1,7,4
1987,Jan Schöppner,de,MF,,Heidenheim,Bundesliga,25,1999,13.0,25,12,6,11,8,13,32,40.6,19,18,2,16,21,46,41
1988,Marvin Schulz,de,DF,MF,Holstein Kiel,Bundesliga,29,1995,2.9,5,4,2,2,1,2,8,25.0,6,10,6,4,0,5,10
1989,Léo Scienza,br,FW,MF,Heidenheim,Bundesliga,26,1998,8.2,12,8,7,4,1,4,10,40.0,6,8,1,7,4,16,7
1990,Alex Scott,eng,MF,,Bournemouth,Premier League,21,2003,2.9,16,7,8,4,4,12,16,75.0,4,9,1,8,6,22,5
1991,Simone Scuffet,it,GK,,Cagliari,Serie A,28,1996,11.0,0,0,0,0,0,0,1,0.0,1,0,0,0,0,0,7
1992,Jérémy Sebas,mq,FW,MF,Strasbourg,Ligue 1,21,2003,1.7,3,2,1,1,1,2,3,66.7,1,1,0,1,0,3,2
1993,Aleksandar Sedlar,rs,DF,,Alavés,La Liga,33,1991,4.6,15,9,5,10,0,7,9,77.8,2,2,1,1,7,22,7
1994,Alidu Seidu,gh,DF,,Rennes,Ligue 1,24,2000,8.9,22,18,14,6,2,12,15,80.0,3,13,6,7,14,36,17
1995,Nicolas Seiwald,at,MF,DF,RB Leipzig,Bundesliga,23,2001,6.8,17,11,8,9,0,8,16,50.0,8,7,1,6,13,30,21
1996,Matz Sels,be,GK,,Nott'ham Forest,Premier League,32,1992,16.0,1,1,1,0,0,1,1,100.0,0,0,0,0,0,1,11
1997,Nélson Semedo,pt,DF,,Wolves,Premier League,31,1993,12.7,32,18,23,6,3,16,30,53.3,14,15,6,9,7,39,59
1998,Antoine Semenyo,gh,FW,,Bournemouth,Premier League,24,2000,14.4,23,14,9,10,4,5,16,31.3,11,25,4,21,4,27,13
1999,Marvin Senaya,tg,DF,,Strasbourg,Ligue 1,23,2001,2.2,6,3,3,2,1,5,11,45.5,6,5,2,3,7,13,10
2000,Marcos Senesi,ar,DF,,Bournemouth,Premier League,27,1997,10.2,33,21,21,10,2,13,26,50.0,13,14,6,8,11,44,42
2001,Stefano Sensi,it,MF,,Monza,Serie A,29,1995,0.4,2,2,0,2,0,1,2,50.0,1,0,0,0,0,2,0
2002,Suat Serdar,de,MF,,Hellas Verona,Serie A,27,1997,5.8,11,8,5,6,0,3,10,30.0,7,4,1,3,4,15,5
2003,Sergi,es,DF,,Leganés,La Liga,32,1992,16.5,21,16,11,9,1,10,16,62.5,6,19,13,6,27,48,101
2004,Nicolás Serrano,es,FW,,Athletic Club,La Liga,21,2003,1.1,1,1,0,1,0,1,3,33.3,2,4,0,4,1,2,1
2005,Benjamin Šeško,si,FW,MF,RB Leipzig,Bundesliga,21,2003,10.5,5,2,0,3,2,1,6,16.7,5,5,3,2,4,9,8
2006,Ryan Sessegnon,eng,MF,,Fulham,Premier League,24,2000,0.1,0,0,0,0,0,0,1,0.0,1,0,0,0,1,1,1
2007,Stephan El Shaarawy,it,DF,MF,Roma,Serie A,32,1992,6.3,8,6,2,2,4,2,4,50.0,2,2,0,2,4,12,5
2008,Luke Shaw,eng,DF,,Manchester Utd,Premier League,29,1995,0.8,2,2,1,1,0,1,1,100.0,0,1,0,1,1,3,1
2009,Alen Sherri,al,GK,,Cagliari,Serie A,27,1997,5.0,0,0,0,0,0,0,1,0.0,1,0,0,0,0,0,1
2010,Eldor Shomurodov,uz,FW,MF,Roma,Serie A,29,1995,1.3,1,0,0,1,0,0,1,0.0,1,2,0,2,0,1,0
2011,Djibril Sidibé,fr,DF,,Toulouse,Ligue 1,32,1992,11.1,35,19,17,13,5,17,28,60.7,11,6,1,5,14,49,27
2012,Armindo Sieb,de,MF,FW,Mainz 05,Bundesliga,21,2003,4.9,5,2,2,2,1,2,5,40.0,3,2,0,2,1,6,4
2013,Vincent Sierro,ch,MF,,Toulouse,Ligue 1,29,1995,13.7,26,17,9,15,2,16,33,48.5,17,21,3,18,11,37,26
2014,Tim Siersleben,de,DF,,Heidenheim,Bundesliga,24,2000,1.6,2,2,2,0,0,1,1,100.0,0,3,1,2,1,3,9
2015,Kiliann Sildillia,fr,MF,DF,Freiburg,Bundesliga,22,2002,0.6,1,0,0,0,1,0,0,,0,1,0,1,0,1,5
2016,André Silva,pt,FW,MF,RB Leipzig,Bundesliga,29,1995,1.2,1,1,1,0,0,0,1,0.0,1,0,0,0,1,2,2
2017,Bernardo Silva,pt,MF,FW,Manchester City,Premier League,30,1994,14.3,16,11,3,8,5,7,23,30.4,16,15,2,13,11,27,11
2018,Caio Henrique Oliveira Silva,br,DF,,Monaco,Ligue 1,27,1997,7.6,14,11,7,6,1,7,13,53.8,6,8,1,7,4,18,17
2019,Fábio Silva,pt,FW,MF,Las Palmas,La Liga,22,2002,9.8,5,1,1,2,2,1,7,14.3,6,8,0,8,3,8,14
2020,Jota Silva,pt,FW,MF,Nott'ham Forest,Premier League,25,1999,5.6,11,5,5,5,1,2,13,15.4,11,4,0,4,10,21,8
2021,Eric da Silva Moreira,de,MF,DF,Nott'ham Forest,Premier League,18,2006,0.3,2,2,2,0,0,2,6,33.3,4,0,0,0,1,3,0
2022,Rui Silva,pt,GK,,Betis,La Liga,30,1994,15.0,0,0,0,0,0,0,1,0.0,1,1,0,1,0,0,7
2023,Abdallah Sima,sn,FW,,Brest,Ligue 1,23,2001,4.6,3,3,0,2,1,2,4,50.0,2,1,0,1,1,4,3
2024,Mohamed Simakan,fr,DF,,RB Leipzig,Bundesliga,24,2000,0.6,0,0,0,0,0,0,0,,0,0,0,0,2,2,0
2025,Giovanni Simeone,ar,FW,,Napoli,Serie A,29,1995,2.7,0,0,0,0,0,0,3,0.0,3,3,0,3,1,1,2
2026,Giuliano Simeone,ar,MF,DF,Atlético Madrid,La Liga,22,2002,6.2,8,4,1,3,4,5,7,71.4,2,10,1,9,4,12,4
2027,Moses Simon,ng,FW,,Nantes,Ligue 1,29,1995,13.1,9,7,2,4,3,5,12,41.7,7,5,0,5,9,18,4
2028,Unai Simón,es,GK,,Athletic Club,La Liga,27,1997,1.0,0,0,0,0,0,0,0,,0,0,0,0,0,0,0
2029,Xavi Simons,nl,MF,,RB Leipzig,Bundesliga,21,2003,6.8,8,7,2,5,1,3,5,60.0,2,3,1,2,2,10,6
2030,Jahmai Simpson-Pusey,eng,DF,,Manchester City,Premier League,19,2005,1.0,1,0,1,0,0,0,0,,0,1,1,0,0,1,2
2031,Danel Sinani,lu,FW,MF,St. Pauli,Bundesliga,27,1997,2.5,5,4,0,2,3,1,3,33.3,2,3,0,3,1,6,4
2032,Lassine Sinayoko,ml,FW,MF,Auxerre,Ligue 1,25,1999,11.6,15,8,6,4,5,7,12,58.3,5,9,1,8,9,24,24
2033,Wilfried Singo,ci,DF,,Monaco,Ligue 1,23,2000,11.2,18,12,10,7,1,8,11,72.7,3,4,2,2,25,43,46
2034,Luis Sinisterra,co,FW,MF,Bournemouth,Premier League,25,1999,2.3,5,1,1,2,2,0,4,0.0,4,3,0,3,0,5,5
2035,Daley Sinkgraven,nl,DF,,Las Palmas,La Liga,29,1995,1.0,5,1,3,2,0,1,3,33.3,2,1,0,1,1,6,2
2036,Jailson Siqueira,br,DF,MF,Celta Vigo,La Liga,29,1995,5.0,7,7,5,2,0,5,6,83.3,1,5,3,2,8,15,18
2037,Ibrahim Sissoko,ml,FW,,Saint-Étienne,Ligue 1,29,1995,8.9,11,9,5,3,3,2,5,40.0,3,9,1,8,2,13,13
2038,Ibrahima Sissoko,ml,MF,,Bochum,Bundesliga,27,1997,12.0,30,21,16,13,1,10,20,50.0,10,14,3,11,15,45,22
2039,Niama Sissoko,ml,FW,,Reims,Ligue 1,19,2005,0.2,0,0,0,0,0,0,0,,0,0,0,0,0,0,0
2040,Antonio Sivera,es,GK,,Alavés,La Liga,28,1996,17.0,1,0,1,0,0,1,1,100.0,0,0,0,0,0,1,9
2041,Tim Skarke,de,FW,MF,Union Berlin,Bundesliga,28,1996,5.0,3,3,1,2,0,3,6,50.0,3,2,0,2,1,4,4
2042,Ellyes Skhiri,tn,MF,,Eint Frankfurt,Bundesliga,29,1995,9.5,10,6,4,5,1,4,13,30.8,9,19,4,15,9,19,15
2043,Oliver Skipp,eng,MF,,Leicester City,Premier League,24,2000,7.1,7,2,2,4,1,6,9,66.7,3,9,3,6,8,15,8
2044,Leo Skiri Østigård,no,DF,,Rennes,Ligue 1,25,1999,9.9,15,13,12,3,0,12,19,63.2,7,7,7,0,7,22,65
2045,Łukasz Skorupski,pl,GK,,Bologna,Serie A,33,1991,10.0,0,0,0,0,0,0,0,,0,0,0,0,0,0,3
2046,Robert Skov,dk,DF,MF,Union Berlin,Bundesliga,28,1996,3.7,10,7,7,3,0,7,10,70.0,3,4,0,4,4,14,4
2047,Milan Škriniar,sk,DF,,Paris S-G,Ligue 1,29,1995,4.2,7,5,3,4,0,3,3,100.0,0,7,6,1,3,10,16
2048,Steven Skrzybski,de,FW,MF,Holstein Kiel,Bundesliga,32,1992,6.0,9,1,1,4,4,4,9,44.4,5,9,0,9,5,14,2
2049,Naatan Skyttä,fi,FW,,Toulouse,Ligue 1,22,2002,0.1,1,0,0,0,1,0,0,,0,0,0,0,0,1,0
2050,William Smallbone,ie,MF,,Southampton,Premier League,24,2000,2.7,7,3,3,3,1,3,5,60.0,2,3,0,3,0,7,2
2051,Adam Smith,eng,DF,,Bournemouth,Premier League,33,1991,11.0,16,8,8,4,4,9,17,52.9,8,8,2,6,11,27,36
2052,Eric Smith,se,DF,,St. Pauli,Bundesliga,27,1997,13.4,18,12,13,5,0,10,14,71.4,4,20,7,13,22,40,46
2053,Justin Smith,ca,MF,,Espanyol,La Liga,21,2003,1.5,4,1,1,3,0,2,3,66.7,1,3,1,2,3,7,0
2054,Emile Smith Rowe,eng,MF,,Fulham,Premier League,24,2000,12.1,21,13,6,6,9,6,17,35.3,11,10,1,9,7,28,7
2055,Eduard Sobol,ua,DF,,Strasbourg,Ligue 1,29,1995,0.4,0,0,0,0,0,0,0,,0,1,0,1,0,0,2
2056,Simon Sohm,ch,MF,,Parma,Serie A,23,2001,13.8,13,7,4,6,3,9,17,52.9,8,5,1,4,11,24,22
2057,Alex Sola,es,MF,FW,Getafe,La Liga,25,1999,10.8,20,13,9,11,0,9,25,36.0,16,8,0,8,5,25,9
2058,Dominic Solanke,eng,FW,,Tottenham,Premier League,27,1997,12.8,11,7,1,8,2,2,6,33.3,4,7,2,5,0,11,14
2059,Ola Solbakken,no,MF,FW,Empoli,Serie A,26,1998,6.6,5,3,0,5,0,2,4,50.0,2,0,0,0,2,7,8
2060,Carlos Soler,es,MF,,West Ham,Premier League,27,1997,6.7,6,6,3,3,0,2,13,15.4,11,11,3,8,2,8,6
2061,Jhon Solis,co,MF,,Girona,La Liga,20,2004,3.6,4,4,2,2,0,3,9,33.3,6,10,1,9,3,7,4
2062,Yann Sommer,ch,GK,,Inter,Serie A,36,1988,15.0,0,0,0,0,0,0,0,,0,0,0,0,0,0,4
2063,David Soria,es,GK,,Getafe,La Liga,31,1993,17.0,4,4,4,0,0,4,5,80.0,1,0,0,0,0,4,7
2064,Juan Soriano,es,GK,,Leganés,La Liga,27,1997,6.0,1,1,1,0,0,1,1,100.0,0,0,0,0,0,1,2
2065,Borna Sosa,hr,DF,,Torino,Serie A,26,1998,5.1,6,5,3,3,0,4,8,50.0,4,3,0,3,5,11,12
2066,Ramón Sosa,py,FW,MF,Nott'ham Forest,Premier League,25,1999,1.7,3,2,2,0,1,1,2,50.0,1,3,0,3,2,5,2
2067,Hugo Sotelo,es,MF,,Celta Vigo,La Liga,20,2003,6.8,14,10,5,4,5,4,11,36.4,7,6,0,6,2,16,4
2068,Florian Sotoca,fr,FW,MF,Lens,Ligue 1,34,1990,8.2,9,7,2,1,6,6,9,66.7,3,8,1,7,2,11,13
2069,Riccardo Sottil,it,FW,MF,Fiorentina,Serie A,25,1999,5.4,2,1,1,1,0,1,2,50.0,1,1,0,1,3,5,3
2070,Tomáš Souček,cz,MF,,West Ham,Premier League,29,1995,11.9,17,10,5,10,2,9,17,52.9,8,13,6,7,11,28,38
2071,Matìas Soulé,ar,MF,FW,Roma,Serie A,21,2003,6.0,4,3,0,2,2,1,6,16.7,5,8,1,7,3,7,5
2072,Boubakary Soumaré,fr,MF,,Leicester City,Premier League,25,1999,5.3,12,4,8,3,1,6,10,60.0,4,5,2,3,3,15,5
2073,Issa Soumaré,sn,FW,MF,Le Havre,Ligue 1,24,2000,6.9,4,2,0,2,2,2,8,25.0,6,5,1,4,3,7,7
2074,Djibril Sow,ch,MF,,Sevilla,La Liga,27,1997,8.3,5,3,2,3,0,0,3,0.0,3,4,1,3,6,11,5
2075,Saidou Sow,gn,DF,,Strasbourg,Ligue 1,22,2002,11.3,9,5,6,3,0,6,12,50.0,6,15,9,6,15,24,37
2076,Djed Spence,eng,DF,,Tottenham,Premier League,24,2000,1.6,5,5,3,2,0,3,3,100.0,0,0,0,0,3,8,6
2077,Leonardo Spinazzola,it,DF,,Napoli,Serie A,31,1993,2.9,3,3,0,2,1,1,2,50.0,1,4,1,3,0,3,6
2078,Anton Stach,de,DF,MF,Hoffenheim,Bundesliga,26,1998,13.2,35,25,15,19,1,18,25,72.0,7,16,7,9,20,55,52
2079,Jens Stage,dk,MF,,Werder Bremen,Bundesliga,28,1996,8.4,9,6,5,4,0,4,12,33.3,8,17,4,13,9,18,16
2080,Filip Stankovic,rs,GK,,Venezia,Serie A,22,2002,9.0,0,0,0,0,0,0,0,,0,0,0,0,0,0,7
2081,Jay Stansfield,eng,MF,,Fulham,Premier League,22,2002,0.0,0,0,0,0,0,0,0,,0,0,0,0,0,0,0
2082,Carl Starfelt,se,DF,,Celta Vigo,La Liga,29,1995,14.2,19,10,12,6,1,8,12,66.7,4,18,13,5,20,39,72
2083,Niklas Stark,de,DF,,Werder Bremen,Bundesliga,29,1995,8.1,12,8,7,4,1,4,6,66.7,2,17,12,5,10,22,45
2084,Lucas Stassin,be,FW,,Saint-Étienne,Ligue 1,20,2004,5.9,5,3,1,2,2,3,5,60.0,2,4,0,4,0,5,3
2085,Jason Steele,eng,GK,,Brighton,Premier League,34,1990,2.0,0,0,0,0,0,0,0,,0,0,0,0,0,0,1
2086,Orri Steinn Óskarsson,is,FW,,Real Sociedad,La Liga,20,2004,3.7,4,4,1,1,2,1,6,16.7,5,6,0,6,0,4,4
2087,Pascal Stenzel,de,DF,,Stuttgart,Bundesliga,28,1996,1.3,1,0,1,0,0,0,1,0.0,1,3,1,2,0,1,4
2088,Jack Stephens,eng,DF,,Southampton,Premier League,30,1994,8.8,15,10,12,3,0,6,16,37.5,10,8,6,2,5,20,32
2089,Leonidas Stergiou,ch,DF,,Stuttgart,Bundesliga,22,2002,2.3,9,6,4,5,0,8,8,100.0,0,3,0,3,2,11,6
2090,Raheem Sterling,eng,MF,FW,Arsenal,Premier League,30,1994,1.6,1,1,0,1,0,1,3,33.3,2,1,0,1,0,1,0
2091,Enzo Sternal,fr,FW,MF,Marseille,Ligue 1,17,2007,0.3,0,0,0,0,0,0,0,,0,0,0,0,0,0,0
2092,Ross Stewart,sct,FW,MF,Southampton,Premier League,28,1996,1.5,0,0,0,0,0,0,3,0.0,3,3,0,3,0,0,4
2093,Angelo Stiller,de,MF,,Stuttgart,Bundesliga,23,2001,13.3,23,11,11,11,1,8,14,57.1,6,9,4,5,8,31,23
2094,Kevin Stöger,at,MF,FW,Gladbach,Bundesliga,31,1993,7.7,15,8,10,3,2,8,20,40.0,12,13,1,12,6,21,13
2095,Stoichkov,es,MF,FW,Alavés,La Liga,31,1993,6.9,14,9,6,7,1,6,11,54.5,5,2,0,2,1,15,5
2096,Petar Stojanović,si,MF,,Empoli,Serie A,29,1995,0.0,0,0,0,0,0,0,0,,0,0,0,0,0,0,0
2097,John Stones,eng,DF,MF,Manchester City,Premier League,30,1994,3.2,5,2,2,2,1,4,4,100.0,0,2,0,2,3,8,9
2098,Jørgen Strand Larsen,no,FW,,Wolves,Premier League,24,2000,14.6,4,4,1,2,1,1,18,5.6,17,13,3,10,3,7,15
2099,Gabriel Strefezza,br,FW,MF,Como,Serie A,27,1997,13.4,29,21,11,10,8,12,27,44.4,15,11,2,9,4,33,12
2100,Cristhian Stuani,uy,FW,,Girona,La Liga,38,1986,2.9,2,2,0,2,0,1,2,50.0,1,1,0,1,2,4,2
2101,Álex Suárez,es,DF,,Las Palmas,La Liga,31,1993,12.9,18,9,14,3,1,10,13,76.9,3,19,12,7,4,22,58
2102,Denis Suárez,es,MF,FW,Villarreal,La Liga,30,1994,1.5,1,1,1,0,0,1,2,50.0,1,1,1,0,0,1,1
2103,Gabriel Suazo,cl,DF,,Toulouse,Ligue 1,27,1997,8.2,25,16,11,6,8,14,28,50.0,14,12,1,11,14,39,8
2104,Luka Sučić,hr,MF,,Real Sociedad,La Liga,22,2002,10.8,16,11,4,10,2,6,13,46.2,7,17,2,15,8,24,7
2105,Yukinari Sugawara,jp,DF,,Southampton,Premier League,24,2000,8.8,20,12,11,8,1,11,17,64.7,6,11,5,6,6,26,25
2106,Niklas Süle,de,DF,,Dortmund,Bundesliga,29,1995,5.4,5,4,4,1,0,4,5,80.0,1,3,3,0,1,6,26
2107,Ibrahim Sulemana,gh,MF,,Atalanta,Serie A,21,2003,0.3,2,1,1,1,0,1,1,100.0,0,0,0,0,0,2,0
2108,Kamaldeen Sulemana,gh,FW,MF,Southampton,Premier League,22,2002,0.7,4,4,2,1,1,3,4,75.0,1,1,0,1,2,6,1
2109,Crysencio Summerville,nl,FW,MF,West Ham,Premier League,23,2001,6.7,11,6,2,6,3,3,7,42.9,4,10,4,6,0,11,6
2110,Tomáš Suslov,sk,FW,MF,Hellas Verona,Serie A,22,2002,8.9,22,15,6,11,5,9,21,42.9,12,16,1,15,3,25,6
2111,Suso,es,FW,MF,Sevilla,La Liga,31,1993,1.6,1,0,1,0,0,1,4,25.0,3,0,0,0,0,1,0
2112,Zion Suzuki,jp,GK,,Parma,Serie A,22,2002,14.8,1,0,1,0,0,1,1,100.0,0,0,0,0,0,1,12
2113,Mattias Svanberg,se,MF,,Wolfsburg,Bundesliga,25,1999,4.7,8,4,1,5,2,2,5,40.0,3,2,0,2,4,12,5
2114,Marin Šverko,hr,DF,,Venezia,Serie A,26,1998,7.6,9,4,6,3,0,5,5,100.0,0,6,3,3,11,20,23
2115,Mile Svilar,rs,GK,,Roma,Serie A,25,1999,16.0,0,0,0,0,0,0,0,,0,0,0,0,0,0,4
2116,Michael Svoboda,at,DF,,Venezia,Serie A,26,1998,14.6,26,14,19,6,1,8,19,42.1,11,19,11,8,22,48,66
2117,Williot Swedberg,se,FW,MF,Celta Vigo,La Liga,20,2004,7.4,8,7,3,4,1,6,8,75.0,2,8,1,7,1,9,4
2118,Abakar Sylla,ci,DF,,Strasbourg,Ligue 1,21,2002,7.2,19,10,10,7,2,11,12,91.7,1,12,7,5,7,26,29
2119,Issiaga Sylla,gn,DF,MF,Montpellier,Ligue 1,30,1994,7.6,19,6,14,5,0,11,21,52.4,10,8,3,5,7,26,22
2120,Mamadou Sylla,sn,FW,MF,Valladolid,La Liga,30,1994,8.4,2,0,0,0,2,1,2,50.0,1,3,0,3,1,3,8
2121,Sammie Szmodics,ie,FW,,Ipswich Town,Premier League,29,1995,8.3,12,8,2,8,2,5,12,41.7,7,8,1,7,4,16,9
2122,Dominik Szoboszlai,hu,MF,,Liverpool,Premier League,24,2000,11.4,13,8,5,4,4,7,16,43.8,9,18,2,16,6,19,6
2123,Alexander Sørloth,no,FW,,Atlético Madrid,La Liga,29,1995,8.5,4,1,0,2,2,1,2,50.0,1,4,1,3,0,4,13
2124,Musa Al-Taamari,jo,FW,,Montpellier,Ligue 1,27,1997,7.4,12,8,4,4,4,7,13,53.8,6,1,0,1,3,15,1
2125,Haris Tabakovic,ba,FW,,Hoffenheim,Bundesliga,30,1994,3.2,1,1,0,0,1,0,1,0.0,1,2,1,1,0,1,7
2126,Nicolás Tagliafico,ar,DF,,Lyon,Ligue 1,32,1992,7.9,27,17,9,11,7,15,20,75.0,5,11,4,7,17,44,21
2127,Jonathan Tah,de,DF,,Leverkusen,Bundesliga,28,1996,14.0,6,5,4,1,1,3,5,60.0,2,12,7,5,15,21,47
2128,Adrien Tameze,cm,MF,DF,Torino,Serie A,30,1994,3.6,2,1,0,2,0,0,6,0.0,6,3,3,0,10,12,3
2129,Renato Tapia,pe,MF,DF,Leganés,La Liga,29,1995,10.3,27,15,12,13,2,6,20,30.0,14,26,13,13,11,38,37
2130,Edmond Tapsoba,bf,DF,,Leverkusen,Bundesliga,25,1999,13.9,25,17,13,10,2,12,24,50.0,12,7,5,2,12,37,41
2131,Florian Tardieu,fr,MF,,Saint-Étienne,Ligue 1,32,1992,1.9,1,1,1,0,0,0,2,0.0,2,3,1,2,3,4,2
2132,Mehdi Taremi,ir,FW,,Inter,Serie A,32,1992,2.7,2,1,0,1,1,0,0,,0,5,0,5,0,2,3
2133,Oussama Targhalline,ma,MF,,Le Havre,Ligue 1,22,2002,9.3,17,13,11,2,4,4,11,36.4,7,12,6,6,14,31,7
2134,James Tarkowski,eng,DF,,Everton,Premier League,32,1992,14.9,34,21,18,14,2,16,26,61.5,10,26,21,5,13,47,91
2135,César Tárrega,es,DF,,Valencia,La Liga,22,2002,13.0,17,13,10,6,1,5,11,45.5,6,11,5,6,8,25,62
2136,Nuno Tavares,pt,DF,,Lazio,Serie A,24,2000,10.1,18,15,8,6,4,8,18,44.4,10,6,1,5,10,28,28
2137,Marcus Tavernier,eng,FW,MF,Bournemouth,Premier League,25,1999,12.7,31,18,9,13,9,7,19,36.8,12,8,0,8,3,34,8
2138,Charlie Taylor,eng,DF,,Southampton,Premier League,31,1993,2.5,7,5,4,3,0,5,6,83.3,1,5,3,2,3,10,21
2139,Jack Taylor,ie,MF,,Ipswich Town,Premier League,26,1998,3.4,5,1,2,3,0,3,8,37.5,5,3,1,2,3,8,12
2140,Loum Tchaouna,fr,FW,MF,Lazio,Serie A,21,2003,2.8,5,3,1,1,3,3,6,50.0,3,1,0,1,3,8,1
2141,Jackson Tchatchoua,cm,DF,MF,Hellas Verona,Serie A,23,2001,14.4,26,13,18,5,3,19,25,76.0,6,13,6,7,7,33,32
2142,Enzo Tchato,cm,DF,,Montpellier,Ligue 1,22,2002,10.8,21,12,13,7,1,12,24,50.0,12,18,5,13,14,35,29
2143,Aurélien Tchouaméni,fr,MF,DF,Real Madrid,La Liga,24,2000,12.2,24,11,11,12,1,9,19,47.4,10,11,9,2,24,48,17
2144,Álvaro Tejero,es,MF,DF,Espanyol,La Liga,28,1996,8.8,7,3,3,3,1,3,13,23.1,10,7,0,7,7,14,20
2145,Martín Tejón,es,MF,DF,Valencia,La Liga,20,2004,0.5,2,0,0,2,0,1,2,50.0,1,0,0,0,0,2,0
2146,Mathys Tel,fr,FW,MF,Bayern Munich,Bundesliga,19,2005,2.2,2,2,0,2,0,0,0,,0,0,0,0,1,3,1
2147,Nathan Tella,ng,MF,FW,Leverkusen,Bundesliga,25,1999,4.0,3,2,1,2,0,2,5,40.0,3,4,0,4,2,5,1
2148,Nahuel Tenaglia,ar,DF,,Alavés,La Liga,28,1996,14.3,39,25,28,8,3,21,33,63.6,12,9,2,7,14,53,44
2149,Casper Tengstedt,dk,FW,MF,Hellas Verona,Serie A,24,2000,10.8,5,3,0,3,2,2,4,50.0,2,4,1,3,3,8,20
2150,Marc-André ter Stegen,de,GK,,Barcelona,La Liga,32,1992,5.5,0,0,0,0,0,0,1,0.0,1,0,0,0,0,0,2
2151,Filippo Terracciano,it,DF,,Milan,Serie A,21,2003,4.0,6,3,1,3,2,3,6,50.0,3,0,0,0,2,8,4
2152,Pietro Terracciano,it,GK,,Fiorentina,Serie A,34,1990,3.0,0,0,0,0,0,0,0,,0,0,0,0,0,0,0
2153,Ramón Terrats,es,MF,FW,Villarreal,La Liga,24,2000,1.4,3,3,1,2,0,2,4,50.0,2,3,1,2,2,5,3
2154,Martin Terrier,fr,MF,FW,Leverkusen,Bundesliga,27,1997,5.9,2,1,0,0,2,1,4,25.0,3,3,0,3,1,3,1
2155,Tanner Tessmann,us,MF,,Lyon,Ligue 1,23,2001,2.5,7,4,4,2,1,3,5,60.0,2,2,2,0,6,13,9
2156,Kenny Tete,nl,DF,,Fulham,Premier League,29,1995,14.0,41,27,20,12,9,17,28,60.7,11,19,6,13,28,69,36
2157,Teddy Teuma,mt,MF,,Reims,Ligue 1,31,1993,3.2,7,4,1,4,2,4,11,36.4,7,6,1,5,5,12,4
2158,Jordan Teze,nl,DF,,Monaco,Ligue 1,25,1999,3.4,10,5,6,3,1,3,9,33.3,6,9,1,8,2,12,4
2159,Florian Thauvin,fr,FW,MF,Udinese,Serie A,31,1993,10.2,11,9,6,4,1,6,14,42.9,8,5,0,5,5,16,5
2160,Arthur Theate,be,DF,,Eint Frankfurt,Bundesliga,24,2000,12.6,18,11,7,10,1,8,19,42.1,11,21,9,12,17,35,57
2161,Thiago,br,FW,,Brentford,Premier League,23,2001,1.5,2,2,1,0,1,0,1,0.0,1,0,0,0,2,4,2
2162,Malick Thiaw,de,DF,,Milan,Serie A,23,2001,9.0,10,8,5,4,1,2,4,50.0,2,6,4,2,8,18,29
2163,Denis Thomalla,de,MF,,Heidenheim,Bundesliga,32,1992,0.0,0,0,0,0,0,0,0,,0,0,0,0,0,0,0
2164,Luke Thomas,eng,DF,,Leicester City,Premier League,23,2001,1.0,2,2,2,0,0,1,2,50.0,1,3,0,3,0,2,0
2165,Sorba Thomas,wls,FW,,Nantes,Ligue 1,25,1999,7.2,8,4,3,4,1,5,9,55.6,4,8,0,8,2,10,10
2166,Adrien Thomasson,fr,MF,,Lens,Ligue 1,31,1993,13.4,48,27,21,16,11,29,51,56.9,22,20,1,19,11,59,20
2167,Morten Thorsby,no,MF,,Genoa,Serie A,28,1996,10.7,23,17,10,8,5,7,14,50.0,7,11,1,10,3,26,13
2168,Khéphren Thuram,fr,MF,,Juventus,Serie A,23,2001,8.6,14,6,4,10,0,8,11,72.7,3,6,2,4,4,18,18
2169,Marcus Thuram,fr,FW,,Inter,Serie A,27,1997,13.2,11,7,3,3,5,2,8,25.0,6,11,3,8,1,12,7
2170,Youri Tielemans,be,MF,,Aston Villa,Premier League,27,1997,15.3,35,23,13,19,3,18,31,58.1,13,12,6,6,14,49,16
2171,Phillip Tietz,de,FW,,Augsburg,Bundesliga,27,1997,10.0,10,5,2,6,2,5,8,62.5,3,5,1,4,3,13,13
2172,Jurriën Timber,nl,DF,,Arsenal,Premier League,23,2001,12.6,21,11,6,11,4,6,13,46.2,7,10,4,6,4,25,22
2173,Jean-Clair Todibo,fr,DF,,West Ham,Premier League,24,1999,7.2,15,10,12,3,0,9,10,90.0,1,13,6,7,8,23,37
2174,Harry Toffolo,eng,DF,,Nott'ham Forest,Premier League,29,1995,0.4,2,0,1,0,1,0,0,,0,0,0,0,0,2,3
2175,Umut Tohumcu,de,MF,,Hoffenheim,Bundesliga,20,2004,3.2,9,5,3,5,1,5,7,71.4,2,2,0,2,3,12,6
2176,Corentin Tolisso,fr,MF,,Lyon,Ligue 1,30,1994,10.6,24,11,12,8,4,9,23,39.1,14,18,5,13,9,33,16
2177,Rafael Tolói,it,DF,,Atalanta,Serie A,34,1990,1.3,4,1,2,2,0,2,4,50.0,2,1,0,1,2,6,1
2178,Tiago Tomás,pt,FW,MF,Wolfsburg,Bundesliga,22,2002,10.9,12,8,5,3,4,6,17,35.3,11,7,1,6,6,18,6
2179,Takehiro Tomiyasu,jp,DF,,Arsenal,Premier League,26,1998,0.1,0,0,0,0,0,0,0,,0,0,0,0,0,0,1
2180,Fikayo Tomori,eng,DF,,Milan,Serie A,26,1997,6.1,8,7,5,2,1,3,6,50.0,3,7,5,2,7,15,18
2181,Sandro Tonali,it,MF,,Newcastle Utd,Premier League,24,2000,8.2,16,11,6,10,0,6,12,50.0,6,12,5,7,15,31,10
2182,Pablo Torre,es,MF,FW,Barcelona,La Liga,21,2003,2.8,5,4,1,3,1,2,2,100.0,0,0,0,0,1,6,4
2183,David Torres,es,DF,,Valladolid,La Liga,21,2003,7.7,4,3,4,0,0,1,3,33.3,2,10,9,1,2,6,33
2184,Ferrán Torres,es,FW,MF,Barcelona,La Liga,24,2000,5.4,5,3,1,2,2,1,3,33.3,2,5,0,5,1,6,1
2185,Pau Torres,es,DF,,Aston Villa,Premier League,27,1997,15.0,15,11,8,6,1,8,11,72.7,3,10,6,4,6,21,37
2186,Lucas Torró,es,MF,,Osasuna,La Liga,30,1994,15.5,35,21,11,24,0,17,33,51.5,16,23,4,19,23,58,36
2187,Abdoulaye Touré,gn,MF,,Le Havre,Ligue 1,30,1994,12.9,31,15,17,10,4,18,26,69.2,8,17,10,7,19,50,20
2188,Birama Touré,ml,MF,DF,Montpellier,Ligue 1,32,1992,3.3,8,5,5,2,1,4,6,66.7,2,3,2,1,5,13,7
2189,Ousmane Toure,fr,DF,,Lille,Ligue 1,19,2005,0.1,0,0,0,0,0,0,0,,0,0,0,0,1,1,2
2190,Souleymane Touré,fr,DF,,Udinese,Serie A,21,2003,6.8,5,5,4,1,0,3,4,75.0,1,15,6,9,8,13,12
2191,Lucas Tousart,fr,MF,,Union Berlin,Bundesliga,27,1997,1.4,1,1,0,1,0,0,2,0.0,2,3,1,2,1,2,2
2192,Conor Townsend,eng,MF,,Ipswich Town,Premier League,31,1993,0.0,1,1,1,0,0,0,0,,0,0,0,0,0,1,0
2193,Adama Traoré,es,FW,MF,Fulham,Premier League,28,1996,9.1,9,5,6,2,1,3,8,37.5,5,5,0,5,1,10,4
2194,Hamari Traoré,ml,DF,,Real Sociedad,La Liga,32,1992,3.5,11,7,7,3,1,9,12,75.0,3,1,1,0,3,14,11
2195,Omar Traoré,de,DF,FW,Heidenheim,Bundesliga,26,1998,11.3,18,12,13,5,0,12,14,85.7,2,14,2,12,9,27,25
2196,Kevin Trapp,de,GK,,Eint Frankfurt,Bundesliga,34,1990,10.5,0,0,0,0,0,0,0,,0,0,0,0,0,0,4
2197,Mark Travers,ie,GK,,Bournemouth,Premier League,25,1999,3.0,0,0,0,0,0,0,0,,0,0,0,0,0,0,4
2198,Óscar Trejo,ar,MF,FW,Rayo Vallecano,La Liga,36,1988,1.9,3,3,0,3,0,3,4,75.0,1,1,0,1,1,4,2
2199,Philipp Treu,de,MF,DF,St. Pauli,Bundesliga,24,2000,12.5,24,17,15,5,4,14,28,50.0,14,21,2,19,7,31,22
2200,Ryan Trevitt,eng,MF,,Brentford,Premier League,21,2003,0.0,1,1,1,0,0,0,0,,0,0,0,0,0,1,0
2201,Christopher Trimmel,at,DF,MF,Union Berlin,Bundesliga,37,1987,8.0,19,14,11,7,1,16,25,64.0,9,5,1,4,5,24,27
2202,Kieran Trippier,eng,DF,,Newcastle Utd,Premier League,34,1990,3.6,10,5,4,5,1,6,15,40.0,9,2,1,1,2,12,6
2203,Leandro Trossard,be,FW,,Arsenal,Premier League,30,1994,9.4,13,10,2,8,3,7,17,41.2,10,11,0,11,6,19,8
2204,Adrien Truffert,fr,DF,MF,Rennes,Ligue 1,23,2001,11.6,25,11,12,8,5,16,22,72.7,6,16,2,14,8,33,22
2205,Kostas Tsimikas,gr,DF,,Liverpool,Premier League,28,1996,2.6,12,7,8,2,2,6,8,75.0,2,3,1,2,3,15,6
2206,Viktor Tsyhankov,ua,FW,MF,Girona,La Liga,27,1997,5.2,4,3,0,2,2,2,5,40.0,3,0,0,0,2,6,2
2207,Axel Tuanzebe,cd,DF,,Ipswich Town,Premier League,27,1997,8.6,18,11,13,2,3,10,14,71.4,4,7,3,4,11,29,25
2208,Stefano Turati,it,GK,,Monza,Serie A,23,2001,13.0,0,0,0,0,0,0,0,,0,0,0,0,0,0,8
2209,Beñat Turrientes,es,MF,,Real Sociedad,La Liga,22,2002,5.7,11,3,4,6,1,3,7,42.9,4,11,2,9,1,12,5
2210,Tuta,br,DF,MF,Eint Frankfurt,Bundesliga,25,1999,12.5,26,16,14,10,2,18,26,69.2,8,22,13,9,21,47,73
2211,Chrisantus Uche,ng,FW,MF,Getafe,La Liga,21,2003,13.5,11,8,2,5,4,2,4,50.0,2,7,1,6,2,13,8
2212,Destiny Udogie,it,DF,,Tottenham,Premier League,22,2002,14.5,44,28,25,12,7,23,34,67.6,11,24,2,22,16,60,25
2213,Manuel Ugarte Ribeiro,uy,MF,,Manchester Utd,Premier League,23,2001,6.6,29,15,11,14,4,9,21,42.9,12,8,2,6,9,38,8
2214,Lesley Ugochukwu,fr,MF,,Southampton,Premier League,20,2004,2.3,5,2,0,4,1,0,6,0.0,6,6,1,5,2,7,1
2215,Lukas Ullrich,de,DF,,Gladbach,Bundesliga,20,2004,5.1,2,1,1,0,1,1,6,16.7,5,11,3,8,7,9,15
2216,Sven Ulreich,de,GK,,Bayern Munich,Bundesliga,36,1988,1.0,0,0,0,0,0,0,0,,0,0,0,0,0,0,0
2217,Enes Ünal,tr,FW,MF,Bournemouth,Premier League,27,1997,2.5,1,0,0,0,1,0,2,0.0,2,1,0,1,0,1,4
2218,Deniz Undav,de,FW,MF,Stuttgart,Bundesliga,28,1996,7.1,4,4,1,1,2,0,5,0.0,5,3,0,3,3,7,3
2219,Naci Ünüvar,nl,MF,DF,Espanyol,La Liga,21,2003,0.3,2,2,1,1,0,1,2,50.0,1,0,0,0,0,2,0
2220,Dayot Upamecano,fr,DF,,Bayern Munich,Bundesliga,26,1998,12.9,18,12,7,9,2,9,18,50.0,9,12,6,6,19,37,28
2221,Kacper Urbanski,pl,MF,,Bologna,Serie A,20,2004,2.7,5,2,4,0,1,4,6,66.7,2,5,1,4,2,7,5
2222,Can Uzun,tr,MF,FW,Eint Frankfurt,Bundesliga,19,2005,2.2,4,2,1,1,2,3,5,60.0,2,4,0,4,0,4,1
2223,Josha Vagnoman,de,DF,MF,Stuttgart,Bundesliga,24,2000,11.4,10,4,7,3,0,7,13,53.8,6,8,2,6,9,19,29
2224,Lautaro Valenti,ar,DF,,Parma,Serie A,25,1999,0.2,0,0,0,0,0,0,0,,0,1,0,1,0,0,0
2225,Óscar Valentín,es,MF,,Rayo Vallecano,La Liga,30,1994,11.9,32,25,12,12,8,17,34,50.0,17,18,3,15,13,45,32
2226,Germán Valera,es,MF,,Valencia,La Liga,22,2002,1.6,1,1,1,0,0,0,1,0.0,1,2,0,2,4,5,2
2227,Emanuele Valeri,it,DF,,Parma,Serie A,26,1998,11.4,19,9,13,4,2,14,20,70.0,6,13,5,8,13,32,31
2228,Martin Valjent,sk,DF,,Mallorca,La Liga,29,1995,13.8,14,8,12,1,1,6,7,85.7,1,11,6,5,10,24,73
2229,Jesús Vallejo,es,DF,,Real Madrid,La Liga,27,1997,0.1,0,0,0,0,0,0,0,,0,0,0,0,0,0,2
2230,Mattia Valoti,it,MF,,Monza,Serie A,31,1993,0.4,2,2,2,0,0,0,2,0.0,2,1,0,1,0,2,2
2231,Federico Valverde,uy,MF,DF,Real Madrid,La Liga,26,1998,16.3,25,16,10,13,2,15,21,71.4,6,25,4,21,32,57,20
2232,Ignace Van Der Brempt,be,DF,,Como,Serie A,22,2002,7.2,23,18,15,6,2,13,17,76.5,4,6,2,4,6,29,15
2233,Siebe Van Der Heyden,be,DF,MF,Mallorca,La Liga,26,1998,1.1,1,1,0,1,0,0,0,,0,1,0,1,2,3,3
2234,Virgil van Dijk,nl,DF,,Liverpool,Premier League,33,1991,15.0,10,4,6,3,1,3,8,37.5,5,10,3,7,28,38,69
2235,Vanderson,br,DF,,Monaco,Ligue 1,23,2001,9.4,31,18,13,14,4,18,25,72.0,7,17,4,13,23,54,16
2236,Maarten Vandevoordt,be,GK,,RB Leipzig,Bundesliga,22,2002,1.5,0,0,0,0,0,0,0,,0,0,0,0,0,0,2
2237,Jamie Vardy,eng,FW,,Leicester City,Premier League,37,1987,13.2,5,5,2,3,0,1,5,20.0,4,3,2,1,1,6,13
2238,Ruben Vargas,ch,MF,FW,Augsburg,Bundesliga,26,1998,3.0,2,1,1,1,0,1,4,25.0,3,1,0,1,2,4,1
2239,Nikola Vasilj,ba,GK,,St. Pauli,Bundesliga,29,1995,14.0,0,0,0,0,0,0,1,0.0,1,0,0,0,0,0,9
2240,Devis Vásquez,co,GK,,Empoli,Serie A,26,1998,16.0,0,0,0,0,0,0,0,,0,0,0,0,0,0,12
2241,Johan Vásquez,mx,DF,,Genoa,Serie A,26,1998,13.5,17,9,5,10,2,4,14,28.6,10,23,14,9,18,35,53
2242,Denis Vavro,sk,DF,,Wolfsburg,Bundesliga,28,1996,9.0,4,3,4,0,0,3,8,37.5,5,12,6,6,9,13,77
2243,José Luis García Vayá,es,MF,,Valencia,La Liga,26,1998,11.0,18,11,7,7,4,5,13,38.5,8,12,3,9,4,22,15
2244,Jesus Vazquez,es,DF,,Valencia,La Liga,21,2003,7.2,16,13,8,6,2,5,12,41.7,7,14,5,9,5,21,22
2245,Lucas Vázquez,es,DF,,Real Madrid,La Liga,33,1991,8.8,22,12,14,6,2,10,20,50.0,10,6,1,5,4,26,10
2246,Matías Vecino,uy,MF,,Lazio,Serie A,33,1991,5.4,8,6,1,6,1,3,13,23.1,10,5,2,3,5,13,6
2247,Renato Veiga,pt,DF,MF,Chelsea,Premier League,21,2003,2.0,9,6,6,3,0,4,12,33.3,8,3,1,2,1,10,2
2248,Alejo Véliz,ar,FW,,Espanyol,La Liga,21,2003,8.0,1,1,0,1,0,1,5,20.0,4,11,2,9,3,4,14
2249,Miloš Veljković,rs,DF,,Werder Bremen,Bundesliga,29,1995,4.5,2,1,1,0,1,1,5,20.0,4,6,5,1,1,3,15
2250,Joël Veltman,nl,DF,,Brighton,Premier League,32,1992,10.6,22,15,13,7,2,15,34,44.1,19,12,5,7,11,33,35
2251,Micky van de Ven,nl,DF,,Tottenham,Premier League,23,2001,8.8,8,5,3,4,1,6,11,54.5,5,8,5,3,9,17,29
2252,Nikolas Veratschnig,at,MF,DF,Mainz 05,Bundesliga,21,2003,0.1,0,0,0,0,0,0,0,,0,1,0,1,0,0,0
2253,Bart Verbruggen,nl,GK,,Brighton,Premier League,22,2002,14.0,0,0,0,0,0,0,2,0.0,2,0,0,0,0,0,11
2254,Simone Verdi,it,FW,MF,Como,Serie A,32,1992,1.2,2,2,0,1,1,0,2,0.0,2,1,0,1,0,2,2
2255,Jordan Veretout,fr,MF,,Lyon,Ligue 1,31,1993,9.1,12,6,5,6,1,6,19,31.6,13,9,2,7,1,13,11
2256,Arthur Vermeeren,be,MF,,RB Leipzig,Bundesliga,19,2005,6.7,15,12,5,9,1,5,21,23.8,16,13,6,7,13,28,10
2257,Yorbe Vertessen,be,MF,FW,Union Berlin,Bundesliga,23,2001,6.6,6,3,3,2,1,2,6,33.3,4,4,0,4,3,9,5
2258,Mikel Vesga,es,MF,,Athletic Club,La Liga,31,1993,4.4,9,5,2,7,0,4,12,33.3,8,6,0,6,6,15,5
2259,Jannik Vestergaard,dk,DF,,Leicester City,Premier League,32,1992,7.2,14,6,10,4,0,3,7,42.9,4,8,6,2,9,23,38
2260,Ben Viadere,fr,MF,,Auxerre,Ligue 1,19,2005,0.1,0,0,0,0,0,0,0,,0,0,0,0,0,0,0
2261,Guglielmo Vicario,it,GK,,Tottenham,Premier League,28,1996,12.0,0,0,0,0,0,0,0,,0,0,0,0,1,1,7
2262,Carlos Vicente,es,FW,MF,Alavés,La Liga,25,1999,15.7,15,10,10,2,3,8,14,57.1,6,11,1,10,5,20,11
2263,Pau Victor Delgado,es,FW,,Barcelona,La Liga,23,2001,2.2,1,1,0,1,0,0,3,0.0,3,5,1,4,2,3,4
2264,Nacho Vidal,es,DF,,Osasuna,La Liga,29,1995,1.4,2,0,0,1,1,1,4,25.0,3,1,0,1,0,2,6
2265,Gabriel Vidovic,hr,MF,,Mainz 05,Bundesliga,21,2003,0.0,0,0,0,0,0,0,0,,0,0,0,0,0,0,0
2266,Fran Vieites,es,GK,,Betis,La Liga,25,1999,2.0,0,0,0,0,0,0,0,,0,0,0,0,0,0,0
2267,Samuele Vignato,it,MF,,Monza,Serie A,20,2004,2.5,4,2,0,2,2,3,5,60.0,2,0,0,0,0,4,4
2268,Asier Villalibre,es,FW,,Alavés,La Liga,27,1997,2.4,0,0,0,0,0,0,0,,0,1,0,1,1,1,4
2269,Iván Villar,es,GK,,Celta Vigo,La Liga,27,1997,4.0,0,0,0,0,0,0,0,,0,0,0,0,0,0,3
2270,Nicolas Viola,it,MF,FW,Cagliari,Serie A,35,1989,5.3,5,5,1,4,0,0,4,0.0,4,1,0,1,2,7,2
2271,Viti,es,DF,,Las Palmas,La Liga,27,1997,10.2,34,25,19,12,3,11,16,68.8,5,14,3,11,17,51,29
2272,Mattia Viti,it,DF,,Empoli,Serie A,22,2002,16.0,39,26,29,9,1,21,29,72.4,8,27,15,12,28,67,68
2273,Vitinha,pt,FW,,Genoa,Serie A,24,2000,6.2,10,4,4,3,3,4,15,26.7,11,5,1,4,5,15,7
2274,Vitinha,pt,MF,,Paris S-G,Ligue 1,24,2000,10.5,20,9,6,13,1,13,23,56.5,10,8,3,5,5,25,7
2275,Daniel Vivian,es,DF,,Athletic Club,La Liga,25,1999,13.6,16,13,9,7,0,12,15,80.0,3,12,5,7,15,31,66
2276,Dušan Vlahović,rs,FW,,Juventus,Serie A,24,2000,12.8,2,1,0,1,1,1,1,100.0,0,5,3,2,1,3,8
2277,Vanja Vlahović,rs,MF,FW,Atalanta,Serie A,20,2004,0.3,0,0,0,0,0,0,0,,0,0,0,0,0,0,0
2278,Nikola Vlašić,hr,MF,FW,Torino,Serie A,27,1997,5.9,19,12,7,8,4,7,12,58.3,5,6,2,4,5,24,6
2279,Alessandro Vogliacco,it,DF,,Genoa,Serie A,26,1998,7.9,15,3,7,7,1,10,12,83.3,2,11,7,4,9,24,20
2280,Kevin Vogt,de,DF,,Union Berlin,Bundesliga,33,1991,12.4,8,5,6,2,0,7,10,70.0,3,13,7,6,7,15,59
2281,Mërgim Vojvoda,xk,DF,,Torino,Serie A,29,1995,8.7,12,6,5,5,2,6,13,46.2,7,11,3,8,5,17,18
2282,Kevin Volland,de,MF,,Union Berlin,Bundesliga,32,1992,0.1,0,0,0,0,0,0,0,,0,0,0,0,0,0,1
2283,Aster Vranckx,be,MF,,Wolfsburg,Bundesliga,22,2002,1.4,3,2,1,2,0,1,1,100.0,0,2,1,1,3,6,4
2284,Stefan de Vrij,nl,DF,,Inter,Serie A,32,1992,7.7,8,5,5,2,1,3,5,60.0,2,7,4,3,5,13,26
2285,Ibrahima Wadji,sn,MF,FW,Saint-Étienne,Ligue 1,29,1995,1.2,4,4,1,2,1,3,7,42.9,4,0,0,0,0,4,0
2286,Robert Wagner,de,MF,,St. Pauli,Bundesliga,21,2003,4.0,7,2,1,6,0,3,10,30.0,7,6,0,6,1,8,9
2287,Elye Wahi,fr,FW,,Marseille,Ligue 1,21,2003,6.0,0,0,0,0,0,0,4,0.0,4,1,0,1,1,1,0
2288,Hauke Wahl,de,DF,,St. Pauli,Bundesliga,30,1994,14.0,18,12,12,5,1,9,13,69.2,4,12,7,5,11,29,51
2289,Kyle Walker,eng,DF,,Manchester City,Premier League,34,1990,9.7,17,10,7,7,3,14,23,60.9,9,12,4,8,3,20,10
2290,Kyle Walker-Peters,eng,DF,,Southampton,Premier League,27,1997,13.9,20,13,12,5,3,9,18,50.0,9,15,7,8,11,31,35
2291,Christian Walton,eng,GK,,Ipswich Town,Premier League,29,1995,1.0,0,0,0,0,0,0,1,0.0,1,0,0,0,0,0,0
2292,Sebastian Walukiewicz,pl,DF,,Torino,Serie A,24,2000,9.7,14,8,8,4,2,10,15,66.7,5,13,3,10,13,27,32
2293,Sebastian Walukiewicz,pl,DF,,Empoli,Serie A,24,2000,2.0,1,0,1,0,0,0,1,0.0,1,3,3,0,1,2,15
2294,Aaron Wan-Bissaka,eng,DF,,West Ham,Premier League,27,1997,14.0,27,20,13,12,2,10,13,76.9,3,12,4,8,25,52,45
2295,Paul Wanner,de,MF,FW,Heidenheim,Bundesliga,18,2005,11.2,23,14,9,14,0,9,18,50.0,9,7,0,7,3,26,9
2296,Danny Ward,wls,GK,,Leicester City,Premier League,31,1993,0.5,0,0,0,0,0,0,0,,0,0,0,0,0,0,1
2297,James Ward-Prowse,eng,MF,,West Ham,Premier League,30,1994,0.2,1,0,1,0,0,1,1,100.0,0,1,0,1,0,1,0
2298,James Ward-Prowse,eng,MF,,Nott'ham Forest,Premier League,30,1994,4.2,4,1,1,3,0,2,2,100.0,0,3,2,1,5,9,6
2299,Kjell-Arik Wätjen,de,MF,,Dortmund,Bundesliga,18,2006,0.2,0,0,0,0,0,0,0,,0,0,0,0,0,0,2
2300,Ollie Watkins,eng,FW,,Aston Villa,Premier League,28,1995,12.5,5,3,0,3,2,1,6,16.7,5,7,1,6,2,7,3
2301,Timothy Weah,us,FW,,Juventus,Serie A,24,2000,7.7,10,5,2,5,3,4,8,50.0,4,7,1,6,4,14,5
2302,Adam Webster,eng,DF,,Brighton,Premier League,29,1995,0.9,0,0,0,0,0,0,2,0.0,2,4,3,1,1,1,3
2303,Julian Weigl,de,MF,,Gladbach,Bundesliga,29,1995,12.5,22,7,16,4,2,12,16,75.0,4,18,9,9,26,48,27
2304,Timon Weiner,de,GK,,Holstein Kiel,Bundesliga,25,1999,14.0,0,0,0,0,0,0,0,,0,0,0,0,0,0,6
2305,Nelson Weiper,de,MF,FW,Mainz 05,Bundesliga,19,2005,0.5,1,1,1,0,0,0,0,,0,1,0,1,0,1,0
2306,Mitchell Weiser,de,DF,MF,Werder Bremen,Bundesliga,30,1994,12.9,23,15,7,14,2,10,17,58.8,7,9,0,9,7,30,25
2307,Noah Weißhaupt,de,FW,,Freiburg,Bundesliga,23,2001,0.9,0,0,0,0,0,0,1,0.0,1,0,0,0,0,0,1
2308,Danny Welbeck,eng,FW,,Brighton,Premier League,34,1990,12.4,11,6,3,7,1,3,10,30.0,7,11,1,10,4,15,8
2309,Timo Werner,de,FW,MF,Tottenham,Premier League,28,1996,4.4,2,2,1,1,0,1,9,11.1,8,10,1,9,1,3,6
2310,Adam Wharton,eng,MF,,Crystal Palace,Premier League,20,2004,6.9,18,10,9,9,0,9,26,34.6,17,5,0,5,10,28,13
2311,Ben White,eng,DF,,Arsenal,Premier League,27,1997,7.7,10,6,8,1,1,9,21,42.9,12,6,5,1,11,21,23
2312,Silvan Widmer,ch,DF,,Mainz 05,Bundesliga,31,1993,1.8,5,3,1,3,1,3,4,75.0,1,1,0,1,3,8,9
2313,Mats Wieffer,nl,MF,,Brighton,Premier League,25,1999,4.6,19,10,4,12,3,6,13,46.2,7,10,1,9,5,24,11
2314,Mateusz Wieteska,pl,DF,,Cagliari,Serie A,27,1997,1.2,1,0,0,1,0,1,1,100.0,0,2,1,1,6,7,4
2315,Caleb Wiley,us,DF,MF,Strasbourg,Ligue 1,19,2004,3.0,1,0,0,1,0,0,1,0.0,1,3,1,2,4,5,5
2316,Iñaki Williams,gh,FW,,Athletic Club,La Liga,30,1994,15.3,12,5,3,8,1,8,15,53.3,7,13,2,11,8,20,13
2317,Neco Williams,wls,DF,,Nott'ham Forest,Premier League,23,2001,7.2,23,14,19,4,0,12,21,57.1,9,12,2,10,5,28,28
2318,Nico Williams,es,FW,,Athletic Club,La Liga,22,2002,12.8,22,13,7,9,6,8,20,40.0,12,10,0,10,4,26,5
2319,Joe Willock,eng,MF,FW,Newcastle Utd,Premier League,25,1999,5.1,13,9,5,5,3,9,14,64.3,5,11,1,10,3,16,4
2320,Callum Wilson,eng,FW,MF,Newcastle Utd,Premier League,32,1992,0.7,1,1,0,1,0,0,0,,0,0,0,0,0,1,0
2321,Harry Wilson,wls,FW,MF,Fulham,Premier League,27,1997,3.7,5,3,4,1,0,2,4,50.0,2,6,0,6,3,8,1
2322,Patrick Wimmer,at,MF,FW,Wolfsburg,Bundesliga,23,2001,7.0,15,10,7,6,2,6,12,50.0,6,10,1,9,9,24,4
2323,Jonas Wind,dk,MF,FW,Wolfsburg,Bundesliga,25,1999,6.3,2,2,0,2,0,1,2,50.0,1,6,2,4,2,4,4
2324,Harry Winks,eng,MF,,Leicester City,Premier League,28,1996,9.6,12,7,6,4,2,5,13,38.5,8,10,4,6,4,16,14
2325,Florian Wirtz,de,MF,,Leverkusen,Bundesliga,21,2003,12.4,16,9,6,7,3,5,12,41.7,7,17,1,16,8,24,1
2326,Yoane Wissa,cd,FW,,Brentford,Premier League,28,1996,10.6,3,2,0,1,2,0,5,0.0,5,6,1,5,3,6,4
2327,Dani de Wit,nl,MF,FW,Bochum,Bundesliga,26,1998,7.6,14,9,6,7,1,8,15,53.3,7,9,3,6,6,20,13
2328,Axel Witsel,be,DF,,Atlético Madrid,La Liga,35,1989,7.0,11,10,3,7,1,9,11,81.8,2,9,5,4,6,17,24
2329,Maximilian Wittek,de,DF,,Bochum,Bundesliga,29,1995,12.8,22,16,12,8,2,17,25,68.0,8,24,5,19,14,36,35
2330,Marius Wolf,de,DF,,Augsburg,Bundesliga,29,1995,10.4,13,7,5,5,3,7,20,35.0,13,18,3,15,10,23,26
2331,Nick Woltemade,de,FW,MF,Stuttgart,Bundesliga,22,2002,3.1,1,1,0,1,0,0,1,0.0,1,3,0,3,0,1,3
2332,Jeong Woo-yeong,kr,MF,FW,Union Berlin,Bundesliga,25,1999,8.0,2,1,1,1,0,0,2,0.0,2,3,1,2,5,7,1
2333,Chris Wood,nz,FW,,Nott'ham Forest,Premier League,33,1991,13.7,1,1,0,0,1,1,5,20.0,4,3,2,1,4,5,9
2334,Nathan Wood-Gordon,eng,DF,,Southampton,Premier League,22,2002,2.8,4,3,3,1,0,2,4,50.0,2,4,3,1,1,5,8
2335,Christopher Wooh,cm,DF,,Rennes,Ligue 1,23,2001,9.8,26,12,15,9,2,14,19,73.7,5,17,7,10,11,37,35
2336,Luke Woolfenden,eng,DF,,Ipswich Town,Premier League,26,1998,4.2,1,1,1,0,0,0,2,0.0,2,8,3,5,8,9,22
2337,Granit Xhaka,ch,MF,,Leverkusen,Bundesliga,32,1992,14.0,17,10,4,11,2,8,15,53.3,7,12,4,8,3,20,14
2338,Lamine Yamal,es,FW,,Barcelona,La Liga,17,2007,14.2,22,16,2,10,10,6,13,46.2,7,7,0,7,9,31,3
2339,Daniel Yáñez,es,FW,,Real Madrid,La Liga,17,2007,0.0,0,0,0,0,0,0,0,,0,0,0,0,0,0,0
2340,Yehor Yarmoliuk,ua,MF,,Brentford,Premier League,20,2004,4.4,12,9,4,5,3,5,18,27.8,13,15,5,10,6,18,10
2341,Ryan Yates,eng,MF,,Nott'ham Forest,Premier League,27,1997,13.2,26,14,15,8,3,9,17,52.9,8,17,1,16,15,41,35
2342,John Yeboah,ec,MF,FW,Venezia,Serie A,24,2000,2.8,3,3,1,1,1,0,6,0.0,6,2,0,2,2,5,0
2343,Bertuğ Yıldırım,tr,FW,,Getafe,La Liga,22,2002,8.5,6,3,0,5,1,1,5,20.0,4,8,1,7,1,7,11
2344,Kenan Yıldız,tr,FW,MF,Juventus,Serie A,19,2005,12.4,31,19,8,15,8,8,12,66.7,4,11,0,11,2,33,5
2345,Leny Yoro,fr,DF,,Manchester Utd,Premier League,19,2005,1.2,4,1,4,0,0,2,3,66.7,1,1,1,0,2,6,3
2346,Ashley Young,eng,DF,,Everton,Premier League,39,1985,12.5,39,21,19,16,4,25,36,69.4,11,6,2,4,16,55,40
2347,Etienne Youte Kinkoue,fr,DF,,Le Havre,Ligue 1,22,2002,10.5,8,3,4,4,0,6,10,60.0,4,19,11,8,13,21,62
2348,Illia Zabarnyi,ua,DF,,Bournemouth,Premier League,22,2002,16.0,23,16,9,14,0,13,20,65.0,7,21,11,10,17,40,72
2349,Mattia Zaccagni,it,FW,MF,Lazio,Serie A,29,1995,12.1,11,8,1,8,2,4,10,40.0,6,6,0,6,12,23,5
2350,Dan-Axel Zagadou,fr,DF,MF,Stuttgart,Bundesliga,25,1999,0.3,0,0,0,0,0,0,0,,0,0,0,0,1,1,1
2351,Yoram Zague,fr,DF,,Paris S-G,Ligue 1,18,2006,1.8,4,3,2,1,1,2,3,66.7,1,2,0,2,2,6,2
2352,Wilfried Zaha,ci,FW,,Lyon,Ligue 1,32,1992,0.8,1,1,1,0,0,1,2,50.0,1,3,0,3,1,2,0
2353,Warren Zaïre-Emery,fr,MF,DF,Paris S-G,Ligue 1,18,2006,11.6,30,13,9,13,8,13,23,56.5,10,21,3,18,11,41,14
2354,Miha Zajc,si,MF,,Toulouse,Ligue 1,30,1994,1.5,1,1,0,0,1,1,2,50.0,1,0,0,0,2,3,3
2355,Denis Zakaria,ch,MF,,Monaco,Ligue 1,28,1996,9.3,12,8,5,5,2,7,11,63.6,4,10,4,6,14,26,22
2356,Nicola Zalewski,pl,DF,FW,Roma,Serie A,22,2002,5.6,7,5,2,2,3,2,7,28.6,5,5,1,4,3,10,6
2357,Andre-Frank Zambo Anguissa,cm,MF,,Napoli,Serie A,29,1995,15.9,26,18,5,18,3,8,19,42.1,11,8,2,6,22,48,13
2358,Francesco Zampano,it,DF,,Venezia,Serie A,31,1993,13.0,22,15,12,8,2,10,22,45.5,12,15,0,15,5,27,18
2359,Nicolò Zaniolo,it,FW,MF,Atalanta,Serie A,25,1999,2.3,0,0,0,0,0,0,1,0.0,1,0,0,0,0,0,0
2360,Alessandro Zanoli,it,DF,FW,Genoa,Serie A,24,2000,9.1,16,11,6,8,2,6,10,60.0,4,7,2,5,4,20,24
2361,Duván Zapata,co,FW,,Torino,Serie A,33,1991,6.5,7,5,2,0,5,0,3,0.0,3,2,1,1,2,9,7
2362,Gabriele Zappa,it,DF,,Cagliari,Serie A,24,1999,15.5,19,11,10,8,1,9,15,60.0,6,22,12,10,9,28,42
2363,Davide Zappacosta,it,DF,,Atalanta,Serie A,32,1992,7.8,6,4,3,2,1,6,13,46.2,7,8,1,7,2,8,7
2364,Bryan Zaragoza,es,FW,MF,Osasuna,La Liga,23,2001,11.7,11,8,8,2,1,4,16,25.0,12,7,0,7,0,11,8
2365,Anass Zaroury,ma,FW,MF,Lens,Ligue 1,24,2000,7.1,7,6,0,5,2,3,12,25.0,9,5,0,5,0,7,4
2366,Oier Zarraga,es,MF,,Udinese,Serie A,25,1999,5.5,11,7,6,5,0,6,15,40.0,9,3,2,1,2,13,4
2367,Jordan Zemura,zw,DF,,Udinese,Serie A,25,1999,9.2,19,9,9,7,3,10,17,58.8,7,12,3,9,13,32,23
2368,Robin Zentner,de,GK,,Mainz 05,Bundesliga,30,1994,14.0,0,0,0,0,0,0,0,,0,0,0,0,0,0,18
2369,Alessio Zerbin,it,DF,,Napoli,Serie A,25,1999,0.0,1,1,1,0,0,1,1,100.0,0,0,0,0,0,1,0
2370,Kevin Zeroli,it,MF,,Milan,Serie A,19,2005,0.1,1,1,0,1,0,0,0,,0,0,0,0,0,1,0
2371,Cedric Zesiger,ch,DF,,Wolfsburg,Bundesliga,26,1998,5.8,13,8,6,5,2,6,12,50.0,6,6,5,1,3,16,28
2372,Michael Zetterer,de,GK,,Werder Bremen,Bundesliga,29,1995,14.0,0,0,0,0,0,0,0,,0,0,0,0,1,1,3
2373,Nathan Zeze,fr,DF,,Nantes,Ligue 1,19,2005,9.8,23,12,12,11,0,14,20,70.0,6,17,8,9,12,35,76
2374,Edon Zhegrova,xk,FW,MF,Lille,Ligue 1,25,1999,10.9,5,2,3,0,2,2,7,28.6,5,8,0,8,4,9,1
2375,Piotr Zieliński,pl,MF,,Inter,Serie A,30,1994,3.5,7,6,3,3,1,2,7,28.6,5,1,0,1,0,7,1
2376,Oleksandr Zinchenko,ua,DF,MF,Arsenal,Premier League,28,1996,2.6,2,0,1,1,0,1,4,25.0,3,5,0,5,3,5,5
2377,Joshua Zirkzee,nl,FW,MF,Manchester Utd,Premier League,23,2001,6.7,4,1,3,1,0,3,3,100.0,0,7,2,5,2,6,2
2378,Luc Zogbé,ci,DF,,Brest,Ligue 1,19,2005,3.4,12,9,7,3,2,8,12,66.7,4,4,0,4,4,16,8
2379,Nadir Zortea,it,DF,FW,Cagliari,Serie A,25,1999,9.8,13,5,6,6,1,7,14,50.0,7,2,0,2,5,18,17
2380,Aristide Zossou,ci,MF,,Auxerre,Ligue 1,19,2005,0.1,0,0,0,0,0,0,0,,0,0,0,0,0,0,0
2381,Yanis Zouaoui,dz,DF,FW,Le Havre,Ligue 1,30,1994,2.6,4,3,2,1,1,2,2,100.0,0,1,0,1,2,6,5
2382,Igor Zubeldia,es,DF,,Real Sociedad,La Liga,27,1997,14.4,16,11,9,6,1,8,15,53.3,7,20,13,7,14,30,53
2383,Martín Zubimendi,es,MF,,Real Sociedad,La Liga,25,1999,16.0,43,25,17,18,8,16,25,64.0,9,22,7,15,23,66,35
2384,Martin Ødegaard,no,MF,,Arsenal,Premier League,26,1998,8.1,11,6,4,5,2,2,11,18.2,9,2,0,2,1,12,1
2385,Milan Đurić,ba,FW,,Monza,Serie A,34,1990,12.2,1,1,0,1,0,0,2,0.0,2,6,0,6,2,3,12
