Rk,Player,Nation,Pos1,Pos2,Squad,Comp,Age,Born,90s,Tkl,TklW,Def 3rd,Mid 3rd,Att 3rd,Tkl Att,Tkl%,Lost,Blocks,Sh,Pass,Int,Tkl+Int,Clr,Err
1,Max Aarons,eng,DF,,Bournemouth,Premier League,23,2000,13.7,29,19,20,7,2,20,34,58.8,14,9,5,4,8,37,27
2,Brenden Aaronson,us,MF,FW,Union Berlin,Bundesliga,22,2000,14.1,32,18,13,13,6,16,32,50.0,16,26,1,25,2,34,4
3,Paxten Aaronson,us,MF,,Eint Frankfurt,Bundesliga,19,2003,1.1,2,2,1,1,0,1,1,100.0,0,2,0,2,0,2,0
4,Keyliane Abdallah,fr,FW,,Marseille,Ligue 1,17,2006,0.0,0,0,0,0,0,0,0,,0,0,0,0,0,0,0
5,Yunis Abdelhamid,ma,DF,,Reims,Ligue 1,35,1987,30.9,64,35,36,23,5,26,45,57.8,19,51,32,19,39,103,109
6,Salis Abdul Samed,gh,MF,,Lens,Ligue 1,23,2000,16.9,21,14,8,10,3,8,18,44.4,10,12,1,11,12,33,18
7,Nabil Aberdin,fr,DF,,Getafe,La Liga,20,2002,2.0,0,0,0,0,0,0,1,0.0,1,0,0,0,0,0,4
8,Laurent Abergel,fr,MF,,Lorient,Ligue 1,30,1993,31.8,85,52,43,34,8,38,96,39.6,58,29,6,23,61,146,61
9,Matthis Abline,fr,FW,,Nantes,Ligue 1,20,2003,11.6,9,4,4,3,2,3,8,37.5,5,3,0,3,3,12,5
10,Abner,br,DF,,Betis,La Liga,23,2000,15.6,25,19,15,9,1,17,34,50.0,17,23,5,18,15,40,62
11,Zakaria Aboukhlal,ma,MF,FW,Toulouse,Ligue 1,23,2000,8.4,9,8,1,5,3,3,12,25.0,9,9,1,8,1,10,2
12,Abdel Abqar,ma,DF,,Alavés,La Liga,24,1999,25.7,35,19,28,5,2,21,35,60.0,14,31,26,5,23,58,115
13,Tammy Abraham,eng,FW,,Roma,Serie A,25,1997,2.7,3,1,0,1,2,0,0,,0,1,0,1,0,3,4
14,Francesco Acerbi,it,DF,,Inter,Serie A,35,1988,26.5,22,13,16,6,0,11,14,78.6,3,20,13,7,32,54,77
15,Joshua Acheampong,eng,DF,,Chelsea,Premier League,17,2006,0.1,0,0,0,0,0,0,0,,0,3,3,0,0,0,0
16,Marcos Acuña,ar,DF,,Sevilla,La Liga,31,1991,14.4,33,21,20,12,1,9,14,64.3,5,12,2,10,4,37,25
17,Akor Adams,ng,FW,,Montpellier,Ligue 1,23,2000,25.0,12,4,3,4,5,3,7,42.9,4,9,2,7,5,17,11
18,Tyler Adams,us,MF,,Bournemouth,Premier League,24,1999,1.3,4,3,1,3,0,2,3,66.7,1,2,0,2,4,8,2
19,Junior Adamu,at,FW,MF,Freiburg,Bundesliga,22,2001,1.2,5,1,1,2,2,1,2,50.0,1,1,0,1,0,5,2
20,Sargis Adamyan,am,FW,MF,Köln,Bundesliga,30,1993,8.9,14,9,2,9,3,6,11,54.5,5,16,1,15,5,19,7
21,Tosin Adarabioyo,eng,DF,,Fulham,Premier League,25,1997,18.0,21,11,16,5,0,12,21,57.1,9,16,11,5,25,46,80
22,Elijah Adebayo,eng,FW,,Luton Town,Premier League,25,1998,15.8,4,1,1,0,3,1,12,8.3,11,13,2,11,6,10,25
23,Karim Adeyemi,de,FW,MF,Dortmund,Bundesliga,21,2002,10.1,16,14,9,4,3,8,20,40.0,12,11,0,11,3,19,5
24,Simon Adingra,ci,FW,,Brighton,Premier League,21,2002,24.7,45,20,23,11,11,19,42,45.2,23,31,1,30,19,64,22
25,Nathaniel Adjei,gh,DF,,Lorient,Ligue 1,20,2002,13.8,13,9,8,3,2,6,7,85.7,1,15,8,7,18,31,64
26,Amine Adli,ma,MF,FW,Leverkusen,Bundesliga,23,2000,10.0,16,7,2,10,4,7,17,41.2,10,10,2,8,6,22,5
27,Yacine Adli,fr,MF,,Milan,Serie A,23,2000,15.6,34,17,17,13,4,13,35,37.1,22,22,8,14,20,54,15
28,Adryelson,br,DF,FW,Lyon,Ligue 1,25,1998,0.1,0,0,0,0,0,0,0,,0,0,0,0,1,1,3
29,Adson,br,MF,FW,Nantes,Ligue 1,22,2000,2.6,7,6,1,6,0,2,2,100.0,0,5,0,5,2,9,2
30,Michel Aebischer,ch,MF,,Bologna,Serie A,26,1997,24.8,35,20,9,20,6,15,34,44.1,19,28,6,22,12,47,22
31,Emmanuel Agbadou,ci,DF,,Reims,Ligue 1,26,1997,28.8,65,41,38,23,4,44,64,68.8,20,47,25,22,55,120,116
32,Julen Agirrezabala,es,GK,,Athletic Club,La Liga,22,2000,2.6,0,0,0,0,0,0,0,,0,0,0,0,0,0,0
33,Lucien Agoume,fr,MF,,Inter,Serie A,21,2002,0.1,0,0,0,0,0,0,0,,0,0,0,0,0,0,0
34,Lucien Agoume,fr,MF,,Sevilla,La Liga,21,2002,8.6,23,18,7,14,2,9,12,75.0,3,6,1,5,7,30,8
35,Felix Agu,de,DF,MF,Werder Bremen,Bundesliga,23,1999,17.9,45,29,28,13,4,29,41,70.7,12,27,7,20,13,58,41
36,Nayef Aguerd,ma,DF,,West Ham,Premier League,27,1996,20.6,26,14,19,7,0,16,22,72.7,6,33,24,9,17,43,85
37,Ruben Aguilar,fr,DF,,Lens,Ligue 1,30,1993,21.4,53,31,27,23,3,27,45,60.0,18,35,5,30,26,79,46
38,Brandon Aguilera,cr,FW,,Nott'ham Forest,Premier League,20,2003,0.1,0,0,0,0,0,0,0,,0,0,0,0,0,0,0
39,Naouirou Ahamada,fr,MF,FW,Crystal Palace,Premier League,21,2002,3.9,13,9,5,6,2,8,17,47.1,9,3,0,3,2,15,4
40,Anel Ahmedhodžić,ba,DF,,Sheffield Utd,Premier League,24,1999,29.4,64,36,48,14,2,30,49,61.2,19,43,26,17,35,99,137
41,Joseph Aidoo,gh,DF,,Celta Vigo,La Liga,27,1995,4.5,8,3,6,2,0,4,8,50.0,4,3,1,2,4,12,28
42,Ola Aina,ng,DF,,Nott'ham Forest,Premier League,26,1996,18.8,47,31,31,12,4,29,41,70.7,12,19,3,16,18,65,51
43,Rayan Aït-Nouri,dz,DF,MF,Wolves,Premier League,22,2001,25.9,71,44,41,23,7,28,49,57.1,21,32,6,26,15,86,38
44,Tosin Aiyegun,bj,MF,FW,Lorient,Ligue 1,25,1998,10.0,6,4,2,3,1,3,9,33.3,6,4,1,3,2,8,8
45,Kristoffer Ajer,no,DF,,Brentford,Premier League,25,1998,20.4,38,21,25,9,4,23,36,63.9,13,26,11,15,25,63,79
46,Ludovic Ajorque,fr,FW,,Mainz 05,Bundesliga,29,1994,15.1,3,2,1,2,0,2,11,18.2,9,6,2,4,4,7,11
47,Manuel Akanji,ch,DF,MF,Manchester City,Premier League,28,1995,27.9,42,28,16,18,8,22,39,56.4,17,28,12,16,23,65,70
48,Marley Aké,fr,FW,,Udinese,Serie A,22,2001,0.1,0,0,0,0,0,0,0,,0,0,0,0,0,0,0
49,Nathan Aké,nl,DF,,Manchester City,Premier League,28,1995,22.7,26,16,15,8,3,13,20,65.0,7,17,2,15,14,40,54
50,Ilias Akhomach,ma,MF,FW,Villarreal,La Liga,19,2004,16.8,36,21,11,16,9,10,20,50.0,10,10,2,8,13,49,13
51,Sergio Akieme,es,DF,,Almería,La Liga,25,1997,18.6,27,15,18,7,2,13,16,81.3,3,14,4,10,10,37,34
52,Sergio Akieme,es,DF,,Reims,Ligue 1,25,1997,9.1,11,5,6,3,2,8,11,72.7,3,9,3,6,10,21,25
53,Ebenezer Akinsanmiro,ng,MF,,Inter,Serie A,18,2004,0.2,0,0,0,0,0,0,1,0.0,1,0,0,0,0,0,0
54,Maghnes Akliouche,fr,MF,FW,Monaco,Ligue 1,21,2002,17.9,37,23,12,20,5,12,36,33.3,24,21,0,21,9,46,3
55,Paul Akouokou,ci,MF,,Betis,La Liga,25,1997,0.3,5,3,0,2,3,3,3,100.0,0,3,1,2,1,6,1
56,Paul Akouokou,ci,MF,,Lyon,Ligue 1,25,1997,3.4,14,9,2,10,2,6,7,85.7,1,5,1,4,6,20,11
57,Jean-Daniel Akpa-Akpro,ci,MF,,Monza,Serie A,30,1992,7.8,20,11,14,4,2,3,9,33.3,6,10,4,6,12,32,15
58,David Akpan Ankeye,ng,FW,,Genoa,Serie A,21,2002,0.6,1,0,0,1,0,0,1,0.0,1,1,0,1,0,1,0
59,Kevin Akpoguma,ng,DF,,Hoffenheim,Bundesliga,28,1995,12.2,35,18,22,12,1,26,35,74.3,9,28,8,20,18,53,32
60,David Alaba,at,DF,,Real Madrid,La Liga,31,1992,12.8,13,9,7,5,1,4,8,50.0,4,10,7,3,15,28,34
61,Luis Alberto,es,MF,,Lazio,Serie A,30,1992,25.7,35,20,16,12,7,15,53,28.3,38,34,4,30,7,42,13
62,Raúl Albiol,es,DF,,Villarreal,La Liga,37,1985,22.6,25,14,15,9,1,18,27,66.7,9,31,24,7,16,41,102
63,Thiago Alcántara,es,MF,,Liverpool,Premier League,32,1991,0.1,0,0,0,0,0,0,0,,0,0,0,0,0,0,0
64,Carlos Alcaraz,ar,MF,,Juventus,Serie A,20,2002,4.2,6,6,0,6,0,5,10,50.0,5,5,2,3,5,11,4
65,Rubén Alcaraz,es,MF,,Cádiz,La Liga,32,1991,34.8,97,59,39,52,6,50,121,41.3,71,60,14,46,33,130,55
66,Omar Alderete,py,DF,,Getafe,La Liga,26,1996,24.4,28,21,15,13,0,19,35,54.3,16,30,18,12,13,41,111
67,Iván Alejo,es,MF,,Cádiz,La Liga,28,1995,18.8,40,23,23,11,6,17,57,29.8,40,20,0,20,7,47,17
68,Carles Aleñá,es,MF,,Getafe,La Liga,25,1998,11.3,24,8,7,14,3,10,24,41.7,14,14,3,11,4,28,13
69,Trent Alexander-Arnold,eng,DF,,Liverpool,Premier League,24,1998,23.9,39,26,26,11,2,27,87,31.0,60,22,2,20,31,70,48
70,Aboubacar Ali,fr,MF,FW,Strasbourg,Ligue 1,17,2006,1.4,2,0,0,2,0,0,0,,0,1,0,1,1,3,2
71,Mohamed Ali Cho,fr,FW,MF,Real Sociedad,La Liga,19,2004,2.8,4,3,3,1,0,2,7,28.6,5,6,0,6,1,5,1
72,Mohamed Ali Cho,fr,FW,,Nice,Ligue 1,19,2004,9.6,12,9,4,7,1,3,11,27.3,8,10,0,10,3,15,6
73,Faride Alidou,de,FW,MF,Köln,Bundesliga,22,2001,14.2,10,4,3,6,1,4,18,22.2,14,23,2,21,8,18,15
74,Nabil Alioui,fr,MF,FW,Le Havre,Ligue 1,24,1999,11.2,3,2,2,1,0,2,4,50.0,2,6,1,5,3,6,4
75,Alisson,br,GK,,Liverpool,Premier League,30,1992,28.0,0,0,0,0,0,0,1,0.0,1,0,0,0,0,0,11
76,Tadeo Allende,ar,MF,FW,Celta Vigo,La Liga,24,1999,3.7,6,1,3,2,1,4,6,66.7,2,3,0,3,3,9,3
77,Jim Allevinah,ga,MF,DF,Clermont Foot,Ligue 1,28,1995,20.7,30,18,11,14,5,14,35,40.0,21,20,3,17,13,43,30
78,Domingos André Ribeiro Almeida,pt,FW,MF,Valencia,La Liga,23,2000,10.7,25,15,9,12,4,9,19,47.4,10,13,1,12,6,31,5
79,Miguel Almirón,py,FW,,Newcastle Utd,Premier League,29,1994,21.5,36,24,13,15,8,11,29,37.9,18,29,2,27,10,46,13
80,Pontus Almqvist,se,FW,MF,Lecce,Serie A,24,1999,23.4,45,29,16,22,7,23,51,45.1,28,21,2,19,14,59,10
81,Marcos Alonso,es,DF,,Barcelona,La Liga,32,1990,2.8,5,3,2,3,0,3,4,75.0,1,2,0,2,4,9,6
82,Adrià Altimira,es,DF,MF,Villarreal,La Liga,22,2001,8.6,16,7,9,6,1,9,24,37.5,15,18,5,13,5,21,18
83,Sergi Altimira,es,MF,,Betis,La Liga,21,2001,6.3,15,8,8,6,1,11,23,47.8,12,12,1,11,9,24,10
84,Edson Álvarez,mx,MF,,West Ham,Premier League,25,1997,26.4,80,39,47,26,7,31,66,47.0,35,59,20,39,42,122,81
85,Gastón Álvarez,uy,DF,,Getafe,La Liga,23,2000,28.2,68,37,43,20,5,37,57,64.9,20,40,11,29,35,103,80
86,Hugo Álvarez,es,MF,DF,Celta Vigo,La Liga,20,2003,8.5,14,9,8,3,3,9,20,45.0,11,4,1,3,5,19,9
87,Julián Álvarez,ar,MF,FW,Manchester City,Premier League,23,2000,29.4,24,13,5,8,11,8,32,25.0,24,30,0,30,2,26,14
88,Yeray Álvarez,es,DF,,Athletic Club,La Liga,28,1995,12.8,18,9,15,3,0,12,19,63.2,7,8,5,3,11,29,34
89,Skelly Alvero,fr,MF,,Lyon,Ligue 1,21,2002,4.7,8,7,5,2,1,2,9,22.2,7,5,1,4,2,10,5
90,Skelly Alvero,fr,MF,,Werder Bremen,Bundesliga,21,2002,1.4,6,4,1,5,0,3,3,100.0,0,3,1,2,1,7,1
91,Papa Amadou Diallo,sn,FW,,Metz,Ligue 1,19,2004,9.9,18,8,10,7,1,7,21,33.3,14,11,1,10,11,29,16
92,Selim Amallah,ma,FW,MF,Valencia,La Liga,26,1996,6.7,17,12,7,7,3,3,9,33.3,6,13,0,13,11,28,6
93,Amath,sn,FW,MF,Mallorca,La Liga,27,1996,4.4,9,6,7,2,0,2,10,20.0,8,2,0,2,3,12,6
94,Lorenzo Amatucci,it,MF,,Fiorentina,Serie A,19,2004,0.2,0,0,0,0,0,0,0,,0,0,0,0,0,0,0
95,Jordan Amavi,fr,DF,,Brest,Ligue 1,29,1994,1.0,1,1,0,1,0,1,3,33.3,2,2,1,1,3,4,2
96,Zeki Amdouni,ch,FW,,Burnley,Premier League,22,2000,21.7,27,18,1,15,11,7,25,28.0,18,23,10,13,9,36,10
97,Kelvin Amian,fr,DF,,Nantes,Ligue 1,25,1998,8.9,16,7,12,4,0,11,15,73.3,4,6,0,6,7,23,28
98,Bruno Amione,ar,DF,,Hellas Verona,Serie A,21,2002,6.4,11,3,9,2,0,4,5,80.0,1,4,2,2,9,20,19
99,Michael Amir Murillo,pa,DF,,Marseille,Ligue 1,27,1996,11.1,23,11,13,6,4,15,23,65.2,8,9,2,7,11,34,34
100,Nadiem Amiri,de,MF,,Mainz 05,Bundesliga,26,1996,14.6,22,14,8,10,4,13,19,68.4,6,16,2,14,14,36,18
101,Nadiem Amiri,de,MF,,Leverkusen,Bundesliga,26,1996,1.0,4,2,0,3,1,0,3,0.0,3,0,0,0,0,4,1
102,Kofi Amoako,de,MF,,Wolfsburg,Bundesliga,18,2005,0.0,0,0,0,0,0,0,0,,0,0,0,0,0,0,0
103,Sofyan Amrabat,ma,MF,DF,Manchester Utd,Premier League,26,1996,10.4,27,16,17,8,2,17,31,54.8,14,20,7,13,8,35,19
104,Joachim Andersen,dk,DF,,Crystal Palace,Premier League,27,1996,37.9,56,35,33,21,2,29,39,74.4,10,33,18,15,41,97,207
105,Elliot Anderson,eng,MF,FW,Newcastle Utd,Premier League,20,2002,11.4,24,18,12,9,3,15,29,51.7,14,23,4,19,8,32,23
106,Felipe Anderson,br,FW,MF,Lazio,Serie A,30,1993,30.8,78,45,32,33,13,34,90,37.8,56,45,3,42,27,105,23
107,Benjamin André,fr,MF,,Lille,Ligue 1,32,1990,28.6,89,49,39,45,5,43,81,53.1,38,34,5,29,35,124,60
108,Komnen Andrić,rs,FW,,Clermont Foot,Ligue 1,28,1995,1.9,2,1,0,1,1,0,4,0.0,4,2,0,2,0,2,1
109,Robert Andrich,de,MF,DF,Leverkusen,Bundesliga,28,1994,18.8,30,18,8,14,8,13,24,54.2,11,15,4,11,20,50,17
110,Miguel Ángel Rubio,es,DF,,Granada,La Liga,25,1998,17.3,20,12,14,6,0,14,21,66.7,7,31,18,13,28,48,74
111,Angeliño,es,DF,,Roma,Serie A,26,1997,12.7,21,11,12,6,3,11,19,57.9,8,11,5,6,12,33,37
112,Ângelo,br,FW,MF,Strasbourg,Ligue 1,18,2004,12.2,24,11,9,7,8,11,31,35.5,20,18,0,18,9,33,2
113,Fabrizio Angileri,ar,DF,MF,Getafe,La Liga,29,1994,1.8,1,1,1,0,0,1,3,33.3,2,0,0,0,4,5,8
114,Jaidon Anthony,eng,FW,,Bournemouth,Premier League,23,1999,1.7,3,1,1,0,2,1,7,14.3,6,3,0,3,1,4,3
115,Waldemar Anton,de,DF,,Stuttgart,Bundesliga,27,1996,32.1,39,25,21,16,2,23,42,54.8,19,33,20,13,40,79,150
116,Michail Antonio,jm,FW,,West Ham,Premier League,33,1990,18.8,15,8,5,6,4,3,11,27.3,8,16,3,13,4,19,4
117,Antony,br,FW,,Manchester Utd,Premier League,23,2000,14.7,40,21,15,19,6,20,40,50.0,20,29,1,28,12,52,9
118,Christopher Antwi-Adjei,gh,FW,MF,Bochum,Bundesliga,29,1994,13.5,21,12,10,6,5,12,22,54.5,10,13,2,11,2,23,11
119,Houssem Aouar,dz,MF,FW,Roma,Serie A,25,1998,8.4,16,11,4,10,2,3,12,25.0,9,5,0,5,4,20,2
120,Stredair Appuah,fr,FW,MF,Nantes,Ligue 1,19,2004,0.9,0,0,0,0,0,0,3,0.0,3,0,0,0,1,1,1
121,Mauro Arambarri,uy,MF,,Getafe,La Liga,27,1995,3.8,6,2,3,2,1,1,6,16.7,5,1,0,1,2,8,7
122,Jon Aramburu,ve,DF,,Real Sociedad,La Liga,21,2002,6.0,24,15,12,10,2,15,25,60.0,10,8,3,5,7,31,17
123,Asaf Arania,il,MF,,Darmstadt 98,Bundesliga,17,2005,0.1,0,0,0,0,0,0,0,,0,0,0,0,0,0,0
124,Julian Araujo,mx,DF,,Las Palmas,La Liga,21,2001,16.2,41,22,29,7,5,23,33,69.7,10,23,16,7,10,51,52
125,Ronald Araújo,uy,DF,,Barcelona,La Liga,24,1999,22.2,27,22,11,15,1,12,17,70.6,5,20,11,9,12,39,66
126,Oliver Arblaster,eng,MF,,Sheffield Utd,Premier League,19,2004,10.5,23,14,11,8,4,7,15,46.7,8,17,7,10,15,38,9
127,Cameron Archer,eng,FW,MF,Sheffield Utd,Premier League,22,2001,20.4,18,13,6,6,6,8,18,44.4,10,22,3,19,1,19,11
128,Cameron Archer,eng,MF,,Aston Villa,Premier League,22,2001,0.1,0,0,0,0,0,0,0,,0,0,0,0,0,0,0
129,Alphonse Areola,fr,GK,,West Ham,Premier League,30,1993,30.0,1,1,1,0,0,1,3,33.3,2,0,0,0,1,2,16
130,Adu Ares,es,FW,,Athletic Club,La Liga,21,2001,2.9,8,4,4,2,2,2,3,66.7,1,1,0,1,1,9,0
131,Jesús Areso,es,DF,,Osasuna,La Liga,24,1999,29.6,45,24,25,13,7,31,38,81.6,7,36,15,21,18,63,58
132,Simone Aresti,it,GK,,Cagliari,Serie A,37,1986,0.0,0,0,0,0,0,0,0,,0,0,0,0,0,0,0
133,Matias Arezo,uy,FW,,Granada,La Liga,20,2002,4.1,7,3,2,5,0,1,5,20.0,4,4,1,3,1,8,4
134,Iñigo Arguibide,es,DF,,Osasuna,La Liga,18,2005,0.2,1,0,0,1,0,0,0,,0,0,0,0,0,1,1
135,Yoël Armougom,fr,DF,MF,Clermont Foot,Ligue 1,25,1998,2.6,3,3,2,0,1,2,3,66.7,1,1,0,1,1,4,3
136,José Arnaiz,es,FW,MF,Osasuna,La Liga,28,1995,10.3,14,8,6,4,4,6,21,28.6,15,11,2,9,3,17,2
137,Hákon Arnar Haraldsson,is,FW,MF,Lille,Ligue 1,20,2003,14.3,12,8,4,7,1,5,21,23.8,16,7,2,5,3,15,5
138,Marko Arnautović,at,FW,,Inter,Serie A,34,1989,8.9,10,4,3,5,2,4,7,57.1,3,8,1,7,5,15,5
139,Maximilian Arnold,de,MF,,Wolfsburg,Bundesliga,29,1994,27.8,51,31,15,27,9,28,57,49.1,29,23,4,19,24,75,60
140,Mohamed El Arouch,fr,FW,,Lyon,Ligue 1,19,2004,0.0,0,0,0,0,0,0,0,,0,0,0,0,0,0,0
141,Sergio Arribas,es,MF,FW,Almería,La Liga,21,2001,22.7,34,17,16,17,1,14,31,45.2,17,20,1,19,16,50,8
142,Kepa Arrizabalaga,es,GK,,Real Madrid,La Liga,28,1994,13.3,0,0,0,0,0,0,1,0.0,1,0,0,0,0,0,4
143,Arthur,br,DF,,Leverkusen,Bundesliga,20,2003,2.0,4,3,2,0,2,2,2,100.0,0,1,1,0,0,4,7
144,Takuma Asano,jp,FW,MF,Bochum,Bundesliga,28,1994,22.1,17,6,2,9,6,7,23,30.4,16,17,3,14,4,21,11
145,Marco Asensio,es,MF,FW,Paris S-G,Ligue 1,27,1996,12.4,12,10,4,7,1,4,13,30.8,9,7,0,7,5,17,2
146,Kristjan Asllani,al,MF,,Inter,Serie A,21,2002,8.7,7,2,3,4,0,2,11,18.2,9,9,3,6,11,18,8
147,Joel Asoro,se,FW,MF,Metz,Ligue 1,24,1999,9.4,13,9,7,6,0,3,10,30.0,7,7,1,6,6,19,9
148,Jonathan Asp Jensen,dk,FW,,Bayern Munich,Bundesliga,17,2006,0.0,0,0,0,0,0,0,0,,0,0,0,0,0,0,1
149,Iago Aspas,es,FW,,Celta Vigo,La Liga,35,1987,30.1,11,6,4,6,1,1,15,6.7,14,23,3,20,10,21,8
150,Lorenz Assignon,tg,DF,,Burnley,Premier League,23,2000,13.7,35,17,18,13,4,14,27,51.9,13,22,7,15,19,54,43
151,Lorenz Assignon,tg,DF,,Rennes,Ligue 1,23,2000,11.2,24,12,12,8,4,9,24,37.5,15,9,4,5,9,33,27
152,Youcef Atal,dz,DF,,Nice,Ligue 1,27,1996,4.0,9,3,6,2,1,6,8,75.0,2,7,1,6,4,13,1
153,Valentin Atangana Edoa,fr,MF,,Reims,Ligue 1,17,2005,6.2,19,13,6,9,4,5,13,38.5,8,5,1,4,6,25,9
154,Arthur Atta,fr,MF,FW,Metz,Ligue 1,20,2003,10.3,18,14,8,7,3,8,19,42.1,11,13,3,10,10,28,23
155,Noah Atubolu,de,GK,,Freiburg,Bundesliga,21,2002,34.0,0,0,0,0,0,0,1,0.0,1,0,0,0,0,0,8
156,Pierre-Emerick Aubameyang,ga,FW,,Marseille,Ligue 1,34,1989,29.1,22,14,4,11,7,7,26,26.9,19,30,5,25,9,31,26
157,Emil Audero,it,GK,,Inter,Serie A,26,1997,3.7,0,0,0,0,0,0,0,,0,0,0,0,0,0,1
158,Tommaso Augello,it,DF,,Cagliari,Serie A,28,1994,26.9,26,19,18,6,2,16,25,64.0,9,21,10,11,17,43,89
159,Carlos Augusto,br,DF,,Inter,Serie A,24,1999,19.2,29,21,20,9,0,15,22,68.2,7,20,8,12,16,45,52
160,Yann Aurel Bisseck,de,DF,,Inter,Serie A,22,2000,10.0,14,6,10,3,1,6,9,66.7,3,10,7,3,5,19,23
161,Serge Aurier,ci,DF,MF,Nott'ham Forest,Premier League,30,1992,9.3,20,14,9,11,0,5,11,45.5,6,10,3,7,9,29,36
162,Ezequiel Ávila,ar,FW,MF,Osasuna,La Liga,29,1994,9.6,3,2,1,1,1,3,11,27.3,8,14,0,14,4,7,8
163,Ezequiel Ávila,ar,FW,,Betis,La Liga,29,1994,3.3,2,1,0,2,0,1,3,33.3,2,2,0,2,1,3,4
164,Taiwo Awoniyi,ng,FW,,Nott'ham Forest,Premier League,25,1997,11.6,9,7,1,4,4,1,2,50.0,1,7,2,5,1,10,9
165,André Ayew,gh,FW,,Le Havre,Ligue 1,33,1989,12.3,15,11,7,6,2,6,9,66.7,3,8,3,5,2,17,11
166,Jordan Ayew,gh,FW,MF,Crystal Palace,Premier League,31,1991,28.3,65,36,23,28,14,21,42,50.0,21,43,2,41,16,81,15
167,Neil El Aynaoui,fr,MF,,Lens,Ligue 1,22,2001,17.4,37,20,13,20,4,20,46,43.5,26,20,6,14,32,69,21
168,Sardar Azmoun,ir,FW,MF,Roma,Serie A,28,1995,6.5,8,5,2,5,1,4,8,50.0,4,4,1,3,3,11,6
169,César Azpilicueta,es,DF,,Atlético Madrid,La Liga,33,1989,15.8,25,14,15,9,1,12,19,63.2,7,25,6,19,16,41,46
170,Paulo Azzi,br,DF,MF,Cagliari,Serie A,29,1994,10.6,19,11,10,6,3,9,18,50.0,9,11,2,9,16,35,23
171,Oussama El Azzouzi,ma,MF,,Bologna,Serie A,22,2001,6.1,12,7,4,5,3,7,14,50.0,7,8,2,6,6,18,12
172,Abdellah Baallal,ma,MF,,Clermont Foot,Ligue 1,18,2004,0.0,0,0,0,0,0,0,0,,0,1,0,1,0,0,0
173,Iddrisu Baba,gh,MF,,Almería,La Liga,27,1996,15.9,46,26,27,18,1,17,39,43.6,22,20,6,14,11,57,27
174,Srđan Babić,rs,DF,,Almería,La Liga,27,1996,1.0,2,2,0,2,0,1,1,100.0,0,1,1,0,0,2,2
175,Shavy Babicka,ga,FW,MF,Toulouse,Ligue 1,23,2000,4.1,11,8,2,7,2,2,5,40.0,3,6,1,5,0,11,2
176,Aliou Badara Baldé,gn,FW,DF,Nice,Ligue 1,20,2002,0.8,4,1,0,3,1,1,1,100.0,0,2,1,1,3,7,0
177,Loïc Bade,fr,DF,,Sevilla,La Liga,23,2000,25.3,65,41,53,12,0,30,49,61.2,19,23,15,8,38,103,116
178,Milan Badelj,hr,MF,,Genoa,Serie A,34,1989,28.2,51,27,23,24,4,24,61,39.3,37,45,13,32,50,101,54
179,Matthias Bader,de,DF,MF,Darmstadt 98,Bundesliga,26,1997,20.0,51,25,32,11,8,33,65,50.8,32,22,4,18,25,76,20
180,Benoît Badiashile,fr,DF,,Chelsea,Premier League,22,2001,14.9,21,15,12,9,0,9,14,64.3,5,21,14,7,18,39,66
181,Alex Baena,es,MF,FW,Villarreal,La Liga,22,2001,28.7,34,21,10,16,8,20,47,42.6,27,23,2,21,13,47,17
182,Jaime Báez,uy,FW,MF,Frosinone,Serie A,28,1995,5.6,4,1,0,2,2,0,7,0.0,7,5,0,5,4,8,1
183,Nicola Bagnolini,it,GK,,Bologna,Serie A,19,2004,0.1,0,0,0,0,0,0,0,,0,0,0,0,0,0,0
184,Leon Bailey,jm,MF,FW,Aston Villa,Premier League,25,1997,23.0,13,7,7,4,2,5,20,25.0,15,18,1,17,9,22,6
185,Eric Bailly,ci,DF,,Villarreal,La Liga,29,1994,9.3,5,3,4,1,0,2,2,100.0,0,8,8,0,9,14,38
186,Stefan Bajcetic,es,MF,,Liverpool,Premier League,18,2004,0.3,4,1,3,1,0,3,5,60.0,2,0,0,0,0,4,0
187,Nedim Bajrami,al,MF,FW,Sassuolo,Serie A,24,1999,14.6,13,6,6,3,4,5,13,38.5,8,5,1,4,6,19,8
188,Cédric Bakambu,cd,FW,,Betis,La Liga,32,1991,2.2,1,0,0,1,0,0,0,,0,2,0,2,0,1,0
189,Tiemoué Bakayoko,fr,MF,,Lorient,Ligue 1,28,1994,14.6,34,17,14,17,3,15,28,53.6,13,10,4,6,26,60,15
190,Mitchel Bakker,nl,DF,,Atalanta,Serie A,23,2000,4.2,7,3,6,1,0,2,12,16.7,10,5,0,5,3,10,6
191,Ridle Baku,de,DF,MF,Wolfsburg,Bundesliga,25,1998,22.4,37,20,24,7,6,21,46,45.7,25,27,1,26,21,58,45
192,Dilane Bakwa,fr,FW,MF,Strasbourg,Ligue 1,20,2002,24.2,30,22,12,13,5,11,40,27.5,29,26,1,25,20,50,11
193,Tommaso Baldanzi,it,MF,FW,Empoli,Serie A,20,2003,8.3,4,2,1,1,2,3,10,30.0,7,7,0,7,2,6,0
194,Tommaso Baldanzi,it,FW,MF,Roma,Serie A,20,2003,5.8,9,5,3,4,2,1,1,100.0,0,2,0,2,0,9,4
195,Alejandro Balde,es,DF,,Barcelona,La Liga,19,2003,15.3,20,11,11,6,3,7,11,63.6,4,14,1,13,5,25,21
196,George Baldock,gr,DF,,Sheffield Utd,Premier League,30,1993,10.8,18,10,10,7,1,6,15,40.0,9,14,8,6,10,28,33
197,Carlos Baleba,cm,MF,,Brighton,Premier League,19,2004,14.7,40,20,17,19,4,23,46,50.0,23,35,7,28,18,58,30
198,Carlos Baleba,cm,MF,,Lille,Ligue 1,19,2004,0.7,6,2,1,4,1,3,4,75.0,1,0,0,0,2,8,0
199,Leonardo Balerdi,ar,DF,,Marseille,Ligue 1,24,1999,25.2,79,50,55,23,1,49,67,73.1,18,38,15,23,51,130,91
200,Iván Balliu,al,DF,,Rayo Vallecano,La Liga,31,1992,31.9,44,31,20,24,0,22,39,56.4,17,27,11,16,29,73,66
201,Fodé Ballo-Touré,sn,DF,MF,Fulham,Premier League,26,1997,0.8,4,2,1,3,0,1,2,50.0,1,1,0,1,3,7,2
202,Folarin Balogun,us,FW,,Monaco,Ligue 1,22,2001,18.8,12,4,3,8,1,5,13,38.5,8,10,0,10,3,15,4
203,Jonathan Bamba,ci,MF,FW,Celta Vigo,La Liga,27,1996,22.0,14,9,4,8,2,2,17,11.8,15,20,0,20,18,32,12
204,Mohamed Bamba,ci,FW,,Lorient,Ligue 1,21,2001,12.6,14,9,3,8,3,4,10,40.0,6,7,1,6,2,16,3
205,Samuel Bamba,de,FW,,Dortmund,Bundesliga,19,2004,0.5,1,1,1,0,0,1,2,50.0,1,0,0,0,0,1,1
206,Lameck Banda,zm,FW,,Lecce,Serie A,22,2001,15.0,27,23,11,12,4,7,21,33.3,14,18,0,18,3,30,7
207,Daniel Bandeira,pt,MF,,Hellas Verona,Serie A,23,2000,5.0,6,5,1,4,1,3,7,42.9,4,3,0,3,3,9,9
208,Mamady Bangré,bf,FW,MF,Toulouse,Ligue 1,22,2001,1.1,4,2,2,2,0,3,4,75.0,1,0,0,0,4,8,3
209,Mattia Bani,it,DF,,Genoa,Serie A,29,1993,25.6,26,10,18,7,1,11,22,50.0,11,51,31,20,22,48,116
210,Léo Baptistão,br,FW,,Almería,La Liga,30,1992,20.4,25,16,12,8,5,9,25,36.0,16,13,1,12,11,36,22
211,Shandon Baptiste,gd,MF,,Brentford,Premier League,25,1998,2.5,4,4,2,2,0,1,5,20.0,4,5,1,4,3,7,6
212,Antonín Barák,cz,MF,FW,Fiorentina,Serie A,28,1994,9.0,6,2,1,3,2,3,7,42.9,4,5,0,5,2,8,4
213,Valentín Barco,ar,DF,FW,Brighton,Premier League,19,2004,3.4,11,5,4,5,2,6,8,75.0,2,3,0,3,4,15,3
214,Bradley Barcola,fr,FW,,Lyon,Ligue 1,20,2002,3.0,5,2,0,2,3,1,7,14.3,6,4,0,4,2,7,0
215,Bradley Barcola,fr,FW,MF,Paris S-G,Ligue 1,20,2002,15.2,34,16,12,13,9,7,25,28.0,18,27,2,25,10,44,13
216,Melvin Bard,fr,DF,,Nice,Ligue 1,22,2000,29.5,69,38,28,30,11,37,63,58.7,26,46,12,34,42,111,46
217,Nicolò Barella,it,MF,,Inter,Serie A,26,1997,31.6,46,30,17,20,9,19,63,30.2,44,31,1,30,10,56,12
218,Kike Barja,es,FW,MF,Osasuna,La Liga,26,1997,3.4,6,2,2,2,2,3,8,37.5,5,2,1,1,2,8,2
219,Ross Barkley,eng,MF,,Luton Town,Premier League,29,1993,29.1,47,19,16,21,10,11,48,22.9,37,25,9,16,25,72,51
220,Aymen Barkok,ma,MF,FW,Mainz 05,Bundesliga,25,1998,3.6,9,5,2,6,1,3,6,50.0,3,7,0,7,2,11,1
221,Harvey Barnes,eng,FW,MF,Newcastle Utd,Premier League,25,1997,8.9,6,1,3,2,1,1,2,50.0,1,1,0,1,5,11,3
222,Leandro Barreiro Martins,lu,MF,,Mainz 05,Bundesliga,23,2000,29.0,65,40,19,37,9,30,50,60.0,20,45,16,29,36,101,53
223,Enzo Barrenechea,ar,MF,,Frosinone,Serie A,22,2001,31.2,65,42,28,29,8,28,70,40.0,42,47,12,35,27,92,61
224,Ander Barrenetxea,es,FW,MF,Real Sociedad,La Liga,21,2001,15.9,32,21,7,16,9,10,26,38.5,16,18,1,17,6,38,5
225,Pablo Barrios,es,MF,,Atlético Madrid,La Liga,20,2003,17.3,45,25,15,29,1,19,40,47.5,21,20,3,17,28,73,24
226,Davide Bartesaghi,it,DF,MF,Milan,Serie A,17,2005,0.9,2,0,1,1,0,2,4,50.0,2,1,1,0,0,2,7
227,Marc Bartra,es,DF,,Betis,La Liga,32,1991,2.5,4,3,3,1,0,4,5,80.0,1,3,1,2,3,7,10
228,Federico Baschirotto,it,DF,,Lecce,Serie A,26,1996,36.6,21,12,16,5,0,8,15,53.3,7,42,26,16,23,44,144
229,Steven Baseya,fr,DF,,Strasbourg,Ligue 1,18,2005,0.1,2,1,1,1,0,1,1,100.0,0,0,0,0,0,2,1
230,Chris Basham,eng,DF,MF,Sheffield Utd,Premier League,35,1988,3.6,7,2,4,3,0,2,9,22.2,7,9,4,5,5,12,17
231,Toma Bašić,hr,MF,,Salernitana,Serie A,26,1996,12.9,20,13,10,9,1,10,27,37.0,17,18,6,12,14,34,29
232,Calvin Bassey,ng,DF,,Fulham,Premier League,23,1999,25.6,49,29,33,15,1,21,29,72.4,8,32,11,21,28,77,84
233,Alessandro Bastoni,it,DF,,Inter,Serie A,24,1999,25.2,46,33,31,12,3,26,40,65.0,14,25,11,14,23,69,48
234,Simone Bastoni,it,MF,DF,Empoli,Serie A,26,1996,8.3,22,13,12,7,3,11,22,50.0,11,8,0,8,11,33,18
235,Augusto Batalla,ar,GK,,Granada,La Liga,27,1996,17.0,0,0,0,0,0,0,1,0.0,1,0,0,0,0,0,10
236,Daniel Batz,de,GK,,Mainz 05,Bundesliga,32,1991,4.0,0,0,0,0,0,0,0,,0,0,0,0,0,0,3
237,Maximilian Bauer,de,DF,,Augsburg,Bundesliga,23,2000,9.0,19,12,13,4,2,9,17,52.9,8,14,8,6,11,30,30
238,Elias Baum,de,DF,MF,Eint Frankfurt,Bundesliga,17,2005,0.3,1,0,0,0,1,0,0,,0,3,2,1,0,1,1
239,Oliver Baumann,de,GK,,Hoffenheim,Bundesliga,33,1990,34.0,1,1,1,0,0,1,2,50.0,1,0,0,0,0,1,19
240,Christoph Baumgartner,at,MF,FW,RB Leipzig,Bundesliga,23,1999,12.9,26,13,10,12,4,14,38,36.8,24,20,1,19,5,31,14
241,Bebé,cv,MF,FW,Rayo Vallecano,La Liga,33,1990,2.4,2,2,1,1,0,1,5,20.0,4,1,0,1,0,2,0
242,Ihlas Bebou,tg,FW,DF,Hoffenheim,Bundesliga,29,1994,18.2,22,12,10,8,4,8,16,50.0,8,13,2,11,14,36,15
243,Mohamed Bechikh,fr,FW,MF,Strasbourg,Ligue 1,18,2005,0.2,0,0,0,0,0,0,0,,0,0,0,0,0,0,0
244,Adrian Beck,de,MF,FW,Heidenheim,Bundesliga,26,1997,10.8,22,13,8,12,2,9,24,37.5,15,17,0,17,4,26,15
245,Owen Beck,wls,DF,,Liverpool,Premier League,20,2002,0.1,2,1,1,1,0,0,0,,0,0,0,0,0,2,1
246,Sheraldo Becker,sr,FW,MF,Real Sociedad,La Liga,28,1995,8.6,2,2,0,2,0,0,1,0.0,1,3,0,3,1,3,0
247,Sheraldo Becker,sr,FW,MF,Union Berlin,Bundesliga,28,1995,7.2,3,3,0,2,1,0,2,0.0,2,2,0,2,0,3,2
248,Chris Bedia,ci,FW,MF,Union Berlin,Bundesliga,27,1996,1.6,2,1,0,2,0,0,1,0.0,1,3,0,3,0,2,2
249,Donny van de Beek,nl,DF,,Manchester Utd,Premier League,26,1997,0.0,0,0,0,0,0,0,0,,0,1,0,1,0,0,0
250,Donny van de Beek,nl,MF,FW,Eint Frankfurt,Bundesliga,26,1997,4.0,8,3,3,3,2,3,7,42.9,4,5,1,4,3,11,1
251,Yanis Begraoui,ma,FW,MF,Toulouse,Ligue 1,22,2001,3.3,5,3,1,3,1,3,9,33.3,6,4,0,4,5,10,5
252,Kevin Behrens,de,FW,,Wolfsburg,Bundesliga,32,1991,6.8,2,1,0,1,1,0,2,0.0,2,9,0,9,3,5,6
253,Kevin Behrens,de,FW,,Union Berlin,Bundesliga,32,1991,14.0,13,10,3,7,3,1,4,25.0,3,7,2,5,6,19,19
254,Maximilian Beier,de,FW,MF,Hoffenheim,Bundesliga,20,2002,26.9,20,12,5,11,4,4,19,21.1,15,21,1,20,9,29,12
255,Jérémie Bela,ao,MF,FW,Clermont Foot,Ligue 1,30,1993,2.3,1,1,0,1,0,1,3,33.3,2,1,0,1,0,1,1
256,Reda Belahyane,ma,MF,,Hellas Verona,Serie A,19,2004,1.0,1,1,0,1,0,1,1,100.0,0,0,0,0,1,2,0
257,Reda Belahyane,ma,MF,,Nice,Ligue 1,19,2004,0.3,1,0,0,1,0,1,1,100.0,0,0,0,0,0,1,0
258,Amari'i Bell,jm,DF,,Luton Town,Premier League,29,1994,19.1,50,33,30,19,1,22,35,62.9,13,33,15,18,25,75,60
259,Stefan Bell,de,DF,,Mainz 05,Bundesliga,31,1991,7.4,8,8,7,1,0,4,8,50.0,4,7,5,2,6,14,30
260,Alaa Bellaarouch,ma,GK,,Strasbourg,Ligue 1,21,2002,15.0,0,0,0,0,0,0,0,,0,0,0,0,1,1,11
261,Raoul Bellanova,it,DF,,Torino,Serie A,23,2000,33.8,36,26,15,17,4,18,31,58.1,13,21,4,17,15,51,36
262,Jean-Ricner Bellegarde,fr,MF,FW,Wolves,Premier League,25,1998,10.6,17,10,9,6,2,7,15,46.7,8,18,2,16,8,25,14
263,Jean-Ricner Bellegarde,fr,MF,FW,Strasbourg,Ligue 1,25,1998,3.0,5,3,3,2,0,3,6,50.0,3,4,0,4,4,9,0
264,Héctor Bellerín,es,DF,,Betis,La Liga,28,1995,19.0,34,22,14,16,4,20,53,37.7,33,13,5,8,22,56,40
265,Jude Bellingham,eng,MF,,Real Madrid,La Liga,20,2003,25.7,42,34,14,18,10,12,36,33.3,24,55,5,50,21,63,17
266,Jeanuël Belocian,fr,DF,,Rennes,Ligue 1,18,2005,16.1,32,22,23,8,1,22,28,78.6,6,18,10,8,13,45,49
267,Andrea Belotti,it,FW,,Fiorentina,Serie A,29,1993,10.5,8,3,1,5,2,5,12,41.7,7,8,1,7,2,10,3
268,Andrea Belotti,it,FW,,Roma,Serie A,29,1993,7.5,8,4,2,3,3,3,6,50.0,3,7,0,7,2,10,3
269,Fran Beltrán,es,MF,,Celta Vigo,La Liga,24,1999,27.0,56,32,22,23,11,24,63,38.1,39,28,2,26,18,74,34
270,Lucas Beltrán,ar,FW,MF,Fiorentina,Serie A,22,2001,18.8,27,14,4,18,5,11,20,55.0,9,29,3,26,2,29,11
271,Eliesse Ben Seghir,ma,MF,FW,Monaco,Ligue 1,18,2005,4.8,9,6,2,5,2,3,7,42.9,4,6,0,6,2,11,2
272,Anis Ben Slimane,tn,MF,,Sheffield Utd,Premier League,22,2001,4.7,11,6,5,2,4,4,10,40.0,6,7,1,6,5,16,7
273,Wissam Ben Yedder,fr,FW,,Monaco,Ligue 1,32,1990,25.7,4,3,1,2,1,1,11,9.1,10,18,0,18,8,12,1
274,Carlos Benavídez,uy,MF,,Alavés,La Liga,25,1998,12.6,56,35,19,26,11,19,34,55.9,15,13,5,8,19,75,31
275,Ismaël Bennacer,dz,MF,,Milan,Serie A,25,1997,12.8,29,19,11,16,2,11,22,50.0,11,12,4,8,12,41,9
276,Saïd Benrahma,dz,FW,MF,West Ham,Premier League,27,1995,6.9,8,4,5,3,0,4,15,26.7,11,8,0,8,5,13,7
277,Saïd Benrahma,dz,FW,MF,Lyon,Ligue 1,27,1995,8.6,9,7,1,6,2,5,7,71.4,2,7,0,7,1,10,3
278,Ramy Bensebaini,dz,DF,,Dortmund,Bundesliga,28,1995,11.5,34,21,21,11,2,24,34,70.6,10,22,7,15,16,50,37
279,Nabil Bentaleb,dz,MF,,Lille,Ligue 1,28,1994,21.9,49,32,29,18,2,22,43,51.2,21,33,12,21,37,86,33
280,Rodrigo Bentancur,uy,MF,,Tottenham,Premier League,26,1997,11.2,23,15,10,11,2,10,24,41.7,14,15,4,11,17,40,16
281,Daniel Bentley,eng,GK,,Wolves,Premier League,30,1993,4.3,0,0,0,0,0,0,1,0.0,1,0,0,0,0,0,1
282,Lucas Beraldo,br,DF,,Paris S-G,Ligue 1,19,2003,11.2,22,14,14,8,0,10,25,40.0,15,15,6,9,20,42,25
283,Domenico Berardi,it,FW,,Sassuolo,Serie A,28,1994,15.9,17,8,7,9,1,2,21,9.5,19,17,0,17,13,30,9
284,Yuri Berchiche,es,DF,,Athletic Club,La Liga,33,1990,21.4,33,25,13,14,6,19,33,57.6,14,28,9,19,20,53,62
285,Álex Berenguer,es,FW,,Athletic Club,La Liga,28,1995,17.7,23,14,9,9,5,7,24,29.2,17,23,0,23,5,28,13
286,Bartosz Bereszyński,pl,DF,,Empoli,Serie A,31,1992,19.6,41,25,25,13,3,24,40,60.0,16,22,10,12,21,62,52
287,Jóhann Berg Guðmundsson,is,MF,FW,Burnley,Premier League,32,1990,13.2,13,4,6,5,2,7,16,43.8,9,14,0,14,16,29,16
288,Sander Berge,no,MF,,Burnley,Premier League,25,1998,33.4,76,46,35,36,5,34,58,58.6,24,49,20,29,23,99,60
289,Etrit Berisha,al,GK,,Empoli,Serie A,34,1989,14.0,0,0,0,0,0,0,1,0.0,1,0,0,0,0,0,7
290,Medon Berisha,al,FW,MF,Lecce,Serie A,19,2003,2.3,3,1,3,0,0,0,2,0.0,2,2,2,0,1,4,0
291,Mergim Berisha,de,FW,,Hoffenheim,Bundesliga,25,1998,1.6,0,0,0,0,0,0,0,,0,2,1,1,0,0,0
292,Mergim Berisha,de,FW,,Augsburg,Bundesliga,25,1998,1.4,0,0,0,0,0,0,0,,0,1,0,1,0,0,3
293,Bernardo,br,DF,,Bochum,Bundesliga,28,1995,32.5,99,58,56,35,8,45,69,65.2,24,66,30,36,55,154,120
294,Victor Bernth Kristiansen,dk,DF,,Bologna,Serie A,20,2002,25.6,52,34,23,22,7,20,35,57.1,15,35,8,27,12,64,45
295,Matúš Bero,sk,MF,FW,Bochum,Bundesliga,27,1995,18.5,32,22,13,12,7,13,32,40.6,19,24,3,21,12,44,26
296,Luke Berry,eng,MF,DF,Luton Town,Premier League,31,1992,3.6,7,2,2,4,1,2,3,66.7,1,6,1,5,0,7,3
297,Dimitry Bertaud,cd,GK,,Montpellier,Ligue 1,25,1998,4.0,0,0,0,0,0,0,0,,0,0,0,0,0,0,0
298,Jan-Niklas Beste,de,FW,MF,Heidenheim,Bundesliga,24,1999,28.9,77,49,35,24,18,28,55,50.9,27,48,1,47,18,95,31
299,Beto,gw,FW,,Everton,Premier League,25,1998,10.6,14,6,1,6,7,4,12,33.3,8,11,0,11,1,15,14
300,Beto,gw,FW,,Udinese,Serie A,25,1998,0.8,1,0,0,0,1,0,0,,0,0,0,0,0,1,0
301,Davide Bettella,it,MF,,Monza,Serie A,23,2000,0.0,0,0,0,0,0,0,0,,0,0,0,0,0,0,0
302,Sam Beukema,nl,DF,,Bologna,Serie A,24,1998,28.3,27,11,14,11,2,16,25,64.0,9,35,21,14,15,42,99
303,Jordan Beyer,de,DF,,Burnley,Premier League,23,2000,13.7,35,20,22,12,1,14,24,58.3,10,22,15,7,16,51,68
304,Pep Biel,es,MF,FW,Augsburg,Bundesliga,26,1996,3.2,4,3,0,2,2,1,3,33.3,2,2,1,1,2,6,2
305,Jaka Bijol,si,DF,,Udinese,Serie A,24,1999,23.2,43,27,34,9,0,22,35,62.9,13,36,21,15,23,66,140
306,El Bilal Touré,ml,FW,,Atalanta,Serie A,21,2001,4.4,1,1,0,1,0,0,1,0.0,1,0,0,0,1,2,2
307,Philip Billing,dk,MF,,Bournemouth,Premier League,27,1996,15.5,33,16,7,22,4,9,27,33.3,18,31,5,26,20,53,28
308,Cristiano Biraghi,it,DF,,Fiorentina,Serie A,30,1992,26.2,47,28,20,24,3,28,52,53.8,24,30,5,25,14,61,43
309,Davide Biraschi,it,DF,,Genoa,Serie A,29,1994,1.0,3,3,1,2,0,1,3,33.3,2,0,0,0,2,5,5
310,Samuele Birindelli,it,DF,,Monza,Serie A,24,1999,22.4,28,19,16,7,5,14,25,56.0,11,30,11,19,18,46,48
311,Tom Bischof,de,MF,FW,Hoffenheim,Bundesliga,18,2005,2.0,8,4,6,1,1,2,9,22.2,7,3,0,3,1,9,2
312,Yves Bissouma,ml,MF,,Tottenham,Premier League,26,1996,23.0,80,52,32,36,12,41,61,67.2,20,28,5,23,37,117,43
313,Leonardo Bittencourt,de,MF,,Werder Bremen,Bundesliga,29,1993,17.5,42,18,20,17,5,15,39,38.5,24,18,1,17,13,55,6
314,Marco Bizot,nl,GK,,Brest,Ligue 1,32,1991,32.0,0,0,0,0,0,0,1,0.0,1,0,0,0,0,0,18
315,Antonio Blanco,es,MF,,Alavés,La Liga,23,2000,27.0,61,36,29,27,5,31,86,36.0,55,25,2,23,35,96,30
316,Rubén Blanco,es,GK,,Marseille,Ligue 1,28,1995,1.3,0,0,0,0,0,0,0,,0,0,0,0,0,0,0
317,Hendry Blank,de,DF,,Dortmund,Bundesliga,18,2004,0.5,1,0,1,0,0,1,1,100.0,0,1,0,1,0,1,4
318,Ludovic Blas,fr,FW,MF,Rennes,Ligue 1,25,1997,17.4,30,14,16,13,1,12,28,42.9,16,13,1,12,6,36,9
319,Janis Blaswich,de,GK,,RB Leipzig,Bundesliga,32,1991,21.0,1,1,1,0,0,0,0,,0,0,0,0,0,1,7
320,Alexis Blin,fr,MF,,Lecce,Serie A,26,1996,18.2,33,19,11,19,3,15,43,34.9,28,16,2,14,22,55,39
321,Daley Blind,nl,DF,,Girona,La Liga,33,1990,33.0,47,21,33,13,1,29,47,61.7,18,37,19,18,21,68,113
322,Myron Boadu,nl,FW,,Monaco,Ligue 1,22,2001,0.9,2,2,0,1,1,1,2,50.0,1,2,0,2,0,2,0
323,Benicio Boaitey,eng,FW,DF,Brighton,Premier League,19,2004,0.4,0,0,0,0,0,0,1,0.0,1,1,0,1,0,0,2
324,Jérôme Boateng,de,DF,,Salernitana,Serie A,34,1988,2.6,0,0,0,0,0,0,0,,0,6,5,1,4,4,21
325,Oscar Bobb,no,FW,MF,Manchester City,Premier League,20,2003,3.4,7,3,1,2,4,2,4,50.0,2,4,0,4,5,12,1
326,Sacha Boey,fr,DF,,Bayern Munich,Bundesliga,22,2000,1.2,2,0,2,0,0,1,2,50.0,1,1,0,1,1,3,2
327,Jeremie Boga,ci,FW,,Nice,Ligue 1,26,1997,22.2,18,7,6,10,2,10,20,50.0,10,26,2,24,8,26,4
328,Jayden Bogle,eng,DF,,Sheffield Utd,Premier League,23,2000,31.0,66,36,43,21,2,35,70,50.0,35,42,11,31,32,98,97
329,Emil Bohinen,no,MF,,Genoa,Serie A,24,1999,0.6,1,1,0,1,0,0,0,,0,1,0,1,0,1,3
330,Emil Bohinen,no,MF,,Salernitana,Serie A,24,1999,5.9,8,6,5,3,0,2,10,20.0,8,8,2,6,14,22,6
331,Adama Bojang,gm,FW,,Reims,Ligue 1,19,2004,0.9,2,1,1,0,1,0,0,,0,2,1,1,1,3,0
332,Daniel Boloca,ro,MF,,Sassuolo,Serie A,24,1998,22.5,48,33,18,25,5,27,46,58.7,19,23,13,10,14,62,33
333,Willy Boly,ci,DF,,Nott'ham Forest,Premier League,32,1991,16.0,46,29,36,9,1,22,40,55.0,18,32,21,11,25,71,90
334,Giacomo Bonaventura,it,MF,,Fiorentina,Serie A,33,1989,25.3,26,13,6,10,10,9,21,42.9,12,16,1,15,14,40,10
335,Federico Bonazzoli,it,FW,MF,Hellas Verona,Serie A,26,1997,11.3,4,1,1,3,0,1,8,12.5,7,9,1,8,3,7,3
336,Warren Bondo,fr,MF,,Monza,Serie A,19,2003,16.4,29,22,16,10,3,13,17,76.5,4,13,3,10,6,35,13
337,Giovanni Bonfanti,it,DF,,Atalanta,Serie A,20,2003,1.0,4,2,2,2,0,2,3,66.7,1,1,1,0,1,5,1
338,Victor Boniface,ng,FW,,Leverkusen,Bundesliga,22,2000,17.2,6,4,0,1,5,1,4,25.0,3,6,1,5,0,6,13
339,Kevin Bonifazi,it,DF,,Bologna,Serie A,27,1996,1.0,4,0,0,4,0,1,2,50.0,1,0,0,0,0,4,7
340,Kevin Bonifazi,it,DF,,Frosinone,Serie A,27,1996,3.4,5,3,2,3,0,2,3,66.7,1,1,0,1,3,8,9
341,Leonardo Bonucci,it,DF,,Union Berlin,Bundesliga,36,1987,5.1,6,5,2,4,0,4,4,100.0,0,5,3,2,7,13,16
342,Neto Borges,br,DF,,Clermont Foot,Ligue 1,26,1996,28.0,48,24,25,18,5,28,63,44.4,35,28,6,22,57,105,84
343,Yvandro Borges Sanches,lu,MF,FW,Gladbach,Bundesliga,19,2004,0.2,0,0,0,0,0,0,0,,0,0,0,0,0,0,0
344,Sebastiaan Bornauw,be,DF,,Wolfsburg,Bundesliga,24,1999,15.9,26,12,19,7,0,13,19,68.4,6,21,12,9,18,44,81
345,Rafael Borré,co,FW,,Werder Bremen,Bundesliga,27,1995,11.0,10,7,2,4,4,5,16,31.3,11,8,2,6,2,12,10
346,Gennaro Borrelli,it,FW,,Frosinone,Serie A,23,2000,0.3,0,0,0,0,0,0,0,,0,0,0,0,0,0,0
347,Adri Bosch,es,DF,,Granada,La Liga,22,2001,0.3,1,1,1,0,0,0,0,,0,0,0,0,0,1,1
348,Erik Botheim,no,FW,MF,Salernitana,Serie A,23,2000,3.5,2,0,2,0,0,0,1,0.0,1,3,0,3,0,2,2
349,Sven Botman,nl,DF,,Newcastle Utd,Premier League,23,2000,15.3,20,13,14,6,0,8,13,61.5,5,20,16,4,9,29,61
350,Saïmon Bouabré,fr,MF,,Monaco,Ligue 1,17,2006,0.5,2,2,0,2,0,1,2,50.0,1,1,0,1,0,2,0
351,Ayyoub Bouaddi,fr,MF,,Lille,Ligue 1,15,2007,1.5,6,2,6,0,0,2,5,40.0,3,2,0,2,1,7,3
352,Badredine Bouanani,dz,FW,,Nice,Ligue 1,18,2004,1.8,3,2,1,1,1,3,4,75.0,1,5,0,5,3,6,0
353,Badredine Bouanani,dz,MF,,Lorient,Ligue 1,18,2004,4.9,4,2,1,1,2,2,4,50.0,2,3,0,3,2,6,3
354,Mohamed Bouchenna,fr,MF,FW,Clermont Foot,Ligue 1,17,2006,0.3,1,0,1,0,0,0,0,,0,0,0,0,0,1,0
355,Hicham Boudaoui,dz,MF,,Nice,Ligue 1,23,1999,17.9,41,19,16,22,3,21,30,70.0,9,15,1,14,11,52,15
356,Yassine Bounou,ma,GK,,Sevilla,La Liga,32,1991,1.0,0,0,0,0,0,0,0,,0,0,0,0,0,0,0
357,Mehdi Bourabia,ma,MF,,Frosinone,Serie A,31,1991,2.2,5,4,1,4,0,2,4,50.0,2,3,0,3,0,5,4
358,Benjamin Bourigeaud,fr,MF,FW,Rennes,Ligue 1,29,1994,26.9,31,18,14,9,8,13,44,29.5,31,31,2,29,22,53,39
359,Bilal Boutobba,fr,FW,MF,Clermont Foot,Ligue 1,24,1998,10.3,22,12,6,10,6,10,23,43.5,13,9,0,9,8,30,3
360,Hugo Boutsingkham,fr,MF,FW,Nantes,Ligue 1,20,2003,0.1,0,0,0,0,0,0,0,,0,0,0,0,0,0,1
361,Edoardo Bove,it,MF,,Roma,Serie A,21,2002,19.8,60,31,16,31,13,27,46,58.7,19,21,1,20,11,71,11
362,Jarrod Bowen,eng,FW,,West Ham,Premier League,26,1996,33.5,42,28,14,14,14,13,35,37.1,22,37,5,32,19,61,14
363,Lucas Boyé,ar,FW,,Granada,La Liga,27,1996,28.2,50,25,14,25,11,14,34,41.2,20,35,5,30,10,60,46
364,Domagoj Bradarić,hr,DF,,Salernitana,Serie A,23,1999,30.5,29,20,13,10,6,15,25,60.0,10,22,7,15,32,61,62
365,Conor Bradley,nir,DF,,Liverpool,Premier League,20,2003,8.4,33,25,14,12,7,24,38,63.2,14,17,1,16,10,43,14
366,Bilal Brahimi,dz,FW,,Nice,Ligue 1,23,2000,0.1,0,0,0,0,0,0,1,0.0,1,0,0,0,0,0,0
367,Bilal Brahimi,dz,FW,MF,Brest,Ligue 1,23,2000,2.5,0,0,0,0,0,0,3,0.0,3,3,0,3,0,0,0
368,Julian Brandt,de,MF,FW,Dortmund,Bundesliga,27,1996,24.7,17,14,8,8,1,10,27,37.0,17,20,3,17,8,25,18
369,Jarrad Branthwaite,eng,DF,,Everton,Premier League,21,2002,34.6,66,32,42,22,2,45,62,72.6,17,51,36,15,50,116,163
370,Darko Brašanac,rs,MF,,Osasuna,La Liga,31,1992,0.5,1,0,1,0,0,1,1,100.0,0,1,0,1,0,1,0
371,Lilian Brassier,fr,DF,,Brest,Ligue 1,23,1999,29.7,31,18,18,13,0,12,24,50.0,12,28,21,7,41,72,93
372,Brau,es,DF,,Granada,La Liga,21,2001,0.3,1,0,1,0,0,1,1,100.0,0,0,0,0,0,1,2
373,Claudio Bravo,cl,GK,,Betis,La Liga,40,1983,7.0,0,0,0,0,0,0,1,0.0,1,0,0,0,0,0,2
374,Fabian Bredlow,de,GK,,Stuttgart,Bundesliga,28,1995,4.0,0,0,0,0,0,0,1,0.0,1,0,0,0,0,0,3
375,Tim Breithaupt,de,MF,,Augsburg,Bundesliga,21,2002,7.0,20,11,11,9,0,13,21,61.9,8,15,3,12,8,28,10
376,Josip Brekalo,hr,FW,,Fiorentina,Serie A,25,1998,7.2,8,6,6,2,0,2,11,18.2,9,7,0,7,1,9,0
377,Gleison Bremer,br,DF,,Juventus,Serie A,26,1997,35.9,58,42,32,21,5,21,29,72.4,8,45,27,18,40,98,147
378,Brenner,br,MF,FW,Udinese,Serie A,23,2000,2.1,8,7,1,5,2,4,7,57.1,3,2,0,2,0,8,2
379,Ben Brereton,cl,FW,MF,Sheffield Utd,Premier League,24,1999,12.3,9,4,4,4,1,4,10,40.0,6,9,3,6,3,12,12
380,Ben Brereton,cl,FW,MF,Villarreal,La Liga,24,1999,3.0,2,2,1,0,1,0,2,0.0,2,0,0,0,0,2,0
381,Marco Brescianini,it,MF,,Frosinone,Serie A,23,2000,25.8,28,13,13,12,3,9,25,36.0,16,22,5,17,10,38,37
382,Maximilian Breunig,de,FW,,Freiburg,Bundesliga,22,2000,0.1,0,0,0,0,0,0,0,,0,1,0,1,0,0,0
383,Rhian Brewster,eng,FW,MF,Sheffield Utd,Premier League,23,2000,3.8,5,1,1,2,2,0,2,0.0,2,2,0,2,1,6,2
384,Bennit Bröger,de,FW,,Wolfsburg,Bundesliga,17,2006,0.1,0,0,0,0,0,0,0,,0,0,0,0,0,0,0
385,Armando Broja,al,FW,,Chelsea,Premier League,21,2001,5.0,3,0,0,1,2,1,2,50.0,1,5,1,4,0,3,3
386,Armando Broja,al,FW,,Fulham,Premier League,21,2001,1.0,0,0,0,0,0,0,0,,0,1,0,1,0,0,0
387,Dylan Bronn,tn,DF,MF,Salernitana,Serie A,28,1995,0.6,0,0,0,0,0,0,1,0.0,1,2,0,2,0,0,4
388,Andre Brooks,eng,MF,DF,Sheffield Utd,Premier League,19,2003,10.4,22,13,7,11,4,9,21,42.9,12,13,1,12,14,36,20
389,David Brooks,wls,FW,MF,Bournemouth,Premier League,26,1997,3.1,5,4,2,1,2,2,4,50.0,2,3,0,3,2,7,2
390,John Brooks,us,DF,,Hoffenheim,Bundesliga,30,1993,17.1,28,15,17,10,1,15,30,50.0,15,29,17,12,27,55,109
391,Moritz Broschinski,de,FW,,Bochum,Bundesliga,22,2000,13.9,11,7,2,5,4,2,8,25.0,6,11,2,9,0,11,6
392,Jacob Brown,sct,MF,FW,Luton Town,Premier League,25,1998,11.3,19,12,7,7,5,7,18,38.9,11,20,1,19,8,27,22
393,Josh Brownhill,eng,MF,,Burnley,Premier League,27,1995,25.0,61,35,23,28,10,27,37,73.0,10,33,8,25,34,95,40
394,Alexander Brunst,de,GK,,Darmstadt 98,Bundesliga,28,1995,3.0,0,0,0,0,0,0,2,0.0,2,0,0,0,0,0,2
395,Jacob Bruun Larsen,dk,MF,FW,Burnley,Premier League,24,1998,13.9,9,4,4,3,2,7,21,33.3,14,16,2,14,7,16,23
396,Tajon Buchanan,ca,DF,,Inter,Serie A,24,1999,1.8,1,1,0,0,1,1,2,50.0,1,1,0,1,0,1,4
397,Ante Budimir,hr,FW,,Osasuna,La Liga,32,1991,27.1,21,15,2,11,8,5,14,35.7,9,19,5,14,5,26,18
398,Hugo Bueno,es,DF,MF,Wolves,Premier League,20,2002,8.2,21,14,12,7,2,12,19,63.2,7,17,4,13,6,27,24
399,Manu Bueno,es,MF,,Sevilla,La Liga,19,2004,1.3,4,2,4,0,0,3,3,100.0,0,3,0,3,0,4,1
400,Santiago Bueno,uy,DF,,Wolves,Premier League,24,1998,9.1,13,7,5,7,1,5,11,45.5,6,22,12,10,6,19,33
401,Marius Bülter,de,DF,FW,Hoffenheim,Bundesliga,30,1993,15.0,18,11,9,5,4,12,23,52.2,11,17,3,14,10,28,20
402,Facundo Buonanotte,ar,FW,MF,Brighton,Premier League,18,2004,15.2,42,22,13,22,7,14,44,31.8,30,22,3,19,8,50,5
403,Alessandro Buongiorno,it,DF,,Torino,Serie A,24,1999,28.1,70,39,43,24,3,24,34,70.6,10,20,12,8,69,139,131
404,Jonathan Burkardt,de,FW,MF,Mainz 05,Bundesliga,23,2000,17.1,12,8,2,6,4,4,11,36.4,7,16,3,13,3,15,2
405,Oliver Burke,sct,FW,,Werder Bremen,Bundesliga,26,1997,0.4,0,0,0,0,0,0,2,0.0,2,0,0,0,0,0,0
406,Reece Burke,eng,DF,,Luton Town,Premier League,26,1996,18.4,37,23,17,14,6,12,26,46.2,14,25,18,7,18,55,78
407,Dan Burn,eng,DF,,Newcastle Utd,Premier League,31,1992,30.3,61,33,37,20,4,26,61,42.6,35,55,25,30,37,98,124
408,Rareș-Cătălin Burnete,ro,FW,,Lecce,Serie A,19,2004,0.1,0,0,0,0,0,0,0,,0,0,0,0,0,0,0
409,Mason Burstow,eng,FW,,Chelsea,Premier League,19,2003,0.1,0,0,0,0,0,0,0,,0,0,0,0,0,0,0
410,Marnon Busch,de,DF,,Heidenheim,Bundesliga,28,1994,6.6,11,9,6,3,2,7,12,58.3,5,9,2,7,10,21,12
411,Maxime Busi,be,FW,DF,Reims,Ligue 1,23,1999,1.8,2,0,0,1,1,0,2,0.0,2,6,1,5,4,6,5
412,Pablo Busto,es,DF,,Betis,La Liga,17,2005,0.5,1,1,0,0,1,1,1,100.0,0,0,0,0,1,2,3
413,Aurélio Buta,pt,DF,MF,Eint Frankfurt,Bundesliga,26,1997,19.4,40,25,19,16,5,21,38,55.3,17,24,5,19,15,55,36
414,Marcin Bułka,pl,GK,,Nice,Ligue 1,23,1999,34.0,0,0,0,0,0,0,2,0.0,2,0,0,0,0,0,9
415,Rémy Cabella,fr,FW,MF,Lille,Ligue 1,33,1990,16.4,54,36,19,20,15,20,54,37.0,34,32,0,32,5,59,5
416,Jovane Cabral,cv,MF,FW,Salernitana,Serie A,25,1998,7.5,13,9,4,7,2,3,9,33.3,6,3,0,3,1,14,4
417,Liberato Cacace,nz,DF,,Empoli,Serie A,22,2000,21.2,40,24,24,13,3,24,38,63.2,14,23,6,17,19,59,56
418,Anthony Caci,fr,DF,,Mainz 05,Bundesliga,26,1997,27.6,56,23,30,25,1,27,44,61.4,17,43,7,36,32,88,45
419,Moisés Caicedo,ec,MF,,Chelsea,Premier League,21,2001,31.8,91,46,38,42,11,36,60,60.0,24,59,25,34,37,128,44
420,Tom Cairney,sct,MF,,Fulham,Premier League,32,1991,16.5,24,16,10,12,2,13,25,52.0,12,16,4,12,13,37,6
421,Jens Cajuste,se,MF,,Napoli,Serie A,23,1999,11.3,36,24,13,17,6,20,37,54.1,17,20,3,17,4,40,15
422,Davide Calabria,it,DF,,Milan,Serie A,26,1996,24.3,70,38,38,25,7,44,72,61.1,28,26,7,19,24,94,49
423,Riccardo Calafiori,it,DF,,Bologna,Serie A,21,2002,26.1,47,32,28,16,3,22,32,68.8,10,38,13,25,50,97,74
424,Mattia Caldara,it,DF,,Milan,Serie A,29,1994,0.4,1,1,1,0,0,1,1,100.0,0,1,1,0,1,2,1
425,Luca Caldirola,it,DF,,Monza,Serie A,32,1991,23.8,25,14,19,4,2,13,22,59.1,9,26,17,9,29,54,53
426,Duje Ćaleta-Car,hr,DF,,Lyon,Ligue 1,26,1996,22.1,26,11,19,6,1,18,22,81.8,4,27,14,13,18,44,94
427,Hakan Çalhanoğlu,tr,MF,,Inter,Serie A,29,1994,28.4,66,33,29,29,8,32,49,65.3,17,29,13,16,24,90,22
428,José Callejón,es,MF,FW,Granada,La Liga,36,1987,8.9,13,6,10,3,0,8,22,36.4,14,7,1,6,5,18,10
429,Dominic Calvert-Lewin,eng,FW,,Everton,Premier League,26,1997,24.1,13,6,2,6,5,2,15,13.3,13,14,4,10,4,17,38
430,Lamine Camara,sn,MF,,Metz,Ligue 1,19,2004,25.1,62,42,26,30,6,24,49,49.0,25,35,2,33,28,90,34
431,Mahdi Camara,fr,MF,,Brest,Ligue 1,25,1998,22.4,55,39,8,40,7,20,49,40.8,29,24,1,23,27,82,19
432,Mohamed Camara,ml,MF,,Monaco,Ligue 1,23,2000,11.5,35,21,10,20,5,15,29,51.7,14,8,2,6,11,46,7
433,Francesco Camarda,it,FW,,Milan,Serie A,15,2008,0.2,0,0,0,0,0,0,2,0.0,2,0,0,0,0,0,0
434,Eduardo Camavinga,fr,MF,DF,Real Madrid,La Liga,20,2002,20.2,76,47,39,29,8,23,39,59.0,16,36,8,28,29,105,29
435,Nicolò Cambiaghi,it,FW,MF,Empoli,Serie A,22,2000,28.4,51,39,15,20,16,16,35,45.7,19,26,1,25,14,65,8
436,Andrea Cambiaso,it,DF,FW,Juventus,Serie A,23,2000,26.4,47,30,23,15,9,25,43,58.1,18,28,3,25,11,58,26
437,Axel Camblan,fr,FW,,Brest,Ligue 1,19,2003,1.0,3,1,0,2,1,2,4,50.0,2,2,0,2,0,3,0
438,Sergio Camello,es,FW,,Rayo Vallecano,La Liga,22,2001,18.5,16,5,3,10,3,6,15,40.0,9,10,2,8,3,19,15
439,José Campaña,es,MF,,Las Palmas,La Liga,30,1993,1.9,2,2,1,1,0,0,2,0.0,2,3,2,1,2,4,3
440,Emre Can,de,MF,DF,Dortmund,Bundesliga,29,1994,21.7,63,45,37,23,3,28,48,58.3,20,30,7,23,22,85,41
441,Matteo Cancellieri,it,FW,MF,Empoli,Serie A,21,2002,19.9,35,22,12,16,7,13,36,36.1,23,19,0,19,6,41,18
442,João Cancelo,pt,DF,,Barcelona,La Liga,29,1994,27.8,64,44,35,21,8,38,58,65.5,20,35,6,29,29,93,59
443,Fali Candé,gw,DF,,Metz,Ligue 1,25,1998,20.5,40,19,31,9,0,20,35,57.1,15,41,28,13,20,60,107
444,Antonio Candreva,it,MF,FW,Salernitana,Serie A,36,1987,30.6,18,13,8,8,2,9,25,36.0,16,9,0,9,7,25,23
445,Thomas Cannon,ie,FW,,Everton,Premier League,20,2002,0.0,0,0,0,0,0,0,0,,0,0,0,0,0,0,0
446,Sergi Canós,es,MF,FW,Valencia,La Liga,26,1997,13.7,23,13,7,11,5,10,24,41.7,14,14,2,12,11,34,9
447,Luigi Canotto,it,FW,,Frosinone,Serie A,29,1994,0.2,0,0,0,0,0,0,0,,0,0,0,0,0,0,0
448,Gino Caoki,fr,MF,,Lorient,Ligue 1,19,2004,0.1,0,0,0,0,0,0,1,0.0,1,0,0,0,0,0,0
449,Étienne Capoue,fr,MF,,Villarreal,La Liga,35,1988,16.2,32,18,17,12,3,15,22,68.2,7,20,4,16,22,54,24
450,Gianluca Caprari,it,MF,FW,Monza,Serie A,30,1993,3.2,2,1,1,1,0,0,1,0.0,1,0,0,0,2,4,0
451,Elia Caprile,it,GK,,Empoli,Serie A,21,2001,23.0,1,0,1,0,0,1,1,100.0,0,0,0,0,0,1,16
452,Francesco Caputo,it,FW,,Empoli,Serie A,35,1987,14.1,2,0,0,0,2,0,1,0.0,1,4,0,4,1,3,3
453,Maxence Caqueret,fr,MF,,Lyon,Ligue 1,23,2000,33.6,91,64,39,37,15,38,107,35.5,69,40,9,31,48,139,26
454,Andrea Carboni,it,DF,,Monza,Serie A,22,2001,16.5,38,22,24,12,2,20,31,64.5,11,23,13,10,17,55,56
455,Valentin Carboni,ar,MF,FW,Monza,Serie A,18,2005,13.0,25,15,10,12,3,8,26,30.8,18,12,1,11,7,32,4
456,Isaac Carcelen,es,DF,,Cádiz,La Liga,30,1993,29.0,50,31,30,15,5,25,45,55.6,20,24,7,17,27,77,87
457,Cárdenas,es,GK,,Rayo Vallecano,La Liga,26,1997,1.0,0,0,0,0,0,0,0,,0,0,0,0,0,0,1
458,Irvin Cardona,fr,MF,DF,Augsburg,Bundesliga,25,1997,0.6,1,1,0,0,1,1,3,33.3,2,1,0,1,0,1,1
459,Marc Cardona,es,FW,,Las Palmas,La Liga,28,1995,8.2,9,8,3,4,2,1,12,8.3,11,5,0,5,2,11,7
460,Sergi Cardona,es,DF,,Las Palmas,La Liga,24,1999,31.3,90,55,52,29,9,55,96,57.3,41,45,7,38,46,136,102
461,Johnny Cardoso,us,MF,,Betis,La Liga,21,2001,14.8,48,29,19,24,5,22,33,66.7,11,20,5,15,32,80,31
462,Igor Carioca,br,DF,MF,Lorient,Ligue 1,26,1996,2.9,8,6,6,1,1,4,6,66.7,2,0,0,0,3,11,6
463,Diego Carlos,br,DF,,Aston Villa,Premier League,30,1993,20.2,27,16,22,4,1,13,21,61.9,8,24,19,5,13,40,78
464,Carmona,es,DF,MF,Getafe,La Liga,21,2002,14.6,30,21,13,14,3,9,28,32.1,19,15,2,13,21,51,25
465,Marco Carnesecchi,it,GK,,Atalanta,Serie A,23,2000,26.9,0,0,0,0,0,0,0,,0,0,0,0,0,0,22
466,Yannick Carrasco,be,DF,,Atlético Madrid,La Liga,29,1993,2.5,4,4,3,1,0,2,7,28.6,5,2,0,2,1,5,6
467,Álvaro Carreras,es,MF,FW,Granada,La Liga,20,2003,5.3,13,8,8,4,1,5,11,45.5,6,5,1,4,7,20,9
468,Rasmus Carstensen,dk,DF,FW,Köln,Bundesliga,22,2000,18.4,47,22,23,20,4,31,56,55.4,25,38,9,29,20,67,50
469,Antonin Cartillier,fr,DF,,Monaco,Ligue 1,19,2004,0.1,0,0,0,0,0,0,0,,0,1,0,1,0,0,0
470,Dani Carvajal,es,DF,,Real Madrid,La Liga,31,1992,24.1,47,32,28,15,4,23,42,54.8,19,28,9,19,22,69,54
471,Fabio Carvalho,pt,MF,,RB Leipzig,Bundesliga,20,2002,1.8,3,1,0,2,1,1,3,33.3,2,8,0,8,0,3,1
472,William Carvalho,pt,MF,,Betis,La Liga,31,1992,7.6,20,12,11,7,2,10,16,62.5,6,8,1,7,8,28,9
473,Cesare Casadei,it,FW,MF,Chelsea,Premier League,20,2003,0.9,5,3,2,1,2,2,5,40.0,3,1,0,1,0,5,4
474,Marc Casado,es,MF,,Barcelona,La Liga,19,2003,0.2,1,1,1,0,0,1,1,100.0,0,0,0,0,1,2,2
475,Nicolò Casale,it,DF,,Lazio,Serie A,25,1998,17.3,15,9,13,2,0,6,15,40.0,9,19,16,3,12,27,61
476,Casemiro,br,MF,DF,Manchester Utd,Premier League,31,1992,22.0,83,56,43,32,8,51,106,48.1,55,74,33,41,18,101,71
477,Kaelan Casey,eng,DF,,West Ham,Premier League,18,2004,0.0,0,0,0,0,0,0,0,,0,0,0,0,0,0,1
478,Matty Cash,pl,DF,,Aston Villa,Premier League,25,1997,23.8,54,31,24,24,6,29,59,49.2,30,35,14,21,18,72,59
479,Josué Casimir,fr,FW,DF,Le Havre,Ligue 1,21,2001,22.4,31,18,14,14,3,7,18,38.9,11,23,2,21,13,44,25
480,Giuseppe Caso,it,FW,MF,Frosinone,Serie A,24,1998,4.6,4,3,2,0,2,2,3,66.7,1,0,0,0,0,4,0
481,Cristian Cásseres Jr.,ve,MF,,Toulouse,Ligue 1,23,2000,21.6,70,34,31,33,6,29,61,47.5,32,34,4,30,27,97,33
482,Timothy Castagne,be,DF,,Fulham,Premier League,27,1995,29.3,49,24,23,16,10,26,44,59.1,18,38,10,28,38,87,69
483,Koen Casteels,be,GK,,Wolfsburg,Bundesliga,31,1992,25.0,2,1,2,0,0,2,3,66.7,1,0,0,0,0,2,16
484,Valentín Castellanos,ar,FW,,Lazio,Serie A,24,1998,18.7,22,10,1,12,9,6,20,30.0,14,22,2,20,2,24,18
485,Jean-Charles Castelletto,cm,DF,,Nantes,Ligue 1,28,1995,27.4,34,26,22,10,2,18,29,62.1,11,19,10,9,32,66,81
486,Samu Castillejo,es,FW,MF,Sassuolo,Serie A,28,1995,6.0,12,10,5,5,2,7,19,36.8,12,16,1,15,1,13,3
487,Jonny Castro,es,MF,,Wolves,Premier League,29,1994,0.1,0,0,0,0,0,0,1,0.0,1,1,1,0,0,0,0
488,Santiago Castro,ar,FW,,Bologna,Serie A,18,2004,2.7,2,1,0,1,1,1,3,33.3,2,1,0,1,1,3,1
489,Gaetano Castrovilli,it,FW,MF,Fiorentina,Serie A,26,1997,4.1,3,2,1,2,0,1,8,12.5,7,4,0,4,2,5,3
490,Danilo Cataldi,it,MF,,Lazio,Serie A,28,1994,15.1,24,12,7,16,1,8,18,44.4,10,15,7,8,17,41,19
491,Catena,es,DF,,Osasuna,La Liga,28,1994,28.2,33,18,26,6,1,19,35,54.3,16,24,15,9,15,48,119
492,Maximiliano Caufriez,be,DF,,Clermont Foot,Ligue 1,26,1997,18.4,38,28,31,5,2,19,29,65.5,10,18,12,6,18,56,69
493,Ivan Cavaleiro,pt,FW,,Lille,Ligue 1,29,1993,8.6,10,6,3,4,3,7,20,35.0,13,9,2,7,5,15,6
494,Dani Ceballos,es,MF,FW,Real Madrid,La Liga,26,1996,6.6,10,5,4,5,1,5,14,35.7,9,9,2,7,0,10,4
495,Emil Ceide,no,FW,MF,Sassuolo,Serie A,21,2001,2.0,2,2,1,1,0,1,1,100.0,0,6,1,5,0,2,0
496,Zeki Çelik,tr,DF,,Roma,Serie A,26,1997,7.5,23,16,10,10,3,14,25,56.0,11,12,5,7,8,31,25
497,Álex Centelles,es,DF,,Almería,La Liga,25,1997,10.9,11,6,9,2,0,8,18,44.4,10,5,2,3,18,29,29
498,Fabien Centonze,fr,DF,,Hellas Verona,Serie A,27,1996,7.5,14,8,10,4,0,5,10,50.0,5,14,2,12,10,24,18
499,Fabien Centonze,fr,DF,,Nantes,Ligue 1,27,1996,1.0,2,1,2,0,0,2,3,66.7,1,2,1,1,0,2,1
500,Václav Černý,cz,FW,MF,Wolfsburg,Bundesliga,25,1997,10.2,8,3,3,4,1,2,14,14.3,12,13,0,13,8,16,6
501,Michele Cerofolini,it,GK,,Frosinone,Serie A,24,1999,7.5,0,0,0,0,0,0,0,,0,0,0,0,0,0,5
502,Alberto Cerri,it,FW,,Empoli,Serie A,27,1996,6.1,3,3,1,1,1,2,5,40.0,3,3,1,2,3,6,7
503,Leonardo Cerri,it,DF,,Juventus,Serie A,20,2003,0.1,0,0,0,0,0,0,0,,0,0,0,0,0,0,0
504,Franco Cervi,ar,MF,DF,Celta Vigo,La Liga,29,1994,6.1,24,18,13,9,2,13,24,54.2,11,16,0,16,9,33,4
505,Julian Chabot,de,DF,,Köln,Bundesliga,25,1998,30.0,59,42,40,17,2,35,59,59.3,24,66,43,23,45,104,145
506,El Chadaille Bitshiabu,fr,DF,MF,RB Leipzig,Bundesliga,18,2005,0.4,1,0,1,0,0,0,0,,0,0,0,0,1,2,4
507,Fares Chaïbi,dz,FW,MF,Toulouse,Ligue 1,20,2002,0.6,0,0,0,0,0,0,0,,0,0,0,0,0,0,2
508,Fares Chaïbi,dz,MF,FW,Eint Frankfurt,Bundesliga,20,2002,21.2,27,17,7,12,8,8,18,44.4,10,37,1,36,5,32,19
509,Trevoh Chalobah,eng,DF,,Chelsea,Premier League,24,1999,10.6,16,12,10,2,4,10,15,66.7,5,8,7,1,8,24,51
510,Muhammed Cham,at,MF,FW,Clermont Foot,Ligue 1,22,2000,28.4,25,14,10,13,2,11,27,40.7,16,20,2,18,8,33,5
511,Calum Chambers,eng,MF,DF,Aston Villa,Premier League,28,1995,1.7,3,0,3,0,0,0,1,0.0,1,2,1,1,2,5,4
512,Timothy Chandler,us,MF,DF,Eint Frankfurt,Bundesliga,33,1990,0.2,0,0,0,0,0,0,0,,0,0,0,0,0,0,0
513,Brendan Chardonnet,fr,DF,,Brest,Ligue 1,28,1994,33.0,57,34,33,22,2,32,63,50.8,31,58,34,24,53,110,139
514,Charlys,br,MF,,Hellas Verona,Serie A,19,2004,0.3,0,0,0,0,0,0,0,,0,0,0,0,1,1,0
515,Pep Chavarría,es,DF,MF,Rayo Vallecano,La Liga,25,1998,13.0,23,18,15,6,2,11,17,64.7,6,15,3,12,6,29,29
516,Jhoanner Chávez,ec,DF,,Lens,Ligue 1,21,2002,5.3,6,5,2,2,2,3,9,33.3,6,2,0,2,5,11,11
517,Walid Cheddira,ma,FW,,Frosinone,Serie A,25,1998,23.6,12,7,1,8,3,4,8,50.0,4,6,1,5,5,17,10
518,Rayan Cherki,fr,MF,FW,Lyon,Ligue 1,19,2003,19.1,28,15,4,16,8,17,46,37.0,29,13,3,10,7,35,1
519,Youssef Chermiti,pt,FW,,Everton,Premier League,19,2004,2.3,3,2,2,1,0,1,5,20.0,4,4,1,3,1,4,2
520,Lucas Chevalier,fr,GK,,Lille,Ligue 1,21,2001,33.0,3,0,3,0,0,3,4,75.0,1,1,0,1,0,3,11
521,Fabio Chiarodia,it,DF,,Gladbach,Bundesliga,18,2005,1.7,8,5,5,1,2,5,7,71.4,2,2,1,1,3,11,9
522,Federico Chiesa,it,FW,,Juventus,Serie A,25,1997,24.4,20,10,7,6,7,3,13,23.1,10,17,1,16,6,26,4
523,Ben Chilwell,eng,DF,,Chelsea,Premier League,26,1996,8.4,15,10,5,9,1,5,8,62.5,3,11,3,8,4,19,19
524,Tawanda Chirewa,zw,MF,FW,Wolves,Premier League,19,2003,1.6,7,3,3,3,1,2,3,66.7,1,0,0,0,1,8,0
525,Pedro Chirivella,es,MF,,Nantes,Ligue 1,26,1997,28.8,50,28,20,29,1,30,76,39.5,46,22,5,17,31,81,28
526,Leon Chiwome,eng,FW,,Wolves,Premier League,17,2006,1.9,2,1,0,1,1,1,2,50.0,1,3,1,2,0,2,2
527,Tahith Chong,nl,MF,FW,Luton Town,Premier League,23,1999,22.0,36,22,19,13,4,15,33,45.5,18,30,6,24,8,44,11
528,Joris Chotard,fr,MF,,Montpellier,Ligue 1,21,2001,28.7,81,52,45,25,11,48,96,50.0,48,47,21,26,44,125,60
529,Andreas Christensen,dk,DF,MF,Barcelona,La Liga,27,1996,22.0,23,14,7,14,2,16,28,57.1,12,23,10,13,21,44,41
530,Jacob Christensen,dk,MF,,Köln,Bundesliga,22,2001,2.4,10,6,7,3,0,4,7,57.1,3,8,2,6,4,14,4
531,Oliver Christensen,dk,GK,,Fiorentina,Serie A,24,1999,4.0,0,0,0,0,0,0,0,,0,0,0,0,0,0,1
532,Ryan Christie,sct,MF,,Bournemouth,Premier League,28,1995,32.3,86,44,34,35,17,39,92,42.4,53,52,11,41,52,138,53
533,Carney Chukwuemeka,eng,MF,FW,Chelsea,Premier League,19,2003,2.5,6,4,3,3,0,1,3,33.3,2,1,1,0,0,6,1
534,Samuel Chukwueze,ng,FW,,Milan,Serie A,24,1999,11.3,18,7,11,5,2,9,17,52.9,8,3,1,2,6,24,3
535,Chumi,es,DF,,Almería,La Liga,24,1999,27.0,34,22,22,12,0,16,26,61.5,10,38,23,15,14,48,107
536,Víctor Chust,es,DF,,Cádiz,La Liga,23,2000,20.7,29,18,23,5,1,18,32,56.3,14,27,21,6,11,40,92
537,Pathé Ciss,sn,MF,,Rayo Vallecano,La Liga,29,1994,18.5,44,24,16,26,2,16,29,55.2,13,27,10,17,30,74,54
538,Alphadjo Cissè,it,FW,,Hellas Verona,Serie A,16,2006,0.1,0,0,0,0,0,0,0,,0,0,0,0,0,0,0
539,Djaoui Cissé,fr,MF,,Rennes,Ligue 1,19,2004,0.0,0,0,0,0,0,0,0,,0,0,0,0,0,0,0
540,Ibrahim Cissoko,nl,FW,MF,Toulouse,Ligue 1,20,2003,2.7,4,3,3,1,0,1,3,33.3,2,3,0,3,1,5,0
541,Giorgio Cittadini,it,DF,,Monza,Serie A,21,2002,0.2,1,1,1,0,0,1,1,100.0,0,1,1,0,0,1,0
542,Giorgio Cittadini,it,DF,,Genoa,Serie A,21,2002,1.2,5,4,4,1,0,3,3,100.0,0,1,0,1,3,8,5
543,Patrick Ciurria,it,DF,MF,Monza,Serie A,28,1995,17.8,30,18,13,13,4,13,21,61.9,8,20,5,15,9,39,28
544,Bobby Clark,eng,MF,,Liverpool,Premier League,18,2005,1.0,2,1,1,1,0,1,5,20.0,4,6,2,4,1,3,1
545,Jordan Clark,eng,MF,,Luton Town,Premier League,29,1993,14.5,30,17,14,11,5,11,39,28.2,28,24,3,21,11,41,15
546,Alexis Claude-Maurice,fr,MF,,Nice,Ligue 1,25,1998,5.6,12,5,3,6,3,1,5,20.0,4,4,1,3,5,17,7
547,Jonathan Clauss,fr,DF,,Marseille,Ligue 1,30,1992,23.0,47,20,22,19,6,26,49,53.1,23,17,3,14,36,83,46
548,Silvi Clúa,es,MF,,Girona,La Liga,18,2005,0.0,2,0,2,0,0,2,2,100.0,0,1,0,1,0,2,0
549,Nathaniel Clyne,eng,DF,,Crystal Palace,Premier League,32,1991,14.9,24,15,11,11,2,14,21,66.7,7,18,6,12,10,34,33
550,Marcus Coco,fr,DF,FW,Nantes,Ligue 1,27,1996,16.5,43,26,29,10,4,28,60,46.7,32,19,1,18,21,64,38
551,Saúl Coco,gq,DF,,Las Palmas,La Liga,24,1999,25.5,32,19,25,7,0,11,18,61.1,7,27,15,12,20,52,120
552,Séamus Coleman,ie,DF,,Everton,Premier League,34,1988,7.4,17,14,10,3,4,11,16,68.8,5,12,4,8,7,24,26
553,Maxime Colin,fr,DF,,Metz,Ligue 1,31,1991,20.4,39,23,25,7,7,16,29,55.2,13,22,7,15,20,59,71
554,Nathan Collins,ie,DF,,Brentford,Premier League,22,2001,29.5,38,20,24,12,2,19,29,65.5,10,46,30,16,44,82,141
555,Nnamdi Collins,de,DF,,Eint Frankfurt,Bundesliga,19,2004,1.0,0,0,0,0,0,0,0,,0,0,0,0,2,2,4
556,Lorenzo Colombo,it,FW,,Monza,Serie A,21,2002,15.1,17,12,3,9,5,8,14,57.1,6,18,5,13,0,17,14
557,Andrea Colpani,it,MF,FW,Monza,Serie A,24,1999,29.5,25,15,6,13,6,11,20,55.0,9,11,4,7,14,39,14
558,Levi Colwill,eng,DF,,Chelsea,Premier League,20,2003,20.0,48,30,26,17,5,26,34,76.5,8,28,10,18,26,74,66
559,Kingsley Coman,fr,FW,,Bayern Munich,Bundesliga,27,1996,12.4,12,7,5,3,4,9,17,52.9,8,15,1,14,2,14,5
560,Eray Cömert,ch,DF,,Nantes,Ligue 1,25,1998,22.2,42,28,28,13,1,28,38,73.7,10,35,18,17,36,78,77
561,Santi Comesaña,es,MF,,Villarreal,La Liga,26,1996,18.4,44,26,15,21,8,19,38,50.0,19,33,9,24,22,66,27
562,Pietro Comuzzo,it,DF,FW,Fiorentina,Serie A,18,2005,0.5,1,1,1,0,0,1,1,100.0,0,1,0,1,1,2,2
563,Alois Confais,fr,MF,FW,Le Havre,Ligue 1,26,1996,0.1,2,2,1,1,0,1,1,100.0,0,0,0,0,0,2,0
564,Andrea Consigli,it,GK,,Sassuolo,Serie A,36,1987,35.0,0,0,0,0,0,0,0,,0,1,0,1,1,1,19
565,Bambasé Conté,de,MF,FW,Hoffenheim,Bundesliga,20,2003,0.5,3,3,2,0,1,1,1,100.0,0,0,0,0,0,3,0
566,Nikita Contini Baranovsky,it,GK,,Napoli,Serie A,27,1996,0.2,0,0,0,0,0,0,0,,0,0,0,0,0,0,1
567,Lewis Cook,eng,MF,,Bournemouth,Premier League,26,1997,31.0,61,41,24,30,7,34,63,54.0,29,32,11,21,65,126,46
568,Copete,es,DF,,Mallorca,La Liga,23,1999,14.8,45,27,27,17,1,30,43,69.8,13,12,6,6,32,77,47
569,Diego Coppola,it,DF,,Hellas Verona,Serie A,19,2003,18.2,36,22,25,9,2,20,33,60.6,13,26,9,17,27,63,89
570,Francis Coquelin,fr,MF,,Villarreal,La Liga,32,1991,10.1,20,12,8,10,2,5,13,38.5,8,14,4,10,16,36,15
571,Tommaso Corazza,it,DF,,Bologna,Serie A,19,2004,2.2,10,4,9,1,0,4,9,44.4,5,2,0,2,5,15,3
572,Theo Corbeanu,ca,MF,FW,Granada,La Liga,21,2002,2.0,5,2,2,3,0,1,3,33.3,2,3,0,3,3,8,2
573,Jeppe Corfitzen,dk,FW,,Lecce,Serie A,18,2004,0.1,1,0,0,1,0,1,1,100.0,0,0,0,0,0,1,0
574,Jack Cork,eng,MF,,Burnley,Premier League,34,1989,0.3,2,0,0,2,0,1,3,33.3,2,0,0,0,1,3,1
575,Maxwel Cornet,ci,MF,FW,West Ham,Premier League,26,1996,1.2,3,2,3,0,0,1,5,20.0,4,2,0,2,2,5,1
576,Giacomo Corona,it,FW,,Empoli,Serie A,19,2004,0.1,0,0,0,0,0,0,0,,0,0,0,0,0,0,0
577,Jesús Corona,mx,MF,DF,Sevilla,La Liga,30,1993,0.2,0,0,0,0,0,0,0,,0,0,0,0,1,1,0
578,Ángel Correa,ar,FW,MF,Atlético Madrid,La Liga,28,1995,17.0,22,15,3,11,8,5,17,29.4,12,13,0,13,2,24,6
579,Joaquín Correa,ar,FW,MF,Marseille,Ligue 1,28,1994,4.8,7,5,4,2,1,0,8,0.0,8,2,0,2,1,8,1
580,Thierry Correia,pt,DF,,Valencia,La Liga,24,1999,23.9,63,35,39,20,4,28,49,57.1,21,39,16,23,33,96,61
581,Oscar Cortés,co,FW,MF,Lens,Ligue 1,19,2003,0.5,0,0,0,0,0,0,0,,0,1,0,1,0,0,0
582,Danny da Costa,de,DF,,Mainz 05,Bundesliga,30,1993,9.2,18,9,9,7,2,9,19,47.4,10,17,4,13,16,34,24
583,David Costa,pt,MF,,Lens,Ligue 1,22,2001,16.6,18,10,5,12,1,10,23,43.5,13,21,4,17,16,34,8
584,Jaume Costa,es,DF,,Mallorca,La Liga,35,1988,18.7,38,22,23,10,5,18,29,62.1,11,14,4,10,16,54,35
585,João Costa,br,MF,FW,Roma,Serie A,18,2005,0.2,0,0,0,0,0,0,0,,0,0,0,0,0,0,0
586,Logan Costa,cv,DF,,Toulouse,Ligue 1,22,2001,29.4,40,24,31,9,0,15,24,62.5,9,42,27,15,23,63,120
587,Samu Costa,pt,MF,,Mallorca,La Liga,22,2000,25.6,91,50,40,46,5,46,93,49.5,47,28,14,14,39,130,59
588,Benoît Costil,fr,GK,,Salernitana,Serie A,36,1987,13.0,2,1,1,1,0,2,3,66.7,1,0,0,0,0,2,5
589,Grégoire Coudert,fr,GK,,Brest,Ligue 1,24,1999,2.0,0,0,0,0,0,0,0,,0,0,0,0,0,0,0
590,Vladimír Coufal,cz,DF,,West Ham,Premier League,30,1992,34.8,64,41,50,12,2,38,75,50.7,37,49,15,34,43,107,97
591,Lassana Coulibaly,ml,MF,,Salernitana,Serie A,27,1996,23.1,47,32,20,21,6,22,49,44.9,27,23,5,18,16,63,29
592,Mamadou Coulibaly,sn,DF,,Salernitana,Serie A,24,1999,0.0,0,0,0,0,0,0,0,,0,0,0,0,0,0,0
593,Mamadou Coulibaly,fr,MF,,Monaco,Ligue 1,19,2004,1.3,7,4,2,3,2,3,8,37.5,5,4,0,4,0,7,0
594,Tanguy Coulibaly,fr,FW,MF,Montpellier,Ligue 1,22,2001,6.9,13,11,8,4,1,4,9,44.4,5,11,1,10,2,15,2
595,Thibaut Courtois,be,GK,,Real Madrid,La Liga,31,1992,3.7,1,0,1,0,0,0,0,,0,0,0,0,0,1,0
596,Philippe Coutinho,br,MF,FW,Aston Villa,Premier League,31,1992,0.3,0,0,0,0,0,0,1,0.0,1,0,0,0,0,0,0
597,Yan Couto,br,DF,FW,Girona,La Liga,21,2002,24.9,45,34,25,14,6,20,40,50.0,20,14,2,12,10,55,31
598,Nicolas Cozza,fr,DF,,Nantes,Ligue 1,24,1999,9.9,35,23,23,10,2,17,24,70.8,7,7,0,7,14,49,32
599,Nicolas Cozza,fr,DF,,Wolfsburg,Bundesliga,24,1999,3.1,8,6,4,4,0,2,7,28.6,5,3,0,3,4,12,6
600,Alessio Cragno,it,GK,,Sassuolo,Serie A,29,1994,3.0,0,0,0,0,0,0,0,,0,0,0,0,0,0,3
601,Crespo,pt,MF,,Rayo Vallecano,La Liga,26,1996,5.9,16,9,8,6,2,9,17,52.9,8,15,6,9,10,26,7
602,Aaron Cresswell,eng,DF,FW,West Ham,Premier League,33,1989,4.8,3,2,1,1,1,2,3,66.7,1,5,3,2,3,6,7
603,Bryan Cristante,it,MF,DF,Roma,Serie A,28,1995,36.5,72,41,33,28,11,28,50,56.0,22,36,6,30,25,97,55
604,Cristian,es,GK,,Valencia,La Liga,25,1998,0.6,0,0,0,0,0,0,0,,0,0,0,0,0,0,0
605,Juan Cruz Armada,es,DF,,Osasuna,La Liga,31,1992,18.5,27,15,16,10,1,17,25,68.0,8,14,7,7,12,39,39
606,Juan Cruz,ar,FW,MF,Hellas Verona,Serie A,24,1999,1.2,2,2,0,0,2,0,0,,0,1,0,1,1,3,0
607,Juan Cruz,es,FW,,Betis,La Liga,23,2000,0.8,0,0,0,0,0,0,1,0.0,1,0,0,0,0,0,0
608,Juan Cuadrado,co,DF,,Inter,Serie A,35,1988,3.0,4,3,2,2,0,3,5,60.0,2,6,1,5,1,5,2
609,Pau Cubarsí,es,DF,,Barcelona,La Liga,16,2007,17.3,22,14,18,3,1,13,18,72.2,5,20,16,4,12,34,65
610,Marc Cucurella,es,DF,,Chelsea,Premier League,25,1998,19.8,62,38,36,21,5,34,64,53.1,30,36,13,23,22,84,48
611,Iván Cuéllar,es,GK,,Mallorca,La Liga,39,1984,1.0,0,0,0,0,0,0,0,,0,0,0,0,0,0,0
612,Jorge Cuenca,es,DF,,Villarreal,La Liga,23,1999,21.8,42,29,26,10,6,19,30,63.3,11,26,15,11,21,63,114
613,Josh Cullen,ie,MF,,Burnley,Premier League,27,1996,22.9,42,29,15,22,5,26,46,56.5,20,31,19,12,15,57,26
614,Matheus Cunha,br,FW,MF,Wolves,Premier League,24,1999,27.1,30,16,8,17,5,13,35,37.1,22,28,7,21,13,43,21
615,Marvin Cuni,al,FW,,Frosinone,Serie A,22,2001,5.9,8,3,1,3,4,3,4,75.0,1,10,1,9,1,9,0
616,Eric Curbelo,es,DF,MF,Las Palmas,La Liga,29,1994,1.1,4,3,2,2,0,3,4,75.0,1,3,1,2,2,6,5
617,Sam Curtis,ie,DF,,Sheffield Utd,Premier League,17,2005,0.3,1,0,1,0,0,1,2,50.0,1,2,0,2,0,1,0
618,Tomáš Čvančara,cz,FW,,Gladbach,Bundesliga,22,2000,10.0,4,3,0,2,2,1,3,33.3,2,5,1,4,2,6,8
619,Danilo D'Ambrosio,it,DF,,Monza,Serie A,34,1988,17.1,57,34,34,20,3,28,41,68.3,13,22,13,9,14,71,31
620,Alberto Dadie,es,MF,,Real Sociedad,La Liga,21,2002,0.3,2,1,2,0,0,0,0,,0,1,0,1,0,2,0
621,Trévis Dago,ci,FW,MF,Lille,Ligue 1,18,2005,0.3,0,0,0,0,0,0,0,,0,0,0,0,1,1,0
622,Finn Dahmen,de,GK,,Augsburg,Bundesliga,25,1998,31.0,1,0,1,0,0,1,3,33.3,2,0,0,0,0,1,17
623,Mahmoud Dahoud,de,MF,,Brighton,Premier League,27,1996,5.0,9,4,2,4,3,3,9,33.3,6,4,1,3,1,10,5
624,Mahmoud Dahoud,de,MF,,Stuttgart,Bundesliga,27,1996,2.5,5,1,1,4,0,3,7,42.9,4,4,0,4,0,5,1
625,Ameen Al-Dakhil,be,DF,,Burnley,Premier League,21,2002,11.7,12,5,4,7,1,1,10,10.0,9,13,6,7,12,24,38
626,Thijs Dallinga,nl,FW,,Toulouse,Ligue 1,22,2000,27.9,29,15,6,11,12,9,15,60.0,6,11,4,7,3,32,35
627,Diogo Dalot,pt,DF,,Manchester Utd,Premier League,24,1999,35.3,81,51,58,12,11,51,74,68.9,23,44,16,28,37,118,111
628,Mikkel Damsgaard,dk,MF,,Brentford,Premier League,23,2000,9.4,29,17,13,9,7,14,40,35.0,26,23,1,22,11,40,10
629,Flavius Daniliuc,at,DF,,Salernitana,Serie A,22,2001,8.3,19,11,12,5,2,9,19,47.4,10,13,4,9,8,27,15
630,Danilo,br,MF,,Nott'ham Forest,Premier League,22,2001,19.9,36,18,22,12,2,21,46,45.7,25,33,8,25,35,71,42
631,Danilo,br,DF,,Juventus,Serie A,32,1991,27.2,60,36,38,18,4,32,48,66.7,16,34,15,19,37,97,94
632,Arnaut Danjuma,nl,MF,FW,Everton,Premier League,26,1997,6.6,6,4,2,3,1,1,4,25.0,3,4,0,4,3,9,0
633,Jayden Danns,eng,FW,,Liverpool,Premier League,17,2006,0.1,0,0,0,0,0,0,0,,0,0,0,0,0,0,0
634,Kevin Danso,at,DF,,Lens,Ligue 1,24,1998,29.5,24,14,12,11,1,15,30,50.0,15,43,30,13,23,47,115
635,Dante,br,DF,,Nice,Ligue 1,39,1983,31.6,62,30,44,16,2,38,52,73.1,14,43,22,21,37,99,77
636,Raimane Daou,km,DF,MF,Marseille,Ligue 1,18,2004,0.3,1,1,1,0,0,1,2,50.0,1,0,0,0,0,1,2
637,Mohammed Daramy,dk,FW,MF,Reims,Ligue 1,21,2002,18.3,10,9,4,4,2,6,16,37.5,10,5,1,4,4,14,4
638,Sergi Darder,es,MF,,Mallorca,La Liga,29,1993,24.0,39,26,13,21,5,12,31,38.7,19,20,4,16,16,55,16
639,Achraf Dari,ma,DF,FW,Brest,Ligue 1,24,1999,1.3,1,1,1,0,0,0,2,0.0,2,2,0,2,5,6,9
640,Matteo Darmian,it,DF,,Inter,Serie A,33,1989,26.7,48,22,23,15,10,20,53,37.7,33,27,11,16,13,61,55
641,Lukas Daschner,de,MF,FW,Bochum,Bundesliga,24,1998,6.0,9,4,2,3,4,4,9,44.4,5,7,0,7,2,11,2
642,Josh Dasilva,eng,DF,FW,Brentford,Premier League,24,1998,0.3,2,1,0,1,1,0,0,,0,0,0,0,0,2,0
643,David Datro Fofana,ci,FW,,Burnley,Premier League,20,2002,9.8,10,5,3,5,2,3,6,50.0,3,9,3,6,1,11,2
644,David Datro Fofana,ci,FW,MF,Union Berlin,Bundesliga,20,2002,7.6,10,7,3,5,2,4,9,44.4,5,4,0,4,0,10,5
645,Juan David Cabal,co,DF,,Hellas Verona,Serie A,22,2001,16.6,36,27,19,14,3,18,29,62.1,11,30,9,21,26,62,55
646,Jonathan David,ca,FW,,Lille,Ligue 1,23,2000,29.2,26,15,6,13,7,8,26,30.8,18,16,0,16,9,35,4
647,Alphonso Davies,ca,DF,,Bayern Munich,Bundesliga,22,2000,22.9,47,24,29,13,5,30,53,56.6,23,30,4,26,26,73,49
648,Ben Davies,wls,DF,,Tottenham,Premier League,30,1993,12.1,24,17,13,8,3,16,21,76.2,5,17,15,2,10,34,35
649,Tom Davies,eng,MF,,Sheffield Utd,Premier League,25,1998,2.5,10,5,4,3,3,3,9,33.3,6,2,1,1,3,13,6
650,Keinan Davis,eng,FW,MF,Udinese,Serie A,25,1998,2.1,0,0,0,0,0,0,0,,0,0,0,0,0,0,3
651,Paweł Dawidowicz,pl,DF,,Hellas Verona,Serie A,28,1995,23.8,53,30,33,18,2,17,29,58.6,12,17,9,8,24,77,114
652,Craig Dawson,eng,DF,,Wolves,Premier League,33,1990,24.5,30,20,23,6,1,22,34,64.7,12,51,39,12,16,46,120
653,Kevin De Bruyne,be,MF,,Manchester City,Premier League,32,1991,13.6,14,9,1,5,8,7,20,35.0,13,5,0,5,4,18,4
654,Charles De Ketelaere,be,FW,MF,Atalanta,Serie A,22,2001,22.5,33,21,3,12,18,10,20,50.0,10,30,2,28,7,40,6
655,Rodrigo De Paul,ar,MF,,Atlético Madrid,La Liga,29,1994,23.1,31,21,11,14,6,15,38,39.5,23,28,1,27,11,42,15
656,Mattia De Sciglio,it,DF,,Juventus,Serie A,30,1992,0.5,0,0,0,0,0,0,0,,0,1,0,1,1,1,2
657,Lorenzo De Silvestri,it,DF,,Bologna,Serie A,35,1988,7.5,10,8,5,2,3,4,7,57.1,3,9,4,5,6,16,27
658,Thibault De Smet,be,DF,,Reims,Ligue 1,25,1998,20.3,56,35,36,16,4,33,59,55.9,26,25,5,20,21,77,51
659,Koni De Winter,be,DF,,Genoa,Serie A,21,2002,26.4,44,25,26,13,5,21,31,67.7,10,30,10,20,21,65,78
660,Grégoire Defrel,mq,FW,MF,Sassuolo,Serie A,32,1991,8.4,17,8,7,5,5,7,15,46.7,8,10,0,10,3,20,9
661,Alessandro Deiola,it,MF,,Cagliari,Serie A,27,1995,17.9,33,19,13,16,4,18,47,38.3,29,16,6,10,9,42,37
662,Romain Del Castillo,fr,FW,,Brest,Ligue 1,27,1996,27.7,46,29,14,18,14,18,70,25.7,52,33,1,32,9,55,8
663,Thomas Delaine,fr,DF,MF,Strasbourg,Ligue 1,31,1992,22.7,38,19,29,8,1,20,42,47.6,22,18,2,16,17,55,51
664,Sacha Delaye,fr,MF,FW,Montpellier,Ligue 1,21,2002,1.4,7,2,2,2,3,1,6,16.7,5,2,0,2,0,7,1
665,Hannes Delcroix,be,DF,,Burnley,Premier League,24,1999,6.5,10,6,6,4,0,3,4,75.0,1,9,3,6,9,19,26
666,Alessandro Dellavalle,it,DF,,Torino,Serie A,19,2004,0.2,0,0,0,0,0,0,0,,0,1,1,0,1,1,0
667,Olivier Deman,be,DF,,Werder Bremen,Bundesliga,23,2000,15.2,28,15,21,4,3,18,38,47.4,20,24,8,16,14,42,49
668,Karamoko Dembélé,eng,MF,FW,Brest,Ligue 1,20,2003,0.2,0,0,0,0,0,0,0,,0,0,0,0,0,0,0
669,Ousmane Dembélé,fr,MF,FW,Paris S-G,Ligue 1,26,1997,16.7,19,14,2,7,10,6,13,46.2,7,11,0,11,5,24,4
670,Jessy Deminguet,fr,MF,FW,Strasbourg,Ligue 1,25,1998,7.7,14,9,6,8,0,6,18,33.3,12,8,0,8,9,23,5
671,Ermedin Demirović,ba,FW,MF,Augsburg,Bundesliga,25,1998,31.9,24,14,5,16,3,12,40,30.0,28,28,2,26,11,35,26
672,Diego Demme,de,MF,,Napoli,Serie A,31,1991,0.8,1,1,0,1,0,0,1,0.0,1,0,0,0,0,1,0
673,Sepp van den Berg,nl,DF,,Mainz 05,Bundesliga,21,2001,31.5,38,23,20,15,3,15,26,57.7,11,66,36,30,43,81,159
674,Leander Dendoncker,be,MF,,Aston Villa,Premier League,28,1995,1.3,6,4,3,2,1,4,5,80.0,1,5,2,3,2,8,3
675,Leander Dendoncker,be,MF,,Napoli,Serie A,28,1995,0.3,0,0,0,0,0,0,0,,0,1,1,0,0,0,0
676,Rémy Descamps,fr,GK,,Nantes,Ligue 1,27,1996,6.0,0,0,0,0,0,0,0,,0,0,0,0,0,0,7
677,Mikkel Desler,dk,DF,,Toulouse,Ligue 1,28,1995,17.2,18,12,8,7,3,9,17,52.9,8,32,13,19,19,37,38
678,Arthur Desmas,fr,GK,,Le Havre,Ligue 1,29,1994,33.0,0,0,0,0,0,0,2,0.0,2,0,0,0,0,0,13
679,Mattia Destro,it,FW,MF,Empoli,Serie A,32,1991,4.1,2,1,0,2,0,1,1,100.0,0,4,0,4,2,4,3
680,Samuele Di Benedetto,de,MF,,Stuttgart,Bundesliga,18,2005,0.1,0,0,0,0,0,0,0,,0,0,0,0,1,1,0
681,Federico Di Francesco,it,FW,MF,Lecce,Serie A,29,1994,0.2,1,0,0,1,0,0,0,,0,0,0,0,0,1,0
682,Raffaele Di Gennaro,it,GK,,Inter,Serie A,29,1993,0.3,0,0,0,0,0,0,0,,0,0,0,0,0,0,0
683,Michele Di Gregorio,it,GK,,Monza,Serie A,26,1997,31.9,1,0,1,0,0,1,4,25.0,3,1,0,1,1,2,10
684,Giovanni Di Lorenzo,it,DF,,Napoli,Serie A,29,1993,35.9,58,36,26,26,6,32,68,47.1,36,43,16,27,24,82,45
685,Alessandro Di Pardo,it,DF,MF,Cagliari,Serie A,24,1999,4.0,4,1,3,0,1,0,3,0.0,3,9,2,7,5,9,7
686,Boulaye Dia,sn,FW,MF,Salernitana,Serie A,26,1996,12.7,4,2,2,2,0,1,3,33.3,2,5,0,5,3,7,7
687,Moussa Diaby,fr,FW,MF,Aston Villa,Premier League,24,1999,24.2,12,5,5,4,3,4,22,18.2,18,8,1,7,9,21,6
688,Lamine Diack,sn,MF,,Nantes,Ligue 1,22,2000,0.0,0,0,0,0,0,0,0,,0,0,0,0,0,0,0
689,Mouctar Diakhaby,gn,DF,MF,Valencia,La Liga,26,1996,11.9,18,11,9,9,0,11,13,84.6,2,17,7,10,11,29,62
690,Mamadou Diakhon,fr,FW,MF,Reims,Ligue 1,17,2005,2.3,5,3,2,1,2,3,9,33.3,6,1,0,1,1,6,1
691,Bafodé Diakité,fr,DF,,Lille,Ligue 1,22,2001,18.8,29,20,12,15,2,24,32,75.0,8,16,8,8,21,50,49
692,Ibrahim Diakité,gn,DF,,Reims,Ligue 1,19,2003,1.2,1,0,0,1,0,0,1,0.0,1,3,0,3,2,3,5
693,Moussa Diakité,ml,MF,,Cádiz,La Liga,19,2003,0.0,0,0,0,0,0,0,0,,0,0,0,0,0,0,0
694,Oumar Diakité,ci,FW,,Reims,Ligue 1,19,2003,17.6,25,12,10,9,6,7,21,33.3,14,13,0,13,7,32,7
695,Amad Diallo,ci,FW,MF,Manchester Utd,Premier League,21,2002,4.3,10,3,1,6,3,3,7,42.9,4,3,1,2,1,11,6
696,Amadou Diallo,eng,MF,,Newcastle Utd,Premier League,20,2003,0.0,0,0,0,0,0,0,0,,0,0,0,0,0,0,0
697,Assane Diao,es,FW,,Betis,La Liga,17,2005,11.6,20,12,5,9,6,6,17,35.3,11,22,4,18,7,27,7
698,Habib Diarra,sn,MF,FW,Strasbourg,Ligue 1,19,2004,25.6,30,23,8,20,2,9,33,27.3,24,23,4,19,17,47,15
699,Moussa Diarra,ml,DF,,Toulouse,Ligue 1,22,2000,15.5,32,12,16,15,1,13,27,48.1,14,30,14,16,20,52,43
700,Rúben Dias,pt,DF,,Manchester City,Premier League,26,1997,28.4,39,20,14,21,4,19,26,73.1,7,32,17,15,30,69,77
701,Krépin Diatta,sn,DF,FW,Monaco,Ligue 1,24,1999,13.4,37,20,17,16,4,27,49,55.1,22,17,2,15,16,53,22
702,Mory Diaw,sn,GK,,Clermont Foot,Ligue 1,30,1993,30.0,1,1,1,0,0,1,2,50.0,1,0,0,0,1,2,13
703,Mahamadou Diawara,fr,MF,,Lyon,Ligue 1,18,2005,4.0,9,6,4,5,0,3,11,27.3,8,4,1,3,4,13,4
704,Brahim Díaz,ma,FW,MF,Real Madrid,La Liga,23,1999,17.2,29,19,4,16,9,6,13,46.2,7,16,1,15,5,34,2
705,Luis Díaz,co,FW,,Liverpool,Premier League,26,1997,29.2,35,25,5,17,13,7,30,23.3,23,15,0,15,3,38,8
706,Víctor Díaz,es,DF,MF,Granada,La Liga,35,1988,1.8,5,3,2,3,0,1,3,33.3,2,1,0,1,1,6,8
707,Famara Diedhiou,sn,FW,MF,Granada,La Liga,30,1992,1.0,1,1,0,1,0,0,1,0.0,1,0,0,0,0,1,2
708,Justin Diehl,de,FW,MF,Köln,Bundesliga,18,2004,1.9,0,0,0,0,0,0,0,,0,1,1,0,0,0,0
709,Bamba Dieng,sn,FW,,Lorient,Ligue 1,23,2000,6.1,3,3,0,3,0,1,3,33.3,2,3,0,3,0,3,7
710,Eric Dier,eng,DF,,Tottenham,Premier League,29,1994,2.2,2,1,2,0,0,2,2,100.0,0,3,3,0,2,4,12
711,Eric Dier,eng,DF,,Bayern Munich,Bundesliga,29,1994,13.0,11,8,5,5,1,5,6,83.3,1,20,12,8,10,21,48
712,Guillaume Dietsch,fr,GK,,Metz,Ligue 1,22,2001,0.8,0,0,0,0,0,0,0,,0,0,0,0,0,0,0
713,Florian Dietz,de,FW,MF,Köln,Bundesliga,24,1998,0.8,0,0,0,0,0,0,0,,0,1,0,1,0,0,0
714,Lucas Digne,fr,DF,,Aston Villa,Premier League,30,1993,26.8,47,19,35,9,3,25,44,56.8,19,20,2,18,26,73,67
715,Federico Dimarco,it,DF,,Inter,Serie A,25,1997,23.1,42,25,19,14,9,17,35,48.6,18,18,3,15,9,51,34
716,Stole Dimitrievski,mk,GK,,Rayo Vallecano,La Liga,29,1993,37.0,1,1,1,0,0,1,1,100.0,0,0,0,0,0,1,17
717,Junior Dina Ebimbe,fr,MF,DF,Eint Frankfurt,Bundesliga,22,2000,21.7,44,29,15,17,12,18,41,43.9,23,28,7,21,9,53,39
718,Eren Dinkçi,de,FW,MF,Heidenheim,Bundesliga,21,2001,29.4,32,18,16,13,3,19,48,39.6,29,40,4,36,12,44,21
719,Sinaly Diomande,ci,DF,,Lyon,Ligue 1,22,2001,9.9,10,4,5,3,2,9,16,56.3,7,12,9,3,15,25,26
720,Edan Diop,fr,MF,DF,Monaco,Ligue 1,18,2004,1.8,10,8,6,3,1,7,9,77.8,2,3,0,3,1,11,5
721,Issa Diop,fr,DF,,Fulham,Premier League,26,1997,15.8,30,16,23,5,2,15,20,75.0,5,28,19,9,17,47,80
722,Sofiane Diop,fr,FW,,Nice,Ligue 1,23,2000,5.5,8,6,3,4,1,4,10,40.0,6,4,0,4,3,11,3
723,Andy Diouf,fr,MF,,Lens,Ligue 1,20,2003,14.6,28,19,12,11,5,14,22,63.6,8,13,3,10,3,31,5
724,Yehvann Diouf,fr,GK,,Reims,Ligue 1,23,1999,34.0,0,0,0,0,0,0,1,0.0,1,0,0,0,1,1,19
725,Axel Disasi,fr,DF,,Chelsea,Premier League,25,1998,28.7,33,19,20,10,3,23,30,76.7,7,26,19,7,18,51,102
726,Tiago Djaló,pt,DF,,Juventus,Serie A,23,2000,0.2,0,0,0,0,0,0,0,,0,1,0,1,0,0,1
727,Chaim El Djebali,tn,MF,,Lyon,Ligue 1,19,2004,0.1,0,0,0,0,0,0,0,,0,0,0,0,0,0,0
728,Djené,tg,DF,MF,Getafe,La Liga,31,1991,27.6,34,19,18,13,3,15,26,57.7,11,31,15,16,23,57,70
729,Koffi Djidji,ci,DF,,Torino,Serie A,30,1992,8.4,14,9,9,5,0,3,4,75.0,1,10,5,5,10,24,20
730,Berat Djimsiti,al,DF,,Atalanta,Serie A,30,1993,31.5,42,24,29,12,1,19,31,61.3,12,53,33,20,57,99,100
731,Marko Dmitrović,rs,GK,,Sevilla,La Liga,31,1992,13.0,1,1,1,0,0,1,2,50.0,1,0,0,0,1,2,5
732,Ben Doak,sct,FW,,Liverpool,Premier League,17,2005,0.2,0,0,0,0,0,0,0,,0,0,0,0,0,0,0
733,Ritsu Doan,jp,DF,MF,Freiburg,Bundesliga,25,1998,25.0,50,27,21,19,10,21,36,58.3,15,30,3,27,9,59,29
734,Lewis Dobbin,eng,MF,,Everton,Premier League,20,2003,2.6,9,7,3,5,1,5,9,55.6,4,5,1,4,1,10,0
735,Dodô,br,DF,,Fiorentina,Serie A,24,1998,5.8,5,3,1,4,0,2,5,40.0,3,2,0,2,5,10,11
736,Danilho Doekhi,nl,DF,,Union Berlin,Bundesliga,25,1998,24.0,34,23,18,16,0,15,21,71.4,6,46,25,21,38,72,111
737,Matt Doherty,ie,DF,MF,Wolves,Premier League,31,1992,12.8,31,18,17,10,4,12,23,52.2,11,15,5,10,7,38,47
738,Josh Doig,sct,DF,,Hellas Verona,Serie A,21,2002,9.2,16,9,9,7,0,13,17,76.5,4,12,3,9,4,20,17
739,Josh Doig,sct,DF,,Sassuolo,Serie A,21,2002,14.9,25,17,16,9,0,15,27,55.6,12,31,10,21,16,41,38
740,Jeremy Doku,be,FW,MF,Manchester City,Premier League,21,2002,17.7,39,22,13,12,14,9,20,45.0,11,14,0,14,9,48,5
741,Jeremy Doku,be,FW,,Rennes,Ligue 1,21,2002,1.2,2,2,1,0,1,1,1,100.0,0,0,0,0,0,2,0
742,Jaume Doménech,es,GK,,Valencia,La Liga,32,1990,0.9,0,0,0,0,0,0,0,,0,0,0,0,0,0,0
743,Carlos Dominguez,es,DF,,Celta Vigo,La Liga,22,2001,17.6,33,21,17,9,7,23,37,62.2,14,24,12,12,22,55,78
744,Mario Dominguez,es,FW,,Valencia,La Liga,19,2004,0.3,0,0,0,0,0,0,0,,0,0,0,0,0,0,0
745,Nicolás Domínguez,ar,MF,FW,Nott'ham Forest,Premier League,25,1998,16.6,63,34,35,27,1,23,48,47.9,25,31,5,26,18,81,24
746,Nicolás Domínguez,ar,MF,,Bologna,Serie A,25,1998,1.1,1,0,1,0,0,0,2,0.0,2,3,0,3,0,1,2
747,Giulio Donati,it,DF,,Monza,Serie A,33,1990,0.4,0,0,0,0,0,0,0,,0,0,0,0,0,0,1
748,Jamie Donley,eng,FW,,Tottenham,Premier League,18,2005,0.0,0,0,0,0,0,0,0,,0,0,0,0,0,0,3
749,Gianluigi Donnarumma,it,GK,,Paris S-G,Ligue 1,24,1999,24.1,0,0,0,0,0,0,0,,0,0,0,0,1,1,9
750,Patrick Dorgu,dk,DF,MF,Lecce,Serie A,18,2004,17.4,43,22,22,17,4,22,34,64.7,12,16,5,11,9,52,45
751,Niklas Dorsch,de,MF,,Augsburg,Bundesliga,25,1998,15.4,35,24,13,21,1,13,33,39.4,20,15,9,6,16,51,27
752,Alberto Dossena,it,DF,,Cagliari,Serie A,24,1998,33.1,55,35,43,12,0,32,48,66.7,16,50,27,23,45,100,172
753,Carlos Dotor,es,MF,,Celta Vigo,La Liga,22,2001,7.9,14,7,3,8,3,4,13,30.8,9,12,2,10,4,18,4
754,Abdoulaye Doucouré,ml,FW,MF,Everton,Premier League,30,1993,29.2,43,27,20,14,9,18,46,39.1,28,23,3,20,15,58,19
755,Cheick Doucouré,ml,MF,,Crystal Palace,Premier League,23,2000,10.2,34,17,15,13,6,18,30,60.0,12,13,2,11,20,54,12
756,Siriné Doucouré,ml,FW,,Lorient,Ligue 1,21,2002,4.7,8,6,0,4,4,3,3,100.0,0,4,0,4,1,9,6
757,Désiré Doué,fr,MF,FW,Rennes,Ligue 1,18,2005,18.1,32,18,11,14,7,10,33,30.3,23,30,1,29,14,46,8
758,Guela Doué,ci,DF,,Rennes,Ligue 1,20,2002,13.7,28,21,14,12,2,22,32,68.8,10,12,1,11,15,43,65
759,Alfie Doughty,eng,DF,,Luton Town,Premier League,23,1999,32.5,63,40,29,18,16,37,82,45.1,45,51,9,42,31,94,43
760,Douglas,br,MF,,Nantes,Ligue 1,26,1997,19.7,70,42,34,30,6,30,59,50.8,29,22,8,14,26,96,30
761,Ismaël Doukouré,fr,MF,DF,Strasbourg,Ligue 1,20,2003,18.4,23,16,7,14,2,13,21,61.9,8,19,7,12,19,42,29
762,Kamory Doumbia,ml,MF,,Brest,Ligue 1,20,2003,9.8,28,18,8,10,10,10,29,34.5,19,14,0,14,9,37,6
763,Anastasios Douvikas,gr,FW,,Celta Vigo,La Liga,23,1999,10.1,15,7,2,6,7,3,8,37.5,5,6,3,3,2,17,9
764,Artem Dovbyk,ua,FW,,Girona,La Liga,26,1997,28.7,4,3,2,1,1,0,2,0.0,2,8,1,7,0,4,17
765,Nikola Dovedan,at,MF,FW,Heidenheim,Bundesliga,29,1994,7.3,14,9,2,10,2,5,25,20.0,20,9,0,9,1,15,3
766,Damion Downs,us,FW,MF,Köln,Bundesliga,19,2004,2.0,1,1,1,0,0,1,2,50.0,1,1,0,1,0,1,1
767,Tommy Doyle,eng,MF,,Wolves,Premier League,21,2001,13.6,26,13,11,10,5,14,23,60.9,9,22,9,13,12,38,18
768,Radu Drăgușin,ro,DF,,Tottenham,Premier League,21,2002,4.8,5,3,5,0,0,3,3,100.0,0,5,4,1,8,13,19
769,Radu Drăgușin,ro,DF,,Genoa,Serie A,21,2002,19.0,16,11,9,6,1,8,9,88.9,1,18,12,6,21,37,87
770,Dion Drena Beljo,hr,FW,MF,Augsburg,Bundesliga,21,2002,6.5,0,0,0,0,0,0,2,0.0,2,8,1,7,1,1,4
771,Tim Drexler,de,DF,,Hoffenheim,Bundesliga,18,2005,6.4,16,9,12,4,0,8,17,47.1,9,12,8,4,8,24,14
772,Domingos Duarte,pt,DF,,Getafe,La Liga,28,1995,10.1,7,4,6,0,1,5,7,71.4,2,7,5,2,8,15,27
773,Rubén Duarte,es,DF,,Alavés,La Liga,27,1995,20.9,39,20,21,16,2,21,31,67.7,10,21,6,15,23,62,69
774,Martin Dúbravka,sk,GK,,Newcastle Utd,Premier League,34,1989,22.1,0,0,0,0,0,0,4,0.0,4,0,0,0,0,0,8
775,Marvin Ducksch,de,FW,,Werder Bremen,Bundesliga,29,1994,30.0,8,3,4,3,1,6,14,42.9,8,2,0,2,4,12,25
776,Ondrej Duda,sk,MF,,Hellas Verona,Serie A,28,1994,27.3,59,39,17,35,7,31,52,59.6,21,29,12,17,26,85,21
777,Denzel Dumfries,nl,DF,,Inter,Serie A,27,1996,18.2,22,13,9,11,2,9,23,39.1,14,15,6,9,12,34,33
778,Paul Dummett,wls,DF,,Newcastle Utd,Premier League,31,1991,0.2,1,0,1,0,0,1,1,100.0,0,0,0,0,0,1,1
779,Alfred Duncan,gh,MF,,Fiorentina,Serie A,30,1993,21.0,35,22,13,15,7,15,35,42.9,20,27,5,22,11,46,13
780,Lewis Dunk,eng,DF,,Brighton,Premier League,31,1991,31.9,27,14,17,9,1,13,36,36.1,23,49,37,12,31,58,90
781,Jhon Durán,co,FW,MF,Aston Villa,Premier League,19,2003,5.3,6,5,3,1,2,1,6,16.7,5,6,0,6,1,7,10
782,Julien Duranville,be,FW,MF,Dortmund,Bundesliga,17,2006,0.1,1,0,0,1,0,1,1,100.0,0,0,0,0,0,1,0
783,Hugo Duro,es,FW,,Valencia,La Liga,23,1999,33.1,16,8,5,8,3,9,29,31.0,20,24,5,19,5,21,27
784,Jean-Kevin Duverne,ht,DF,,Nantes,Ligue 1,26,1997,15.0,37,19,16,17,4,18,44,40.9,26,17,5,12,18,55,34
785,Paulo Dybala,ar,FW,MF,Roma,Serie A,29,1993,21.8,22,13,3,10,9,2,18,11.1,16,12,0,12,3,25,6
786,Aron Dønnum,no,FW,MF,Toulouse,Ligue 1,25,1998,17.7,16,10,3,8,5,7,22,31.8,15,13,0,13,8,24,16
787,George Earthy,eng,FW,,West Ham,Premier League,18,2004,0.4,0,0,0,0,0,0,1,0.0,1,0,0,0,1,1,0
788,Simon Ebonog,cm,MF,,Le Havre,Ligue 1,18,2004,0.2,1,1,0,1,0,1,1,100.0,0,1,1,0,0,1,1
789,Festy Ebosele,ie,DF,,Udinese,Serie A,20,2002,18.9,33,20,23,9,1,21,35,60.0,14,33,2,31,10,43,27
790,Enzo Ebosse,cm,DF,,Udinese,Serie A,24,1999,0.1,1,1,1,0,0,0,1,0.0,1,0,0,0,1,2,0
791,Tyronne Ebuehi,ng,DF,,Empoli,Serie A,27,1995,12.2,14,9,9,5,0,7,11,63.6,4,9,4,5,6,20,27
792,Ederson,br,GK,,Manchester City,Premier League,29,1993,30.9,0,0,0,0,0,0,1,0.0,1,0,0,0,0,0,10
793,Éderson,br,MF,,Atalanta,Serie A,24,1999,31.9,83,49,38,38,7,44,63,69.8,19,48,8,40,41,124,33
794,Odsonne Édouard,fr,FW,MF,Crystal Palace,Premier League,25,1998,17.3,24,12,8,8,8,4,19,21.1,15,17,1,16,6,30,19
795,John Egan,ie,DF,,Sheffield Utd,Premier League,30,1992,5.4,6,4,4,2,0,4,11,36.4,7,10,4,6,13,19,39
796,Maximilian Eggestein,de,MF,,Freiburg,Bundesliga,26,1996,32.4,49,24,25,19,5,15,36,41.7,21,53,19,34,28,77,40
797,Lilian Egloff,de,MF,DF,Stuttgart,Bundesliga,20,2002,1.2,4,1,3,1,0,2,4,50.0,2,3,1,2,1,5,0
798,Kingsley Ehizibue,nl,DF,,Udinese,Serie A,28,1995,10.6,22,14,16,4,2,11,18,61.1,7,21,3,18,8,30,36
799,Hjalmar Ekdal,se,DF,,Burnley,Premier League,24,1998,4.9,4,2,2,2,0,2,4,50.0,2,10,5,5,6,10,21
800,Hugo Ekitike,fr,FW,,Paris S-G,Ligue 1,21,2002,0.1,0,0,0,0,0,0,0,,0,0,0,0,0,0,0
801,Hugo Ekitike,fr,FW,,Eint Frankfurt,Bundesliga,21,2002,8.0,11,7,3,6,2,4,6,66.7,2,10,0,10,2,13,4
802,Emmanuel Ekong,se,FW,,Empoli,Serie A,21,2002,0.1,0,0,0,0,0,0,0,,0,0,0,0,0,0,0
803,Caleb Ekuban,gh,FW,,Genoa,Serie A,29,1994,12.6,8,4,2,4,2,5,9,55.6,4,11,3,8,1,9,7
804,Anthony Elanga,se,FW,MF,Nott'ham Forest,Premier League,21,2002,27.0,33,19,20,6,7,17,36,47.2,19,22,2,20,8,41,20
805,Simon Elisor,fr,FW,,Metz,Ligue 1,24,1999,8.5,9,2,3,2,4,2,6,33.3,4,6,1,5,0,9,9
806,Harvey Elliott,eng,MF,FW,Liverpool,Premier League,20,2003,15.0,27,17,8,14,5,10,31,32.3,21,27,0,27,6,33,7
807,Elif Elmas,mk,FW,MF,Napoli,Serie A,23,1999,3.8,4,3,1,3,0,2,2,100.0,0,2,0,2,2,6,8
808,Elif Elmas,mk,MF,FW,RB Leipzig,Bundesliga,23,1999,3.0,8,6,1,6,1,6,8,75.0,2,5,0,5,1,9,2
809,Mohamed Elneny,eg,MF,,Arsenal,Premier League,31,1992,0.3,0,0,0,0,0,0,1,0.0,1,0,0,0,1,1,0
810,Aritz Elustondo,es,DF,,Real Sociedad,La Liga,29,1994,9.0,11,7,5,4,2,6,14,42.9,8,12,10,2,7,18,26
811,Nico Elvedi,ch,DF,,Gladbach,Bundesliga,26,1996,27.6,33,18,22,10,1,18,24,75.0,6,40,25,15,43,76,150
812,Adri Embarba,es,FW,MF,Almería,La Liga,31,1992,27.5,55,37,29,15,11,26,53,49.1,27,37,1,36,15,70,12
813,Breel Embolo,ch,FW,,Monaco,Ligue 1,26,1997,2.0,3,3,0,2,1,1,4,25.0,3,1,0,1,1,4,2
814,Emanuel Emegha,nl,FW,,Strasbourg,Ligue 1,20,2003,23.1,8,5,2,4,2,4,9,44.4,5,13,3,10,2,10,25
815,Emerson,br,DF,,Tottenham,Premier League,24,1999,12.9,36,24,23,10,3,21,43,48.8,22,23,10,13,20,56,50
816,Youssef En-Nesyri,ma,FW,,Sevilla,La Liga,26,1997,28.6,10,7,3,4,3,0,10,0.0,10,9,1,8,7,17,29
817,Julio Enciso,py,MF,FW,Brighton,Premier League,19,2004,5.3,6,2,3,2,1,2,7,28.6,5,11,0,11,0,6,3
818,Wataru Endo,jp,MF,,Liverpool,Premier League,30,1993,19.1,48,28,11,31,6,20,61,32.8,41,24,2,22,20,68,31
819,Arne Engels,be,MF,DF,Augsburg,Bundesliga,19,2003,15.6,33,18,15,14,4,12,29,41.4,17,23,1,22,15,48,21
820,Christian Eriksen,dk,MF,,Manchester Utd,Premier League,31,1992,12.7,18,13,5,10,3,12,33,36.4,21,17,6,11,4,22,13
821,Martin Erlic,hr,DF,,Sassuolo,Serie A,25,1998,29.1,37,22,26,8,3,20,30,66.7,10,31,16,15,28,65,128
822,Gonzalo Escalante,ar,MF,,Cádiz,La Liga,30,1993,18.9,39,24,16,14,9,20,55,36.4,35,23,5,18,26,65,33
823,Aarón Escandell,es,GK,,Las Palmas,La Liga,27,1995,1.7,0,0,0,0,0,0,0,,0,0,0,0,0,0,1
824,Alfonso Espino,uy,DF,,Rayo Vallecano,La Liga,31,1992,27.9,67,45,43,22,2,30,82,36.6,52,26,4,22,40,107,63
825,Bernardo Espinosa,co,DF,,Girona,La Liga,34,1989,0.0,1,1,1,0,0,1,1,100.0,0,0,0,0,0,1,2
826,Maxime Estève,fr,DF,,Burnley,Premier League,21,2002,14.5,27,10,15,12,0,18,32,56.3,14,21,10,11,27,54,56
827,Maxime Estève,fr,DF,,Montpellier,Ligue 1,21,2002,11.1,16,12,11,5,0,10,15,66.7,5,13,9,4,18,34,50
828,Oscar Estupiñan,co,FW,,Metz,Ligue 1,26,1996,2.9,5,4,0,3,2,1,2,50.0,1,2,0,2,0,5,0
829,Pervis Estupiñán,ec,DF,,Brighton,Premier League,25,1998,13.8,26,13,12,11,3,14,30,46.7,16,14,4,10,21,47,20
830,Karl Etta,cm,FW,,Cádiz,La Liga,19,2003,0.2,1,1,0,1,0,0,0,,0,0,0,0,0,1,0
831,Jonny Evans,nir,DF,,Manchester Utd,Premier League,35,1988,15.5,22,14,20,2,0,12,21,57.1,9,25,18,7,23,45,76
832,Eberechi Eze,eng,MF,FW,Crystal Palace,Premier League,25,1998,22.8,35,17,4,18,13,15,31,48.4,16,27,2,25,11,46,6
833,Abde Ezzalzouli,ma,FW,MF,Barcelona,La Liga,21,2001,0.8,1,1,0,0,1,0,1,0.0,1,1,0,1,0,1,0
834,Abde Ezzalzouli,ma,FW,,Betis,La Liga,21,2001,9.6,17,14,7,5,5,4,14,28.6,10,10,0,10,5,22,5
835,Giovanni Fabbian,it,MF,FW,Bologna,Serie A,20,2003,11.7,17,10,9,7,1,7,12,58.3,5,5,2,3,7,24,11
836,Łukasz Fabiański,pl,GK,,West Ham,Premier League,38,1985,8.0,1,0,1,0,0,1,2,50.0,1,0,0,0,1,2,4
837,Nicolò Fagioli,it,MF,,Juventus,Serie A,22,2001,4.9,5,3,1,3,1,3,7,42.9,4,3,0,3,4,9,1
838,Romain Faivre,fr,MF,FW,Bournemouth,Premier League,25,1998,0.5,1,1,0,1,0,0,3,0.0,3,0,0,0,0,1,0
839,Romain Faivre,fr,MF,FW,Lorient,Ligue 1,25,1998,16.1,13,6,5,4,4,6,15,40.0,9,6,1,5,7,20,3
840,Ilhan Fakili,fr,MF,FW,Clermont Foot,Ligue 1,17,2006,1.0,0,0,0,0,0,0,1,0.0,1,1,0,1,1,1,0
841,Radamel Falcao,co,FW,DF,Rayo Vallecano,La Liga,37,1986,4.5,7,5,1,5,1,1,3,33.3,2,2,0,2,3,10,4
842,Wladimiro Falcone,it,GK,,Lecce,Serie A,28,1995,38.0,0,0,0,0,0,0,0,,0,1,0,1,1,1,21
843,Fali,es,DF,,Cádiz,La Liga,29,1993,28.3,41,26,29,11,1,21,36,58.3,15,38,24,14,27,68,120
844,Davide Faraoni,it,DF,,Hellas Verona,Serie A,31,1991,6.7,13,10,5,6,2,7,10,70.0,3,9,5,4,6,19,21
845,Davide Faraoni,it,DF,,Fiorentina,Serie A,31,1991,4.4,9,4,5,2,2,5,11,45.5,6,3,1,2,5,14,14
846,Ansu Fati,es,MF,FW,Brighton,Premier League,20,2002,5.8,5,3,1,2,2,1,11,9.1,10,8,0,8,3,8,3
847,Ansu Fati,es,MF,FW,Barcelona,La Liga,20,2002,0.6,0,0,0,0,0,0,1,0.0,1,0,0,0,0,0,0
848,Khalil Fayad,fr,FW,MF,Montpellier,Ligue 1,19,2004,11.4,28,15,17,7,4,9,22,40.9,13,15,3,12,14,42,6
849,Federico Fazio,ar,DF,,Salernitana,Serie A,36,1987,15.1,18,11,14,4,0,8,14,57.1,6,22,19,3,17,35,99
850,Jacopo Fazzini,it,MF,,Empoli,Serie A,20,2003,13.7,49,25,27,13,9,30,53,56.6,23,21,3,18,12,61,18
851,Peter Federico,do,MF,FW,Valencia,La Liga,21,2002,7.2,5,3,3,1,1,1,10,10.0,9,11,0,11,7,12,10
852,Nabil Fekir,fr,MF,FW,Betis,La Liga,30,1993,11.7,15,10,5,7,3,5,10,50.0,5,9,0,9,7,22,3
853,Felipe,br,DF,,Nott'ham Forest,Premier League,34,1989,4.2,12,9,9,3,0,9,12,75.0,3,4,1,3,4,16,12
854,Luiz Felipe,it,DF,,Betis,La Liga,26,1997,4.0,7,3,5,2,0,4,5,80.0,1,10,4,6,4,11,16
855,João Félix,pt,FW,,Barcelona,La Liga,23,1999,17.1,22,16,9,7,6,8,22,36.4,14,14,1,13,10,32,11
856,Ohis Felix Uduokhai,de,DF,,Augsburg,Bundesliga,25,1997,32.5,37,21,18,14,5,16,25,64.0,9,45,35,10,46,83,178
857,Kiko Femenía,es,DF,,Villarreal,La Liga,32,1991,17.6,35,25,19,13,3,19,34,55.9,15,21,6,15,31,66,45
858,Evan Ferguson,ie,FW,,Brighton,Premier League,18,2004,15.2,14,6,4,7,3,5,14,35.7,9,10,3,7,2,16,8
859,Lewis Ferguson,sct,MF,,Bologna,Serie A,23,1999,30.1,37,21,16,17,4,16,37,43.2,21,25,8,17,17,54,27
860,Bruno Fernandes,pt,MF,FW,Manchester Utd,Premier League,28,1994,34.6,68,38,27,25,16,30,88,34.1,58,49,6,43,27,95,50
861,Edimilson Fernandes,ch,DF,,Mainz 05,Bundesliga,27,1996,14.3,25,16,15,9,1,16,24,66.7,8,14,6,8,22,47,52
862,Aitor Fernández,es,GK,,Osasuna,La Liga,32,1991,6.1,0,0,0,0,0,0,1,0.0,1,0,0,0,0,0,5
863,Álex Fernández,es,MF,,Cádiz,La Liga,30,1992,14.3,19,9,10,9,0,11,22,50.0,11,17,5,12,15,34,30
864,Carlos Fernández,es,FW,,Real Sociedad,La Liga,27,1996,4.5,11,7,3,6,2,0,2,0.0,2,4,0,4,0,11,5
865,Enzo Fernández,ar,MF,,Chelsea,Premier League,22,2001,24.5,50,22,22,18,10,27,65,41.5,38,36,13,23,17,67,28
866,Raúl Fernández,es,GK,,Granada,La Liga,35,1988,3.1,0,0,0,0,0,0,1,0.0,1,0,0,0,0,0,1
867,Valery Fernández,es,MF,FW,Girona,La Liga,23,1999,5.6,11,9,4,7,0,6,8,75.0,2,6,1,5,1,12,4
868,Fernando,es,GK,,Almería,La Liga,33,1990,4.0,0,0,0,0,0,0,0,,0,1,0,1,0,0,2
869,Fernando,br,MF,,Sevilla,La Liga,36,1987,5.1,9,8,2,4,3,5,9,55.6,4,2,0,2,7,16,9
870,Ichem Ferrah,fr,FW,,Lille,Ligue 1,17,2005,0.0,0,0,0,0,0,0,0,,0,0,0,0,0,0,0
871,Andrea Ferraris,it,MF,,Monza,Serie A,20,2003,0.1,1,1,1,0,0,0,0,,0,0,0,0,0,1,0
872,André Ferreira,pt,GK,,Granada,La Liga,27,1996,14.9,0,0,0,0,0,0,1,0.0,1,0,0,0,0,0,9
873,João Ferreira,pt,DF,,Udinese,Serie A,22,2001,20.2,58,42,36,18,4,34,58,58.6,24,27,6,21,29,87,89
874,Jordan Ferri,fr,MF,,Montpellier,Ligue 1,31,1992,22.6,36,22,16,17,3,20,67,29.9,47,19,1,18,13,49,23
875,Nacho Ferri,es,FW,MF,Eint Frankfurt,Bundesliga,18,2004,0.8,3,3,1,2,0,2,3,66.7,1,0,0,0,0,3,2
876,Rachad Fettal,ma,FW,,Almería,La Liga,18,2005,0.2,1,1,1,0,0,0,0,,0,0,0,0,0,1,0
877,Seydou Fini,it,DF,FW,Genoa,Serie A,17,2006,0.4,0,0,0,0,0,0,0,,0,0,0,0,0,0,0
878,Max Finkgräfe,de,DF,FW,Köln,Bundesliga,19,2004,19.5,65,39,40,25,0,39,74,52.7,35,35,10,25,22,87,39
879,Vincenzo Fiorillo,it,GK,,Salernitana,Serie A,33,1990,4.0,0,0,0,0,0,0,0,,0,0,0,0,0,0,0
880,Kilian Fischer,de,DF,MF,Wolfsburg,Bundesliga,22,2000,3.2,8,6,4,3,1,2,5,40.0,3,8,1,7,1,9,12
881,John Fleck,sct,MF,DF,Sheffield Utd,Premier League,31,1991,1.0,1,0,0,1,0,0,1,0.0,1,0,0,0,0,1,1
882,Mark Flekken,nl,GK,,Brentford,Premier League,30,1993,36.5,1,1,1,0,0,1,5,20.0,4,1,0,1,0,1,17
883,Alessandro Florenzi,it,DF,,Milan,Serie A,32,1991,19.2,43,21,26,12,5,26,48,54.2,22,16,9,7,20,63,25
884,Phil Foden,eng,FW,MF,Manchester City,Premier League,23,2000,31.7,31,20,11,10,10,13,31,41.9,18,30,0,30,13,44,18
885,Wes Foderingham,eng,GK,,Sheffield Utd,Premier League,32,1991,29.4,5,3,5,0,0,5,6,83.3,1,0,0,0,0,5,18
886,Malick Fofana,be,FW,,Lyon,Ligue 1,18,2005,6.2,5,4,3,1,1,4,9,44.4,5,3,0,3,5,10,9
887,Youssouf Fofana,fr,MF,,Monaco,Ligue 1,24,1999,30.0,61,39,19,36,6,30,66,45.5,36,35,7,28,37,98,31
888,Jonas Föhrenbach,de,DF,,Heidenheim,Bundesliga,27,1996,31.0,44,24,24,14,6,19,36,52.8,17,34,19,15,31,75,70
889,Thomas Foket,be,DF,,Reims,Ligue 1,28,1994,20.4,32,17,21,8,3,20,45,44.4,25,34,12,22,25,57,36
890,Michael Folorunsho,it,MF,FW,Hellas Verona,Serie A,25,1998,30.9,50,28,21,22,7,23,57,40.4,34,45,12,33,17,67,44
891,Tiago Fonseca Morais,pt,FW,,Lille,Ligue 1,19,2003,0.5,1,1,0,1,0,0,0,,0,0,0,0,1,2,0
892,Pablo Fornals,es,MF,FW,West Ham,Premier League,27,1996,4.7,10,6,4,3,3,5,16,31.3,11,8,1,7,6,16,7
893,Pablo Fornals,es,FW,MF,Betis,La Liga,27,1996,12.8,24,16,8,11,5,12,22,54.5,10,14,0,14,22,46,10
894,Emil Forsberg,se,MF,FW,RB Leipzig,Bundesliga,31,1991,5.2,7,3,2,5,0,5,12,41.7,7,7,0,7,0,7,5
895,Omari Forson,eng,FW,,Manchester Utd,Premier League,19,2004,0.8,2,0,0,2,0,1,1,100.0,0,0,0,0,0,2,0
896,Philipp Förster,de,MF,FW,Bochum,Bundesliga,28,1995,4.3,9,5,3,4,2,2,6,33.3,4,3,0,3,7,16,3
897,Héctor Fort,es,DF,,Barcelona,La Liga,16,2006,3.5,6,5,5,1,0,4,10,40.0,6,0,0,0,2,8,4
898,Lyle Foster,za,FW,MF,Burnley,Premier League,22,2000,21.1,19,10,5,6,8,6,17,35.3,11,13,3,10,3,22,34
899,Dimitri Foulquier,fr,DF,MF,Valencia,La Liga,30,1993,20.5,39,22,22,13,4,18,26,69.2,8,10,1,9,16,55,49
900,Juan Foyth,ar,DF,,Villarreal,La Liga,25,1998,11.8,26,15,18,8,0,12,27,44.4,15,17,4,13,12,38,44
901,Matheus França,br,MF,FW,Crystal Palace,Premier League,19,2004,2.6,3,3,2,1,0,1,7,14.3,6,4,0,4,1,4,1
902,Bartol Franjić,hr,MF,,Darmstadt 98,Bundesliga,23,2000,13.7,15,12,4,10,1,7,28,25.0,21,12,4,8,30,45,29
903,Przemysław Frankowski,pl,DF,,Lens,Ligue 1,28,1995,24.4,60,39,25,26,9,31,74,41.9,43,30,7,23,25,85,36
904,Nathan Fraser,ie,FW,,Wolves,Premier League,18,2005,2.1,5,2,2,1,2,1,3,33.3,2,2,1,1,1,6,2
905,Davide Frattesi,it,MF,,Inter,Serie A,23,1999,10.6,10,6,3,7,0,4,8,50.0,4,9,3,6,5,15,19
906,Morten Frendrup,dk,MF,,Genoa,Serie A,22,2001,34.9,133,72,47,70,16,55,91,60.4,36,55,14,41,51,184,42
907,Remo Freuler,ch,MF,,Bologna,Serie A,31,1992,29.2,78,50,41,32,5,38,69,55.1,31,37,9,28,36,114,53
908,Marco Friedl,at,DF,,Werder Bremen,Bundesliga,25,1998,24.4,53,32,38,15,0,36,48,75.0,12,45,29,16,35,88,129
909,Marvin Friedrich,de,DF,,Gladbach,Bundesliga,27,1995,17.4,23,15,16,6,1,12,20,60.0,8,28,20,8,17,40,87
910,Jeremie Frimpong,nl,DF,,Leverkusen,Bundesliga,22,2000,25.0,26,17,12,7,7,8,20,40.0,12,26,0,26,7,33,17
911,Jorge de Frutos,es,FW,MF,Rayo Vallecano,La Liga,26,1997,17.2,19,8,5,8,6,7,22,31.8,15,12,0,12,7,26,18
912,Chris Führich,de,FW,MF,Stuttgart,Bundesliga,25,1998,28.5,30,19,6,14,10,16,37,43.2,21,31,0,31,7,37,7
913,Shiō Fukuda,jp,FW,MF,Gladbach,Bundesliga,19,2004,0.4,2,0,1,1,0,1,2,50.0,1,0,0,0,1,3,0
914,Angelo Fulgini,fr,MF,,Lens,Ligue 1,26,1996,15.3,23,14,6,13,4,11,19,57.9,8,22,1,21,8,31,11
915,Niclas Füllkrug,de,FW,,Werder Bremen,Bundesliga,30,1993,2.0,1,1,0,1,0,1,1,100.0,0,2,1,1,0,1,1
916,Niclas Füllkrug,de,FW,,Dortmund,Bundesliga,30,1993,24.6,7,2,1,6,0,2,8,25.0,6,17,4,13,2,9,25
917,Gerardo Fusco,it,FW,,Salernitana,Serie A,18,2005,0.2,0,0,0,0,0,0,0,,0,0,0,0,0,0,0
918,Daniel Fuzato,br,GK,,Getafe,La Liga,26,1997,0.1,0,0,0,0,0,0,0,,0,0,0,0,0,0,1
919,Matteo Gabbia,it,DF,,Milan,Serie A,23,1999,14.2,29,20,15,13,1,18,24,75.0,6,11,6,5,10,39,48
920,Matteo Gabbia,it,DF,,Villarreal,La Liga,23,1999,5.3,10,6,4,6,0,5,8,62.5,3,5,2,3,8,18,36
921,Gianluca Gaetano,it,FW,MF,Cagliari,Serie A,23,2000,8.3,7,4,0,4,3,2,7,28.6,5,4,0,4,3,10,4
922,Gianluca Gaetano,it,MF,,Napoli,Serie A,23,2000,1.8,4,1,0,4,0,2,4,50.0,2,5,2,3,1,5,4
923,Roberto Gagliardini,it,MF,DF,Monza,Serie A,29,1994,26.2,61,30,27,25,9,31,50,62.0,19,30,11,19,31,92,38
924,Cody Gakpo,nl,FW,MF,Liverpool,Premier League,24,1999,18.3,27,17,8,14,5,8,25,32.0,17,21,4,17,14,41,7
925,Javi Galán,es,DF,,Atlético Madrid,La Liga,28,1994,1.0,5,4,2,2,1,4,5,80.0,1,1,0,1,1,6,3
926,Javi Galán,es,DF,,Real Sociedad,La Liga,28,1994,11.9,38,22,15,19,4,15,30,50.0,15,24,1,23,14,52,17
927,Iñigo Ruiz de Galarreta,es,MF,,Athletic Club,La Liga,29,1993,23.2,49,31,15,26,8,24,49,49.0,25,18,5,13,12,61,17
928,Pablo Galdames Millán,cl,MF,DF,Genoa,Serie A,26,1996,0.1,0,0,0,0,0,0,0,,0,1,0,1,0,0,0
929,Conor Gallagher,eng,MF,,Chelsea,Premier League,23,2000,34.8,85,52,37,31,17,33,77,42.9,44,50,11,39,43,128,34
930,Antonino Gallo,it,DF,,Lecce,Serie A,23,2000,27.7,43,27,31,11,1,31,49,63.3,18,34,9,25,25,68,67
931,Cristian Gamboa,cr,DF,,Bochum,Bundesliga,33,1989,13.2,24,18,12,11,1,14,33,42.4,19,20,7,13,15,39,34
932,Kévin Gameiro,fr,FW,MF,Strasbourg,Ligue 1,36,1987,15.0,10,10,5,3,2,2,17,11.8,15,9,0,9,3,13,7
933,Idrissa Gana Gueye,sn,MF,,Everton,Premier League,33,1989,20.9,73,44,32,27,14,29,46,63.0,17,24,7,17,28,101,16
934,Ignatius Ganago,cm,FW,MF,Nantes,Ligue 1,24,1999,2.0,0,0,0,0,0,0,1,0.0,1,1,0,1,1,1,1
935,Aleix García,es,MF,,Girona,La Liga,26,1997,35.5,49,28,17,26,6,28,54,51.9,26,45,17,28,36,85,53
936,Álvaro García,es,FW,MF,Rayo Vallecano,La Liga,30,1992,27.5,34,25,15,10,9,7,34,20.6,27,35,0,35,36,70,33
937,Dani García,es,MF,,Athletic Club,La Liga,33,1990,8.3,17,11,4,7,6,12,24,50.0,12,9,3,6,8,25,11
938,David García,es,DF,,Osasuna,La Liga,29,1994,25.9,29,18,19,9,1,16,26,61.5,10,40,19,21,18,47,115
939,Eric García,es,DF,,Barcelona,La Liga,22,2001,0.6,0,0,0,0,0,0,0,,0,1,1,0,0,0,0
940,Eric García,es,DF,,Girona,La Liga,22,2001,29.3,55,37,34,18,3,34,49,69.4,15,36,18,18,30,85,79
941,Fran Garcia,es,DF,,Real Madrid,La Liga,23,1999,15.5,25,17,11,12,2,13,31,41.9,18,16,3,13,19,44,28
942,Gonzalo García,es,FW,MF,Real Madrid,La Liga,19,2004,0.2,0,0,0,0,0,0,1,0.0,1,1,1,0,0,0,1
943,Jastin García,es,FW,,Girona,La Liga,19,2004,0.4,1,0,0,0,1,0,0,,0,0,0,0,0,1,1
944,Raúl García,es,FW,MF,Athletic Club,La Liga,37,1986,4.7,9,6,2,4,3,4,9,44.4,5,10,1,9,3,12,9
945,Rubén García,es,FW,MF,Osasuna,La Liga,30,1993,17.2,32,18,8,17,7,13,33,39.4,20,23,3,20,12,44,23
946,Santiago García,es,FW,,Getafe,La Liga,21,2001,0.3,1,0,0,0,1,1,1,100.0,0,0,0,0,0,1,0
947,Ulisses Garcia,ch,DF,,Marseille,Ligue 1,27,1996,10.1,21,16,6,13,2,13,20,65.0,7,8,3,5,7,28,13
948,Unai García,es,DF,,Osasuna,La Liga,31,1992,6.2,12,9,9,2,1,5,10,50.0,5,7,1,6,8,20,18
949,Alejandro Garnacho,ar,FW,,Manchester Utd,Premier League,19,2004,28.5,22,15,7,6,9,12,45,26.7,33,26,2,24,18,40,18
950,James Garner,eng,MF,,Everton,Premier League,22,2001,33.4,83,44,32,38,13,35,82,42.7,47,45,14,31,45,128,47
951,Luca Garritano,it,MF,DF,Frosinone,Serie A,29,1994,5.4,10,5,7,2,1,5,15,33.3,10,13,0,13,4,14,8
952,Yarek Gasiorowski,es,DF,,Valencia,La Liga,18,2005,8.2,22,12,14,5,3,13,19,68.4,6,15,8,7,15,37,50
953,Johan Gastien,fr,MF,,Clermont Foot,Ligue 1,35,1988,25.1,43,22,18,21,4,23,81,28.4,58,31,9,22,36,79,24
954,Federico Gatti,it,DF,,Juventus,Serie A,25,1998,29.3,33,19,16,16,1,19,24,79.2,5,26,15,11,19,52,90
955,Federico Gattoni,ar,DF,FW,Sevilla,La Liga,24,1999,0.1,1,0,1,0,0,1,1,100.0,0,0,0,0,0,1,1
956,Gavi,es,MF,FW,Barcelona,La Liga,18,2004,10.5,39,21,20,14,5,18,36,50.0,18,19,3,16,8,47,16
957,Paulo Gazzaniga,ar,GK,,Girona,La Liga,31,1992,38.0,2,2,2,0,0,2,4,50.0,2,0,0,0,0,2,12
958,Yann Gboho,fr,MF,FW,Toulouse,Ligue 1,22,2001,13.3,14,4,6,6,2,8,23,34.8,15,21,1,20,4,18,2
959,Dennis Geiger,de,MF,,Hoffenheim,Bundesliga,25,1998,0.7,1,0,1,0,0,0,0,,0,1,1,0,0,1,0
960,Gelabert,es,MF,FW,Toulouse,Ligue 1,22,2000,8.4,14,8,5,6,3,7,20,35.0,13,8,2,6,5,19,8
961,Francesco Gelli,it,MF,DF,Frosinone,Serie A,26,1996,17.3,19,13,8,4,7,10,24,41.7,14,19,3,16,11,30,27
962,Luca Gemello,it,GK,,Torino,Serie A,23,2000,2.0,0,0,0,0,0,0,1,0.0,1,0,0,0,0,0,1
963,Valentin Gendrey,fr,DF,,Lecce,Serie A,23,2000,33.8,55,33,35,16,4,30,46,65.2,16,40,11,29,35,90,99
964,Denis Genreau,au,MF,FW,Toulouse,Ligue 1,24,1999,5.2,12,9,6,6,0,8,15,53.3,7,8,1,7,6,18,8
965,Yannick Gerhardt,de,MF,DF,Wolfsburg,Bundesliga,29,1994,18.1,31,20,16,12,3,9,32,28.1,23,15,2,13,7,38,35
966,Anwar El Ghazi,nl,MF,DF,Mainz 05,Bundesliga,28,1995,0.6,0,0,0,0,0,0,1,0.0,1,0,0,0,0,0,0
967,Farés Ghedjemis,fr,FW,MF,Frosinone,Serie A,20,2002,2.0,2,0,1,0,1,0,2,0.0,2,2,0,2,1,3,2
968,Saman Ghoddos,ir,DF,,Brentford,Premier League,29,1993,8.2,28,19,19,7,2,17,31,54.8,14,9,2,7,5,33,12
969,Lautaro Gianetti,ar,DF,,Udinese,Serie A,29,1993,7.0,9,4,7,2,0,4,5,80.0,1,10,6,4,19,28,39
970,Morgan Gibbs-White,eng,MF,FW,Nott'ham Forest,Premier League,23,2000,35.1,36,24,6,20,10,14,33,42.4,19,31,8,23,17,53,21
971,Samuel Gigot,fr,DF,,Marseille,Ligue 1,29,1993,19.2,33,22,16,13,4,13,19,68.4,6,28,18,10,25,58,93
972,Bryan Gil,es,FW,MF,Tottenham,Premier League,22,2001,2.3,1,0,0,0,1,1,4,25.0,3,3,0,3,3,4,4
973,David Gil,es,GK,,Cádiz,La Liga,29,1994,4.1,0,0,0,0,0,0,1,0.0,1,0,0,0,0,0,3
974,Mario Gila,es,DF,,Lazio,Serie A,22,2000,20.1,32,14,23,8,1,19,34,55.9,15,27,14,13,20,52,69
975,Alfie Gilchrist,eng,DF,,Chelsea,Premier League,19,2003,2.3,4,0,4,0,0,2,5,40.0,3,6,3,3,3,7,11
976,Billy Gilmour,sct,MF,,Brighton,Premier League,22,2001,23.6,26,16,14,10,2,11,35,31.4,24,23,9,14,11,37,14
977,Benedikt Gimber,de,DF,,Heidenheim,Bundesliga,26,1997,22.5,40,24,25,14,1,19,35,54.3,16,27,17,10,16,56,101
978,Gvidas Gineitis,lt,MF,,Torino,Serie A,19,2004,6.0,11,7,3,8,0,4,7,57.1,3,10,4,6,4,15,9
979,Matthias Ginter,de,DF,,Freiburg,Bundesliga,29,1994,21.3,29,15,19,9,1,16,29,55.2,13,40,26,14,16,45,93
980,Olivier Giroud,fr,FW,,Milan,Serie A,36,1986,26.3,17,11,6,6,5,2,14,14.3,12,14,3,11,6,23,22
981,Jamie Gittens,eng,FW,MF,Dortmund,Bundesliga,18,2004,11.8,14,7,6,7,1,2,17,11.8,15,11,2,9,4,18,7
982,Klaus Gjasula,al,DF,MF,Darmstadt 98,Bundesliga,33,1989,15.1,44,22,18,25,1,17,30,56.7,13,26,14,12,19,63,42
983,Serge Gnabry,de,FW,MF,Bayern Munich,Bundesliga,28,1995,4.8,8,5,0,5,3,2,13,15.4,11,5,0,5,3,11,2
984,Ben Godfrey,eng,DF,,Everton,Premier League,25,1998,12.4,30,20,17,8,5,15,28,53.6,13,14,8,6,16,46,57
985,Edoardo Goldaniga,it,DF,,Cagliari,Serie A,29,1993,11.2,12,7,9,3,0,4,10,40.0,6,11,7,4,15,27,37
986,Pierluigi Gollini,it,GK,,Napoli,Serie A,28,1995,7.0,1,1,1,0,0,1,1,100.0,0,0,0,0,1,2,2
987,Aleksandr Golovin,ru,MF,FW,Monaco,Ligue 1,27,1996,23.9,42,30,14,22,6,15,42,35.7,27,37,3,34,21,63,14
988,André Gomes,pt,MF,FW,Everton,Premier League,30,1993,5.6,7,4,2,3,2,3,13,23.1,10,10,1,9,3,10,4
989,Angel Gomes,eng,MF,,Lille,Ligue 1,22,2000,28.6,26,13,4,15,7,14,32,43.8,18,23,6,17,18,44,28
990,João Gomes,br,MF,,Wolves,Premier League,22,2001,29.4,128,74,67,49,12,44,99,44.4,55,51,8,43,18,146,29
991,Toti Gomes,pt,DF,,Wolves,Premier League,24,1999,30.8,44,25,32,8,4,24,37,64.9,13,40,19,21,26,70,93
992,Joe Gomez,eng,DF,,Liverpool,Premier League,26,1997,19.8,47,31,24,16,7,30,63,47.6,33,26,4,22,19,66,50
993,Maxi Gómez,uy,FW,,Cádiz,La Liga,26,1996,12.9,6,4,2,3,1,3,5,60.0,2,8,3,5,3,9,3
994,Moi Gómez,es,MF,FW,Osasuna,La Liga,29,1994,22.3,30,19,7,19,4,9,24,37.5,15,15,1,14,11,41,22
995,Papu Gómez,ar,MF,FW,Monza,Serie A,35,1988,0.5,0,0,0,0,0,0,2,0.0,2,0,0,0,1,1,0
996,Sergio Gómez,es,FW,MF,Manchester City,Premier League,22,2000,0.6,1,0,0,1,0,1,2,50.0,1,0,0,0,1,2,0
997,Unai Gómez,es,MF,,Athletic Club,La Liga,20,2003,9.7,12,10,2,6,4,5,10,50.0,5,13,2,11,2,14,9
998,Iron Gomis,fr,MF,,Salernitana,Serie A,23,1999,1.5,4,1,2,2,0,0,1,0.0,1,2,0,2,2,6,2
999,Maxime Gonalons,fr,MF,,Clermont Foot,Ligue 1,34,1989,14.4,47,33,14,27,6,25,57,43.9,32,18,3,15,20,67,11
1000,Édgar González,es,DF,MF,Almería,La Liga,26,1997,28.0,45,21,22,20,3,25,49,51.0,24,48,28,20,38,83,130
1001,Enso Gonzalez,py,MF,DF,Wolves,Premier League,18,2005,0.0,0,0,0,0,0,0,1,0.0,1,0,0,0,0,0,0
1002,Fabio González,es,MF,,Las Palmas,La Liga,26,1997,1.4,2,2,2,0,0,1,2,50.0,1,2,0,2,0,2,0
1003,Giovanni González,uy,DF,,Mallorca,La Liga,28,1994,27.4,73,45,37,32,4,40,81,49.4,41,24,3,21,31,104,60
1004,Hugo González,es,MF,FW,Valencia,La Liga,20,2003,1.0,2,1,0,2,0,0,0,,0,0,0,0,0,2,0
1005,Iñaki González,es,MF,,Las Palmas,La Liga,19,2004,0.1,1,0,1,0,0,0,0,,0,0,0,0,0,1,1
1006,Joan Gonzàlez,es,MF,,Lecce,Serie A,21,2002,14.3,31,18,16,12,3,17,28,60.7,11,20,3,17,5,36,9
1007,Nicolás González,ar,FW,,Fiorentina,Serie A,25,1998,21.3,28,18,15,8,5,8,28,28.6,20,26,1,25,12,40,9
1008,Urko González,es,MF,,Real Sociedad,La Liga,22,2001,1.7,4,1,0,3,1,2,2,100.0,0,1,0,1,1,5,6
1009,Anthony Gordon,eng,FW,,Newcastle Utd,Premier League,22,2001,32.1,55,34,16,28,11,22,64,34.4,42,27,0,27,7,62,7
1010,Kaide Gordon,eng,FW,,Liverpool,Premier League,18,2004,0.0,0,0,0,0,0,0,0,,0,0,0,0,0,0,0
1011,Daniel Gore,eng,MF,,Manchester Utd,Premier League,18,2004,0.0,1,1,0,1,0,1,1,100.0,0,0,0,0,1,2,0
1012,Leon Goretzka,de,MF,,Bayern Munich,Bundesliga,28,1995,24.9,41,23,18,14,9,24,54,44.4,30,44,8,36,31,72,42
1013,Mathieu Gorgelin,fr,GK,,Le Havre,Ligue 1,32,1990,1.0,0,0,0,0,0,0,0,,0,0,0,0,0,0,0
1014,Andoni Gorosabel,es,DF,,Alavés,La Liga,26,1996,31.7,62,42,40,17,5,38,75,50.7,37,24,8,16,28,90,69
1015,Robin Gosens,de,DF,MF,Union Berlin,Bundesliga,29,1994,25.4,63,44,25,31,7,30,44,68.2,14,52,9,43,36,99,75
1016,Mario Götze,de,MF,,Eint Frankfurt,Bundesliga,31,1992,23.0,51,34,18,25,8,28,62,45.2,34,19,3,16,14,65,10
1017,Amine Gouiri,dz,FW,MF,Rennes,Ligue 1,23,2000,23.0,20,10,4,11,5,8,19,42.1,11,18,1,17,14,34,12
1018,Jeffrey Gouweleeuw,nl,DF,,Augsburg,Bundesliga,32,1991,28.8,35,23,13,17,5,16,25,64.0,9,44,24,20,35,70,108
1019,Pablo Gozalbez,es,MF,FW,Valencia,La Liga,22,2001,1.1,1,0,0,0,1,1,6,16.7,5,0,0,0,1,2,2
1020,Jonathan Gradit,fr,DF,,Lens,Ligue 1,30,1992,23.5,32,20,15,14,3,19,35,54.3,16,30,17,13,37,69,61
1021,Jens Grahl,de,GK,,Eint Frankfurt,Bundesliga,34,1988,2.0,0,0,0,0,0,0,0,,0,0,0,0,0,0,3
1022,Samuel Grandsir,fr,MF,FW,Le Havre,Ligue 1,26,1996,6.7,16,12,5,9,2,8,18,44.4,10,4,0,4,3,19,3
1023,Alberto Grassi,it,MF,,Empoli,Serie A,28,1995,20.1,30,18,13,13,4,10,26,38.5,16,26,11,15,41,71,37
1024,Ryan Gravenberch,nl,MF,,Liverpool,Premier League,21,2002,12.5,26,12,5,13,8,12,29,41.4,17,20,2,18,14,40,11
1025,Ryan Gravenberch,nl,FW,,Bayern Munich,Bundesliga,21,2002,0.1,0,0,0,0,0,0,0,,0,0,0,0,0,0,0
1026,Adrian Grbić,at,FW,,Lorient,Ligue 1,26,1996,0.3,0,0,0,0,0,0,0,,0,0,0,0,0,0,0
1027,Ivo Grbić,hr,GK,,Sheffield Utd,Premier League,27,1996,8.6,0,0,0,0,0,0,1,0.0,1,1,0,1,0,0,9
1028,Jack Grealish,eng,FW,MF,Manchester City,Premier League,27,1995,11.2,13,8,6,7,0,6,12,50.0,6,13,2,11,6,19,5
1029,Mason Greenwood,eng,MF,FW,Getafe,La Liga,21,2001,29.6,11,6,3,5,3,4,21,19.0,17,9,0,9,4,15,4
1030,Michael Gregoritsch,at,FW,,Freiburg,Bundesliga,29,1994,18.7,16,12,8,5,3,2,14,14.3,12,17,4,13,9,25,27
1031,Dominik Greif,sk,GK,,Mallorca,La Liga,26,1997,1.0,0,0,0,0,0,0,0,,0,0,0,0,0,0,0
1032,Antoine Griezmann,fr,FW,MF,Atlético Madrid,La Liga,32,1991,29.4,33,19,14,14,5,15,41,36.6,26,34,3,31,10,43,23
1033,Vincenzo Grifo,it,MF,FW,Freiburg,Bundesliga,30,1993,25.8,31,20,14,11,6,14,31,45.2,17,22,1,21,15,46,20
1034,Florian Grillitsch,at,DF,MF,Hoffenheim,Bundesliga,27,1995,25.5,54,28,31,19,4,22,54,40.7,32,41,20,21,52,106,90
1035,Álex Grimaldo,es,DF,,Leverkusen,Bundesliga,27,1995,30.9,45,24,26,10,9,30,55,54.5,25,32,7,25,22,67,41
1036,Christian Groß,de,DF,MF,Werder Bremen,Bundesliga,34,1989,8.9,21,16,11,9,1,11,25,44.0,14,17,6,11,13,34,28
1037,Pascal Groß,de,MF,DF,Brighton,Premier League,32,1991,34.6,70,46,33,21,16,31,72,43.1,41,41,8,33,22,92,32
1038,Brajan Gruda,de,MF,FW,Mainz 05,Bundesliga,19,2004,18.2,22,14,5,11,6,14,24,58.3,10,15,0,15,5,27,4
1039,Ilia Gruev,bg,MF,,Werder Bremen,Bundesliga,23,2000,0.0,0,0,0,0,0,0,0,,0,0,0,0,0,0,0
1040,Vicente Guaita,es,GK,,Celta Vigo,La Liga,36,1987,26.7,1,1,1,0,0,1,2,50.0,1,0,0,0,0,1,9
1041,Andrés Guardado,mx,MF,,Betis,La Liga,36,1986,5.0,17,12,5,9,3,7,14,50.0,7,4,2,2,6,23,5
1042,Sergi Guardiola,es,FW,MF,Cádiz,La Liga,32,1991,5.5,10,7,2,6,2,4,9,44.4,5,10,0,10,0,10,4
1043,Nemanja Gudelj,rs,DF,MF,Sevilla,La Liga,31,1991,19.4,31,24,18,10,3,17,31,54.8,14,17,9,8,27,58,56
1044,Gabriel Gudmundsson,se,DF,FW,Lille,Ligue 1,24,1999,14.1,22,16,7,13,2,12,20,60.0,8,14,3,11,15,37,25
1045,Gonçalo Guedes,pt,FW,MF,Villarreal,La Liga,26,1996,10.6,6,4,1,2,3,2,7,28.6,5,8,0,8,2,8,3
1046,Axel Gueguin,fr,DF,FW,Montpellier,Ligue 1,18,2005,1.5,9,5,6,2,1,2,6,33.3,4,2,0,2,2,11,6
1047,Marc Guéhi,eng,DF,,Crystal Palace,Premier League,23,2000,22.5,28,19,21,7,0,14,24,58.3,10,22,17,5,18,46,89
1048,Mattéo Guendouzi,fr,MF,,Lazio,Serie A,24,1999,26.3,34,15,11,18,5,21,49,42.9,28,24,6,18,21,55,24
1049,Mattéo Guendouzi,fr,MF,,Marseille,Ligue 1,24,1999,0.2,0,0,0,0,0,0,0,,0,1,1,0,0,0,0
1050,Javier Guerra,es,MF,,Valencia,La Liga,20,2003,27.8,54,24,25,22,7,22,58,37.9,36,27,7,20,18,72,44
1051,Raphaël Guerreiro,pt,DF,MF,Bayern Munich,Bundesliga,29,1993,13.2,19,16,6,9,4,9,15,60.0,6,7,1,6,15,34,5
1052,Axel Guessand,fr,DF,,Udinese,Serie A,18,2004,0.5,1,1,0,1,0,1,1,100.0,0,1,0,1,0,1,0
1053,Evann Guessand,ci,FW,,Nice,Ligue 1,22,2001,17.3,16,7,2,7,7,6,7,85.7,1,12,1,11,12,28,7
1054,Ander Guevara,es,MF,,Alavés,La Liga,26,1997,32.6,59,32,28,25,6,31,64,48.4,33,34,12,22,13,72,46
1055,Pape Gueye,sn,MF,DF,Marseille,Ligue 1,24,1999,8.5,33,21,11,19,3,13,19,68.4,6,17,3,14,13,46,12
1056,Josuha Guilavogui,fr,DF,,Mainz 05,Bundesliga,32,1990,4.5,15,10,10,5,0,6,7,85.7,1,13,7,6,13,28,21
1057,Morgan Guilavogui,gn,FW,MF,Lens,Ligue 1,25,1998,6.3,21,10,4,12,5,5,11,45.5,6,11,2,9,4,25,7
1058,Frederic Guilbert,fr,DF,MF,Strasbourg,Ligue 1,28,1994,27.7,87,50,49,30,8,47,72,65.3,25,39,10,29,71,158,99
1059,Hugo Guillamón,es,MF,,Valencia,La Liga,23,2000,14.6,24,15,7,14,3,11,17,64.7,6,8,3,5,12,36,25
1060,Bruno Guimarães,br,MF,,Newcastle Utd,Premier League,25,1997,36.3,88,53,45,32,11,40,77,51.9,37,52,14,38,35,123,20
1061,Serhou Guirassy,gn,FW,,Stuttgart,Bundesliga,27,1996,24.5,6,3,1,4,1,2,5,40.0,3,8,1,7,6,12,29
1062,Marc Guiu,es,FW,MF,Barcelona,La Liga,17,2006,0.8,1,0,0,1,0,0,0,,0,0,0,0,0,1,0
1063,Péter Gulácsi,hu,GK,,RB Leipzig,Bundesliga,33,1990,13.0,0,0,0,0,0,0,0,,0,0,0,0,0,0,8
1064,Manuel Gulde,de,DF,,Freiburg,Bundesliga,32,1991,22.7,37,23,23,13,1,17,23,73.9,6,24,14,10,25,62,82
1065,Arda Güler,tr,FW,MF,Real Madrid,La Liga,18,2005,4.2,6,4,1,3,2,5,8,62.5,3,0,0,0,2,8,5
1066,Gerard Gumbau,es,MF,,Granada,La Liga,28,1994,29.7,55,34,21,30,4,23,62,37.1,39,24,5,19,25,80,30
1067,Robert Gumny,pl,DF,,Augsburg,Bundesliga,25,1998,5.3,6,5,1,3,2,1,5,20.0,4,13,5,8,7,13,15
1068,İlkay Gündoğan,de,MF,,Barcelona,La Liga,32,1990,33.3,32,22,14,16,2,12,39,30.8,27,19,4,15,21,53,18
1069,Christian Günter,de,DF,,Freiburg,Bundesliga,30,1993,11.8,20,12,9,11,0,7,18,38.9,11,9,3,6,2,22,16
1070,Jon Guridi,es,MF,,Alavés,La Liga,28,1995,29.8,42,24,10,27,5,12,45,26.7,33,23,3,20,22,64,22
1071,Gorka Guruzeta,es,FW,,Athletic Club,La Liga,26,1996,24.6,34,23,6,25,3,9,30,30.0,21,36,2,34,17,51,23
1072,Malo Gusto,fr,DF,,Chelsea,Premier League,20,2003,19.5,55,27,34,15,6,35,52,67.3,17,28,4,24,17,72,43
1073,Miguel Gutiérrez,es,DF,,Girona,La Liga,22,2001,33.7,29,18,11,14,4,13,35,37.1,22,27,11,16,22,51,66
1074,Albert Guðmundsson,is,FW,MF,Genoa,Serie A,26,1997,33.5,23,10,8,10,5,12,44,27.3,32,15,2,13,11,34,13
1075,Joško Gvardiol,hr,DF,,Manchester City,Premier League,21,2002,25.9,55,33,21,24,10,21,38,55.3,17,36,12,24,27,82,37
1076,Emmanuel Gyasi,gh,DF,FW,Empoli,Serie A,29,1994,20.9,34,17,18,13,3,15,32,46.9,17,30,12,18,5,39,27
1077,Norbert Gyömbér,sk,DF,,Salernitana,Serie A,31,1992,19.6,36,18,30,6,0,20,26,76.9,6,33,23,10,23,59,77
1078,Erling Haaland,no,FW,,Manchester City,Premier League,23,2000,28.4,6,3,0,3,3,2,3,66.7,1,11,1,10,2,8,16
1079,Nicolas Haas,ch,MF,,Empoli,Serie A,27,1996,1.0,5,3,1,2,2,3,3,100.0,0,1,0,1,1,6,1
1080,Janik Haberer,de,MF,DF,Union Berlin,Bundesliga,29,1994,13.6,36,24,16,13,7,22,45,48.9,23,21,4,17,12,48,18
1081,Robin Hack,de,FW,MF,Gladbach,Bundesliga,24,1998,15.0,15,8,6,7,2,4,17,23.5,13,16,0,16,14,29,21
1082,Antwoine Hackford,eng,FW,,Sheffield Utd,Premier League,19,2004,0.1,0,0,0,0,0,0,0,,0,0,0,0,0,0,0
1083,Munir El Haddadi,ma,FW,,Las Palmas,La Liga,27,1995,27.2,40,27,18,17,5,17,38,44.7,21,27,1,26,11,51,16
1084,Jaouen Hadjam,dz,DF,,Nantes,Ligue 1,20,2003,1.2,6,4,5,1,0,1,2,50.0,1,0,0,0,3,9,2
1085,Ianis Hagi,ro,MF,FW,Alavés,La Liga,24,1998,8.9,17,12,2,14,1,5,12,41.7,7,8,0,8,5,22,4
1086,Amadou Haidara,ml,MF,,RB Leipzig,Bundesliga,25,1998,17.0,42,27,24,16,2,23,41,56.1,18,28,6,22,21,63,37
1087,Massadio Haïdara,ml,DF,,Lens,Ligue 1,30,1992,8.2,9,8,5,3,1,4,6,66.7,2,7,2,5,11,20,32
1088,Oualid El Hajjam,ma,DF,MF,Le Havre,Ligue 1,32,1991,4.4,8,7,5,2,1,2,9,22.2,7,5,1,4,6,14,10
1089,Achraf Hakimi,ma,DF,,Paris S-G,Ligue 1,24,1998,21.5,29,19,14,9,6,17,34,50.0,17,28,4,24,12,41,28
1090,Lewis Hall,eng,DF,,Newcastle Utd,Premier League,18,2004,8.7,28,18,17,10,1,17,28,60.7,11,17,2,15,12,40,22
1091,Sébastien Haller,ci,FW,,Dortmund,Bundesliga,29,1994,4.4,1,0,0,1,0,1,1,100.0,0,4,1,3,0,1,7
1092,Gustavo Hamer,nl,MF,,Sheffield Utd,Premier League,26,1997,32.3,39,21,17,15,7,16,59,27.1,43,33,9,24,29,68,35
1093,Andreas Hanche-Olsen,no,DF,,Mainz 05,Bundesliga,26,1997,11.0,20,12,10,8,2,10,16,62.5,6,10,4,6,11,31,41
1094,Isak Hansen-Aarøen,no,MF,,Werder Bremen,Bundesliga,18,2004,0.3,0,0,0,0,0,0,1,0.0,1,1,0,1,1,1,0
1095,Ridgeciano Haps,sr,DF,,Genoa,Serie A,30,1993,8.6,7,6,3,2,2,5,8,62.5,3,3,0,3,6,13,11
1096,Genki Haraguchi,jp,MF,,Stuttgart,Bundesliga,32,1991,0.3,1,1,1,0,0,0,0,,0,0,0,0,0,1,1
1097,Amine Harit,ma,MF,FW,Marseille,Ligue 1,26,1997,20.2,28,16,8,17,3,13,37,35.1,24,31,4,27,12,40,4
1098,Luke Harris,wls,MF,,Fulham,Premier League,18,2005,0.8,1,1,1,0,0,0,1,0.0,1,0,0,0,0,1,0
1099,Jack Harrison,eng,MF,FW,Everton,Premier League,26,1996,24.6,37,22,12,12,13,17,49,34.7,32,25,5,20,12,49,24
1100,Abdou Harroui,nl,MF,FW,Frosinone,Serie A,25,1998,11.3,23,11,11,11,1,8,16,50.0,8,19,3,16,5,28,8
1101,Makoto Hasebe,jp,DF,MF,Eint Frankfurt,Bundesliga,39,1984,2.4,4,2,2,2,0,3,6,50.0,3,2,1,1,2,6,5
1102,Daiki Hashioka,jp,DF,,Luton Town,Premier League,24,1999,6.6,11,5,6,4,1,5,11,45.5,6,12,7,5,8,19,20
1103,Hans Hateboer,nl,DF,,Atalanta,Serie A,29,1994,12.4,12,5,8,2,2,5,15,33.3,10,21,7,14,4,16,21
1104,Pantelis Hatzidiakos,gr,DF,,Cagliari,Serie A,26,1997,9.5,22,10,12,10,0,10,17,58.8,7,14,5,9,13,35,30
1105,Kai Havertz,de,MF,FW,Arsenal,Premier League,24,1999,29.3,35,15,7,21,7,14,39,35.9,25,26,1,25,20,55,22
1106,Thorgan Hazard,be,DF,,Dortmund,Bundesliga,30,1993,0.1,0,0,0,0,0,0,0,,0,0,0,0,0,0,0
1107,Jan Paul van Hecke,nl,DF,,Brighton,Premier League,23,2000,26.3,47,26,25,19,3,27,45,60.0,18,49,27,22,30,77,76
1108,Hwang Hee-chan,kr,FW,MF,Wolves,Premier League,27,1996,23.5,20,10,11,8,1,9,24,37.5,15,19,1,18,10,30,9
1109,Silvan Hefti,ch,MF,DF,Genoa,Serie A,25,1997,1.3,6,1,2,3,1,4,7,57.1,3,2,0,2,0,6,1
1110,Silvan Hefti,ch,DF,FW,Montpellier,Ligue 1,25,1997,7.9,21,15,10,7,4,15,29,51.7,14,7,2,5,8,29,11
1111,Dominique Heintz,de,DF,,Köln,Bundesliga,29,1993,6.3,12,5,6,6,0,8,12,66.7,4,6,1,5,3,15,28
1112,Dean Henderson,eng,GK,,Crystal Palace,Premier League,26,1997,18.0,1,1,1,0,0,1,2,50.0,1,0,0,0,0,1,8
1113,Liam Henderson,sct,MF,,Empoli,Serie A,27,1996,0.1,0,0,0,0,0,0,0,,0,0,0,0,0,0,0
1114,Benjamin Henrichs,de,DF,,RB Leipzig,Bundesliga,26,1997,28.1,68,39,32,26,10,27,58,46.6,31,49,4,45,33,101,37
1115,Henrique,br,DF,,Lyon,Ligue 1,29,1994,6.7,10,6,6,4,0,6,11,54.5,5,8,2,6,10,20,3
1116,Luis Henrique,br,FW,DF,Marseille,Ligue 1,21,2001,8.7,8,7,4,1,3,4,7,57.1,3,9,0,9,8,16,3
1117,Luiz Henrique,br,FW,,Betis,La Liga,22,2001,6.8,15,11,4,10,1,9,14,64.3,5,11,0,11,5,20,8
1118,Matheus Henrique,br,MF,,Sassuolo,Serie A,25,1997,27.8,43,29,21,18,4,18,43,41.9,25,18,8,10,25,68,31
1119,Rico Henry,eng,DF,,Brentford,Premier League,26,1997,4.5,7,5,3,3,1,6,7,85.7,1,8,3,5,5,12,5
1120,Thomas Henry,fr,FW,,Hellas Verona,Serie A,28,1994,3.7,0,0,0,0,0,0,0,,0,0,0,0,0,0,5
1121,Christophe Hérelle,mq,DF,,Metz,Ligue 1,30,1992,18.0,32,15,24,7,1,13,23,56.5,10,16,9,7,18,50,68
1122,Mario Hermoso,es,DF,,Atlético Madrid,La Liga,28,1995,28.4,46,25,29,13,4,28,51,54.9,23,27,9,18,30,76,93
1123,Javi Hernández,es,DF,,Cádiz,La Liga,25,1998,27.9,43,24,26,12,5,25,46,54.3,21,34,9,25,19,62,72
1124,Aridane Hernández,es,DF,,Rayo Vallecano,La Liga,34,1989,18.8,10,8,5,4,1,4,11,36.4,7,19,14,5,14,24,98
1125,Lucas Hernández,fr,DF,,Paris S-G,Ligue 1,27,1996,21.2,52,36,28,15,9,29,50,58.0,21,21,5,16,27,79,38
1126,Luis Hernández,es,DF,,Cádiz,La Liga,34,1989,8.0,7,3,4,3,0,4,8,50.0,4,3,2,1,8,15,25
1127,Theo Hernández,fr,DF,,Milan,Serie A,25,1997,31.0,30,17,19,11,0,11,22,50.0,11,33,13,20,23,53,42
1128,Jorge Herrando,es,DF,,Osasuna,La Liga,22,2001,18.3,29,19,23,6,0,12,19,63.2,7,20,11,9,15,44,69
1129,Ander Herrera,es,MF,,Athletic Club,La Liga,33,1989,11.4,44,32,11,26,7,20,36,55.6,16,16,6,10,15,59,18
1130,Cristian Herrera,es,FW,MF,Las Palmas,La Liga,32,1991,1.8,1,1,0,1,0,1,2,50.0,1,1,0,1,0,1,2
1131,Sergio Herrera,es,GK,,Osasuna,La Liga,30,1993,31.9,2,2,2,0,0,2,3,66.7,1,0,0,0,0,2,22
1132,Yangel Herrera,ve,MF,,Girona,La Liga,25,1998,23.4,64,37,28,30,6,30,56,53.6,26,30,8,22,24,88,45
1133,Patrick Herrmann,de,FW,DF,Gladbach,Bundesliga,32,1991,1.0,4,4,2,1,1,2,2,100.0,0,1,0,1,1,5,2
1134,Juan Herzog,es,DF,,Las Palmas,La Liga,20,2003,3.2,6,5,5,1,0,3,6,50.0,3,4,1,3,2,8,17
1135,Son Heung-min,kr,FW,,Tottenham,Premier League,31,1992,32.6,21,13,6,7,8,10,21,47.6,11,4,1,3,8,29,4
1136,Aaron Hickey,sct,DF,,Brentford,Premier League,21,2002,7.9,16,9,9,3,4,7,7,100.0,0,7,3,4,3,19,10
1137,Isak Hien,se,DF,,Hellas Verona,Serie A,24,1999,9.6,17,10,10,7,0,10,19,52.6,9,12,5,7,7,24,33
1138,Isak Hien,se,DF,,Atalanta,Serie A,24,1999,10.4,18,12,8,10,0,7,15,46.7,8,12,5,7,14,32,33
1139,James Hill,eng,DF,,Bournemouth,Premier League,21,2002,0.8,3,2,1,2,0,1,1,100.0,0,3,2,1,3,6,8
1140,Piero Hincapié,ec,DF,,Leverkusen,Bundesliga,21,2002,16.5,35,22,14,17,4,13,17,76.5,4,18,7,11,13,48,43
1141,Jack Hinshelwood,eng,DF,,Brighton,Premier League,18,2005,9.7,14,5,7,4,3,5,13,38.5,8,6,2,4,14,28,18
1142,Adam Hložek,cz,MF,FW,Leverkusen,Bundesliga,21,2002,5.1,10,4,2,4,4,3,7,42.9,4,4,1,3,2,12,1
1143,Nicolas Höfler,de,MF,,Freiburg,Bundesliga,33,1990,25.9,63,40,36,20,7,22,49,44.9,27,30,16,14,31,94,45
1144,Jonas Hofmann,de,MF,,Leverkusen,Bundesliga,31,1992,24.5,20,14,6,9,5,10,24,41.7,14,18,0,18,8,28,6
1145,Philipp Hofmann,de,FW,,Bochum,Bundesliga,30,1993,17.5,10,5,4,5,1,4,7,57.1,3,11,2,9,4,14,17
1146,Lucas Höler,de,FW,MF,Freiburg,Bundesliga,29,1994,25.6,32,24,14,10,8,4,23,17.4,19,19,4,15,15,47,35
1147,Mason Holgate,eng,DF,,Sheffield Utd,Premier League,26,1996,7.9,12,7,5,6,1,5,12,41.7,7,12,5,7,11,23,40
1148,Fabian Holland,de,MF,DF,Darmstadt 98,Bundesliga,33,1990,20.4,47,26,18,21,8,20,37,54.1,17,22,12,10,24,71,29
1149,Benedict Hollerbach,de,FW,MF,Union Berlin,Bundesliga,22,2001,14.2,17,11,5,7,5,7,22,31.8,15,28,0,28,4,21,3
1150,Emil Holm,se,DF,,Atalanta,Serie A,23,2000,10.5,28,19,17,9,2,16,36,44.4,20,25,3,22,7,35,25
1151,Gerrit Holtmann,ph,MF,FW,Darmstadt 98,Bundesliga,28,1995,4.4,8,5,3,4,1,7,10,70.0,3,7,0,7,2,10,4
1152,Martin Hongla,cm,MF,,Hellas Verona,Serie A,25,1998,12.0,24,13,9,13,2,8,11,72.7,3,8,3,5,7,31,24
1153,Martin Hongla,cm,MF,DF,Granada,La Liga,25,1998,6.2,7,3,2,5,0,3,9,33.3,6,6,3,3,6,13,13
1154,Franck Honorat,fr,DF,FW,Gladbach,Bundesliga,26,1996,26.1,25,13,13,10,2,11,20,55.0,9,22,3,19,9,34,35
1155,Mathias Honsak,at,FW,MF,Darmstadt 98,Bundesliga,26,1996,11.3,14,7,7,6,1,6,20,30.0,14,14,2,12,8,22,25
1156,Sydney van Hooijdonk,nl,FW,,Bologna,Serie A,23,2000,2.4,3,0,0,2,1,1,2,50.0,1,1,1,0,1,4,4
1157,Fraser Hornby,sct,FW,MF,Darmstadt 98,Bundesliga,23,1999,2.4,0,0,0,0,0,0,1,0.0,1,2,1,1,0,0,4
1158,Lukáš Hrádecký,fi,GK,,Leverkusen,Bundesliga,33,1989,33.0,0,0,0,0,0,0,1,0.0,1,1,0,1,0,0,10
1159,Xabier Huarte Armendáriz,es,MF,,Osasuna,La Liga,22,2001,0.1,0,0,0,0,0,0,0,,0,0,0,0,0,0,0
1160,Timo Hübers,de,DF,,Köln,Bundesliga,27,1996,30.9,68,47,51,14,3,49,80,61.3,31,54,28,26,63,131,168
1161,Callum Hudson-Odoi,eng,FW,MF,Nott'ham Forest,Premier League,22,2000,20.6,18,8,4,5,9,7,28,25.0,21,16,1,15,7,25,12
1162,Will Hughes,eng,MF,,Crystal Palace,Premier League,28,1995,21.0,61,33,30,20,11,24,48,50.0,24,36,14,22,21,82,25
1163,Dean Huijsen,es,DF,,Roma,Serie A,18,2005,5.7,10,5,5,5,0,1,4,25.0,3,7,4,3,4,14,26
1164,Dean Huijsen,es,DF,,Juventus,Serie A,18,2005,0.1,0,0,0,0,0,0,0,,0,0,0,0,0,0,1
1165,Mats Hummels,de,DF,,Dortmund,Bundesliga,34,1988,17.6,52,34,34,12,6,30,53,56.6,23,33,11,22,33,85,82
1166,Denis Huseinbasic,ba,MF,,Köln,Bundesliga,22,2001,18.1,38,18,17,15,6,20,31,64.5,11,26,1,25,13,51,14
1167,Elseid Hysaj,al,DF,,Lazio,Serie A,29,1994,13.3,24,14,8,13,3,15,24,62.5,9,16,6,10,17,41,31
1168,Pierre Højbjerg,dk,MF,,Tottenham,Premier League,27,1995,14.6,32,18,13,17,2,13,34,38.2,21,21,7,14,19,51,30
1169,Rasmus Højlund,dk,FW,,Manchester Utd,Premier League,20,2003,24.0,11,7,2,3,6,5,13,38.5,8,9,1,8,1,12,19
1170,Iago,br,DF,,Augsburg,Bundesliga,26,1997,18.0,36,17,22,10,4,17,33,51.5,16,39,8,31,18,54,43
1171,Pablo Ibáñez,es,MF,,Osasuna,La Liga,24,1998,12.8,18,9,5,7,6,5,21,23.8,16,26,3,23,9,27,17
1172,Arijon Ibrahimović,de,FW,DF,Frosinone,Serie A,17,2005,5.3,7,6,4,2,1,1,9,11.1,8,4,0,4,1,8,3
1173,Iglesias,es,DF,FW,Getafe,La Liga,25,1998,15.7,41,22,25,11,5,21,33,63.6,12,18,7,11,16,57,53
1174,Borja Iglesias,es,FW,,Betis,La Liga,30,1993,4.5,0,0,0,0,0,0,3,0.0,3,0,0,0,2,2,2
1175,Borja Iglesias,es,FW,,Leverkusen,Bundesliga,30,1993,2.8,1,0,0,1,0,0,1,0.0,1,2,0,2,1,2,1
1176,Igor,br,DF,,Brighton,Premier League,25,1998,18.2,25,18,7,16,2,17,29,58.6,12,22,9,13,14,39,52
1177,Jonathan Ikone,fr,FW,,Fiorentina,Serie A,25,1998,18.7,22,11,7,9,6,10,17,58.8,7,12,0,12,3,25,8
1178,Chukwubuikem Ikwuemesi,ng,FW,,Salernitana,Serie A,21,2001,11.8,3,1,0,2,1,2,6,33.3,4,1,1,0,1,4,8
1179,Andrej Ilic,rs,FW,,Lille,Ligue 1,23,2000,0.1,0,0,0,0,0,0,0,,0,0,0,0,0,0,0
1180,Ivan Ilić,rs,MF,,Torino,Serie A,22,2001,23.3,22,8,9,10,3,13,27,48.1,14,20,7,13,20,42,31
1181,Samuel Iling-Junior,eng,DF,MF,Juventus,Serie A,19,2003,9.0,23,13,9,11,3,11,18,61.1,7,17,5,12,6,29,19
1182,Imanol,es,DF,,Athletic Club,La Liga,23,2000,5.8,7,5,1,5,1,5,18,27.8,13,6,0,6,7,14,15
1183,Joel Imasuen,us,FW,,Werder Bremen,Bundesliga,18,2004,0.0,0,0,0,0,0,0,0,,0,0,0,0,0,0,0
1184,Ciro Immobile,it,FW,,Lazio,Serie A,33,1990,18.4,11,9,2,5,4,3,14,21.4,11,9,3,6,5,16,11
1185,Gino Infantino,ar,MF,,Fiorentina,Serie A,20,2003,1.1,1,1,0,1,0,0,1,0.0,1,4,0,4,3,4,1
1186,Danny Ings,eng,FW,,West Ham,Premier League,31,1992,4.5,6,2,0,6,0,4,13,30.8,9,4,1,3,3,9,7
1187,Bonke Innocent,ng,MF,,Lorient,Ligue 1,27,1996,2.3,6,4,2,2,2,2,9,22.2,7,2,1,1,4,10,2
1188,Tim Iroegbunam,eng,MF,,Aston Villa,Premier League,20,2003,1.8,7,5,4,2,1,4,9,44.4,5,3,0,3,2,9,3
1189,Alexander Isak,se,FW,,Newcastle Utd,Premier League,23,1999,25.1,5,0,2,1,2,2,8,25.0,6,16,1,15,6,11,13
1190,Gustav Isaksen,dk,FW,,Lazio,Serie A,22,2001,11.9,4,3,2,1,1,1,9,11.1,8,11,1,10,4,8,4
1191,Isco,es,MF,,Betis,La Liga,31,1992,25.8,41,27,15,21,5,14,38,36.8,24,19,1,18,10,51,7
1192,Thomas Isherwood,se,DF,,Darmstadt 98,Bundesliga,25,1998,7.1,11,5,7,3,1,5,9,55.6,4,10,7,3,10,21,34
1193,Ismaily,br,DF,,Lille,Ligue 1,33,1990,27.4,72,47,34,25,13,31,60,51.7,29,33,6,27,32,104,77
1194,Ardian Ismajli,al,DF,,Empoli,Serie A,26,1996,22.7,26,16,18,6,2,18,23,78.3,5,28,17,11,23,49,126
1195,Yanis Issoufou,fr,MF,,Montpellier,Ligue 1,16,2006,0.1,0,0,0,0,0,0,0,,0,0,0,0,0,0,0
1196,Ko Itakura,jp,DF,MF,Gladbach,Bundesliga,26,1997,17.7,34,21,17,15,2,16,26,61.5,10,32,18,14,22,56,62
1197,Hiroki Ito,jp,DF,,Stuttgart,Bundesliga,24,1999,24.8,19,18,13,6,0,11,26,42.3,15,29,17,12,29,48,86
1198,Junya Ito,jp,FW,MF,Reims,Ligue 1,30,1993,30.2,33,15,11,14,8,10,36,27.8,26,23,1,22,14,47,7
1199,Diego Iturralde,es,DF,,Sevilla,La Liga,20,2003,0.4,0,0,0,0,0,0,0,,0,1,1,0,0,0,2
1200,Alex Iwobi,ng,MF,,Everton,Premier League,27,1996,1.6,2,0,1,0,1,2,3,66.7,1,2,0,2,1,3,0
1201,Alex Iwobi,ng,FW,MF,Fulham,Premier League,27,1996,24.4,29,18,12,15,2,12,25,48.0,13,16,0,16,14,43,9
1202,Armando Izzo,it,DF,,Monza,Serie A,31,1992,18.3,27,17,17,9,1,16,27,59.3,11,20,16,4,27,54,49
1203,Nicolas Jackson,sn,FW,,Chelsea,Premier League,22,2001,31.1,21,13,5,8,8,5,24,20.8,19,20,5,15,4,25,17
1204,Jérémy Jacquet,fr,MF,,Rennes,Ligue 1,18,2005,0.1,1,1,1,0,0,0,1,0.0,1,0,0,0,1,2,0
1205,Jérémy Jacquet,fr,DF,,Clermont Foot,Ligue 1,18,2005,2.8,4,3,4,0,0,3,3,100.0,0,7,3,4,6,10,10
1206,Lee Jae-sung,kr,MF,FW,Mainz 05,Bundesliga,30,1992,23.5,33,20,11,16,6,13,39,33.3,26,22,2,20,27,60,23
1207,Paul Jaeckel,de,DF,,Union Berlin,Bundesliga,25,1998,2.6,7,2,4,3,0,5,9,55.6,4,3,2,1,4,11,7
1208,Filip Jagiełło,pl,MF,,Genoa,Serie A,25,1997,0.4,0,0,0,0,0,0,1,0.0,1,1,1,0,1,1,0
1209,Kristijan Jakić,hr,MF,,Augsburg,Bundesliga,26,1997,11.7,28,14,14,10,4,15,33,45.5,18,13,1,12,20,48,15
1210,Kristijan Jakić,hr,MF,FW,Eint Frankfurt,Bundesliga,26,1997,2.2,3,3,1,2,0,1,3,33.3,2,1,0,1,2,5,2
1211,Ismail Jakobs,sn,DF,,Monaco,Ligue 1,23,1999,16.3,57,41,27,21,9,29,47,61.7,18,19,2,17,11,68,40
1212,Ablie Jallow,gm,MF,FW,Metz,Ligue 1,24,1998,10.2,8,5,2,3,3,3,5,60.0,2,4,0,4,8,16,3
1213,Reece James,eng,DF,,Chelsea,Premier League,23,1999,4.7,14,9,10,3,1,8,10,80.0,2,4,4,0,3,17,7
1214,Vitaly Janelt,de,MF,DF,Brentford,Premier League,25,1998,33.9,63,38,29,25,9,32,64,50.0,32,35,9,26,36,99,64
1215,Jakub Jankto,cz,MF,FW,Cagliari,Serie A,27,1996,9.7,12,9,9,1,2,8,20,40.0,12,5,1,4,5,17,20
1216,Tony Jantschke,de,DF,MF,Gladbach,Bundesliga,33,1990,0.3,1,1,1,0,0,1,1,100.0,0,2,2,0,1,2,4
1217,Adnan Januzaj,be,FW,MF,Sevilla,La Liga,28,1995,2.1,3,3,2,0,1,0,1,0.0,1,2,0,2,1,4,0
1218,Nuha Jatta,gm,FW,,RB Leipzig,Bundesliga,17,2006,0.0,0,0,0,0,0,0,0,,0,0,0,0,0,0,0
1219,Mikel Jauregizar,es,MF,,Athletic Club,La Liga,19,2003,1.7,0,0,0,0,0,0,6,0.0,6,5,0,5,0,0,2
1220,Luis Javier Suárez,co,FW,,Almería,La Liga,25,1997,10.2,7,5,2,5,0,2,6,33.3,4,11,0,11,0,7,13
1221,Danley Jean-Jacques,ht,MF,,Metz,Ligue 1,23,2000,29.8,54,28,24,21,9,19,56,33.9,37,48,7,41,44,98,44
1222,Salim El Jebari,ma,MF,,Atlético Madrid,La Liga,19,2004,0.1,1,0,0,1,0,0,0,,0,0,0,0,0,1,1
1223,Daniel Jebbison,eng,FW,,Sheffield Utd,Premier League,19,2003,0.2,0,0,0,0,0,0,0,,0,1,0,1,0,0,0
1224,Jeffinho,br,FW,MF,Lyon,Ligue 1,23,1999,3.4,11,4,3,5,3,4,11,36.4,7,1,0,1,0,11,0
1225,Fredrik Jensen,fi,MF,FW,Augsburg,Bundesliga,25,1997,14.9,23,11,9,8,6,14,28,50.0,14,30,1,29,12,35,21
1226,Mathias Jensen,dk,MF,,Brentford,Premier League,27,1996,24.5,54,32,25,22,7,26,95,27.4,69,41,6,35,23,77,25
1227,Moritz Jenz,de,DF,,Wolfsburg,Bundesliga,24,1999,19.4,34,24,21,11,2,14,21,66.7,7,29,17,12,26,60,94
1228,Gabriel Jesus,br,FW,,Arsenal,Premier League,26,1997,16.4,24,17,11,5,8,5,18,27.8,13,23,1,22,13,37,12
1229,Juan Jesus,br,DF,,Napoli,Serie A,32,1991,23.5,42,19,28,12,2,23,33,69.7,10,23,12,11,23,65,67
1230,Alejandro Jiménez,es,DF,,Milan,Serie A,18,2005,0.8,2,1,2,0,0,2,5,40.0,3,0,0,0,0,2,4
1231,Raúl Jiménez,mx,FW,,Fulham,Premier League,32,1991,15.5,18,12,4,8,6,7,20,35.0,13,11,3,8,4,22,13
1232,João Pedro,br,FW,MF,Brighton,Premier League,21,2001,22.7,31,14,10,13,8,14,24,58.3,10,15,2,13,11,42,28
1233,Joelinton,br,MF,FW,Newcastle Utd,Premier League,26,1996,14.2,39,27,21,15,3,14,38,36.8,24,23,7,16,19,58,11
1234,Ryan John Giles,eng,DF,MF,Luton Town,Premier League,23,2000,5.6,8,6,4,3,1,2,7,28.6,5,2,0,2,4,12,22
1235,Ben Johnson,eng,DF,FW,West Ham,Premier League,23,2000,6.0,11,7,7,3,1,9,14,64.3,5,2,1,1,5,16,14
1236,Brennan Johnson,wls,FW,,Tottenham,Premier League,22,2001,23.2,26,15,14,5,7,12,31,38.7,19,37,1,36,10,36,12
1237,Brennan Johnson,wls,FW,MF,Nott'ham Forest,Premier League,22,2001,2.6,4,1,1,1,2,2,4,50.0,2,4,1,3,0,4,0
1238,Joseph Johnson,eng,DF,,Luton Town,Premier League,17,2006,0.9,0,0,0,0,0,0,1,0.0,1,0,0,0,0,0,0
1239,Sam Johnstone,eng,GK,,Crystal Palace,Premier League,30,1993,20.0,1,0,1,0,0,1,1,100.0,0,0,0,0,1,2,5
1240,Curtis Jones,eng,MF,,Liverpool,Premier League,22,2001,13.0,27,14,12,12,3,10,23,43.5,13,22,0,22,7,34,8
1241,Frenkie de Jong,nl,MF,,Barcelona,La Liga,26,1997,18.2,43,26,14,23,6,8,19,42.1,11,18,8,10,14,57,28
1242,Joan Jordán,es,MF,,Sevilla,La Liga,29,1994,4.2,8,7,3,3,2,7,15,46.7,8,4,2,2,4,12,2
1243,Jordi,es,MF,DF,Getafe,La Liga,22,2001,6.4,16,11,3,11,2,7,15,46.7,8,7,2,5,8,24,7
1244,Jeremy Jorge,es,FW,,Getafe,La Liga,20,2003,0.0,0,0,0,0,0,0,0,,0,0,0,0,0,0,0
1245,Kaio Jorge,br,FW,,Frosinone,Serie A,21,2002,9.0,6,4,0,1,5,3,4,75.0,1,6,0,6,1,7,0
1246,Jorginho,it,MF,,Arsenal,Premier League,31,1991,10.2,24,10,6,10,8,11,23,47.8,12,17,1,16,12,36,7
1247,Willian José,br,FW,,Betis,La Liga,31,1991,21.9,7,3,1,2,4,2,5,40.0,3,8,2,6,2,9,15
1248,Joselu,es,FW,,Real Madrid,La Liga,33,1990,18.7,6,3,1,4,1,0,7,0.0,7,11,1,10,6,12,11
1249,Diogo Jota,pt,FW,,Liverpool,Premier League,26,1996,12.7,23,13,6,13,4,10,23,43.5,13,9,1,8,7,30,4
1250,Antoine Joujou,fr,FW,MF,Le Havre,Ligue 1,20,2003,8.7,20,12,7,7,6,11,21,52.4,10,11,2,9,7,27,5
1251,Luka Jović,rs,FW,,Milan,Serie A,25,1997,9.7,6,4,0,3,3,4,6,66.7,2,3,0,3,1,7,9
1252,Kamil Jóźwiak,pl,MF,,Granada,La Liga,25,1998,6.3,13,10,4,6,3,9,17,52.9,8,4,0,4,2,15,6
1253,Juanmi,es,FW,,Cádiz,La Liga,30,1993,9.7,9,4,2,7,0,2,9,22.2,7,6,0,6,6,15,3
1254,Juanpe,es,DF,,Girona,La Liga,32,1991,8.3,11,8,8,3,0,9,10,90.0,1,17,11,6,7,18,50
1255,Mads Juel Andersen,dk,DF,,Luton Town,Premier League,25,1997,4.4,6,5,4,2,0,4,4,100.0,0,9,6,3,8,14,29
1256,Christopher Jullien,fr,DF,,Montpellier,Ligue 1,30,1993,13.7,16,12,11,5,0,6,17,35.3,11,25,20,5,12,28,106
1257,Anthony Jung,de,DF,,Werder Bremen,Bundesliga,31,1991,28.7,37,23,21,14,2,18,33,54.5,15,39,17,22,24,61,102
1258,Eli Junior Kroupi,fr,FW,MF,Lorient,Ligue 1,17,2006,12.0,7,4,2,2,3,1,9,11.1,8,6,0,6,10,17,5
1259,Hamed Junior Traorè,ci,MF,,Bournemouth,Premier League,23,2000,0.5,1,0,1,0,0,1,3,33.3,2,3,0,3,0,1,0
1260,Hamed Junior Traorè,ci,MF,,Napoli,Serie A,23,2000,4.2,4,2,2,0,2,1,6,16.7,5,3,0,3,2,6,1
1261,Vinicius Júnior,br,FW,,Real Madrid,La Liga,23,2000,20.7,18,13,5,5,8,3,12,25.0,9,13,0,13,1,19,3
1262,Josip Juranović,hr,DF,,Union Berlin,Bundesliga,27,1995,14.4,20,14,11,7,2,10,21,47.6,11,17,3,14,12,32,27
1263,David Jurásek,cz,DF,,Hoffenheim,Bundesliga,22,2000,5.5,14,11,13,1,0,7,17,41.2,10,7,2,5,3,17,22
1264,Julian Justvan,de,FW,MF,Hoffenheim,Bundesliga,25,1998,0.5,1,0,1,0,0,1,2,50.0,1,1,0,1,0,1,0
1265,Julian Justvan,de,MF,FW,Darmstadt 98,Bundesliga,25,1998,11.4,10,4,2,7,1,3,17,17.6,14,12,2,10,11,21,6
1266,Filip Jørgensen,dk,GK,,Villarreal,La Liga,21,2002,36.0,3,1,3,0,0,3,4,75.0,1,0,0,0,2,5,10
1267,Mathias Jørgensen,dk,DF,,Brentford,Premier League,33,1990,12.1,17,12,15,1,1,11,19,57.9,8,9,5,4,12,29,40
1268,Mohamed Kaba,fr,MF,,Lecce,Serie A,21,2001,15.3,39,23,15,16,8,17,34,50.0,17,22,4,18,12,51,13
1269,Sory Kaba,gn,FW,,Las Palmas,La Liga,28,1995,8.0,2,0,0,2,0,0,5,0.0,5,6,0,6,0,2,9
1270,Ozan Kabak,tr,DF,,Hoffenheim,Bundesliga,23,2000,25.4,48,35,32,14,2,19,33,57.6,14,43,21,22,46,94,106
1271,Christian Kabasele,be,DF,,Udinese,Serie A,32,1991,9.6,10,7,4,5,1,2,11,18.2,9,15,9,6,12,22,56
1272,Issa Kaboré,bf,DF,,Luton Town,Premier League,22,2001,19.2,52,28,23,21,8,24,45,53.3,21,22,11,11,16,68,56
1273,Abdoul Kader Bamba,fr,FW,MF,Nantes,Ligue 1,29,1994,6.8,10,7,2,5,3,5,15,33.3,10,4,0,4,4,14,4
1274,Yaya Kader Fofana,ml,MF,DF,Reims,Ligue 1,19,2004,0.4,3,3,1,1,1,0,1,0.0,1,0,0,0,1,4,0
1275,Pavel Kadeřábek,cz,DF,FW,Hoffenheim,Bundesliga,31,1992,26.8,31,19,10,15,6,18,40,45.0,22,22,8,14,23,54,68
1276,Tino Kadewere,zw,FW,MF,Lyon,Ligue 1,27,1996,3.3,1,1,0,1,0,1,5,20.0,4,3,1,2,5,6,7
1277,Tino Kadewere,zw,FW,MF,Nantes,Ligue 1,27,1996,8.7,9,4,3,3,3,6,11,54.5,5,10,1,9,10,19,8
1278,Kaiky,br,DF,,Almería,La Liga,19,2004,5.8,7,4,6,0,1,3,6,50.0,3,9,7,2,3,10,29
1279,Florian Kainz,at,MF,FW,Köln,Bundesliga,30,1992,24.4,28,20,8,13,7,17,39,43.6,22,20,6,14,13,41,23
1280,Sasa Kalajdzic,at,FW,,Wolves,Premier League,26,1997,1.8,6,2,3,2,1,1,2,50.0,1,3,0,3,1,7,6
1281,Sasa Kalajdzic,at,FW,,Eint Frankfurt,Bundesliga,26,1997,3.6,2,2,0,2,0,0,0,,0,2,2,0,2,4,6
1282,Arnaud Kalimuendo,fr,FW,,Rennes,Ligue 1,21,2002,23.8,5,4,2,2,1,2,5,40.0,3,13,2,11,4,9,4
1283,Yayah Kallon,sl,FW,,Hellas Verona,Serie A,22,2001,0.0,0,0,0,0,0,0,0,,0,0,0,0,0,0,0
1284,Gedeon Kalulu,cd,DF,,Lorient,Ligue 1,25,1997,10.8,23,17,13,8,2,12,22,54.5,10,18,2,16,5,28,30
1285,Pierre Kalulu,fr,DF,,Milan,Serie A,23,2000,4.2,5,1,2,3,0,1,2,50.0,1,4,3,1,1,6,12
1286,Daichi Kamada,jp,MF,,Lazio,Serie A,26,1996,17.2,53,36,22,22,9,28,52,53.8,24,24,5,19,18,71,7
1287,Waren Kamanzi,no,DF,FW,Toulouse,Ligue 1,22,2000,13.2,36,24,16,16,4,13,23,56.5,10,11,3,8,9,45,35
1288,Boubacar Kamara,fr,MF,,Aston Villa,Premier League,23,1999,18.4,43,29,16,21,6,24,47,51.1,23,21,7,14,21,64,16
1289,Hassane Kamara,ci,DF,,Udinese,Serie A,29,1994,24.7,45,32,26,13,6,25,38,65.8,13,29,2,27,26,71,66
1290,Willy Kambwala,fr,DF,,Manchester Utd,Premier League,18,2004,3.7,3,1,1,2,0,1,3,33.3,2,6,3,3,4,7,14
1291,Jakub Kamiński,pl,FW,MF,Wolfsburg,Bundesliga,21,2002,5.3,14,5,12,2,0,3,6,50.0,3,3,0,3,2,16,5
1292,Thomas Kaminski,be,GK,,Luton Town,Premier League,30,1992,37.8,2,1,2,0,0,2,6,33.3,4,1,0,1,0,2,14
1293,Kevin Kampl,si,MF,,RB Leipzig,Bundesliga,32,1990,15.1,19,8,8,9,2,10,21,47.6,11,19,7,12,11,30,14
1294,Harry Kane,eng,FW,,Bayern Munich,Bundesliga,30,1993,31.5,13,9,4,4,5,6,18,33.3,12,12,4,8,6,19,14
1295,Lee Kang-in,kr,FW,MF,Paris S-G,Ligue 1,22,2001,16.3,26,13,7,9,10,15,36,41.7,21,7,0,7,6,32,3
1296,Yann Karamoh,fr,MF,FW,Torino,Serie A,25,1998,1.8,1,0,0,0,1,0,0,,0,0,0,0,0,1,1
1297,Yann Karamoh,fr,FW,MF,Montpellier,Ligue 1,25,1998,3.2,1,0,0,0,1,1,2,50.0,1,3,0,3,0,1,0
1298,Atakan Karazor,,MF,,Stuttgart,Bundesliga,26,1996,29.1,72,44,23,38,11,29,60,48.3,31,37,8,29,27,99,43
1299,Ayman Kari,fr,MF,,Lorient,Ligue 1,18,2004,9.9,18,14,9,9,0,12,19,63.2,7,19,2,17,6,24,9
1300,Emir Karic,at,DF,,Darmstadt 98,Bundesliga,26,1997,19.8,45,27,23,14,8,21,33,63.6,12,42,11,31,13,58,43
1301,Loris Karius,de,GK,,Newcastle Utd,Premier League,30,1993,1.0,0,0,0,0,0,0,0,,0,0,0,0,0,0,1
1302,Jesper Karlsson,se,FW,,Bologna,Serie A,25,1998,3.8,3,3,2,1,0,2,8,25.0,6,4,0,4,4,7,1
1303,Jon Karrikaburu,es,MF,FW,Alavés,La Liga,20,2002,0.2,0,0,0,0,0,0,0,,0,0,0,0,0,0,0
1304,Rick Karsdorp,nl,DF,,Roma,Serie A,28,1995,13.2,25,18,11,8,6,16,24,66.7,8,13,4,9,9,34,16
1305,Grigoris Kastanos,cy,MF,DF,Salernitana,Serie A,25,1998,16.4,23,14,8,9,6,9,20,45.0,11,13,4,9,8,31,9
1306,Silas Katompa,cd,FW,MF,Stuttgart,Bundesliga,24,1998,10.0,5,3,3,2,0,3,12,25.0,9,9,0,9,0,5,4
1307,Panos Katseris,gr,DF,,Lorient,Ligue 1,22,2001,11.6,26,20,16,8,2,16,25,64.0,9,20,4,16,8,34,18
1308,Mikkel Kaufmann,dk,FW,,Union Berlin,Bundesliga,22,2001,5.4,6,3,2,3,1,3,10,30.0,7,12,0,12,1,7,4
1309,Michael Kayode,it,DF,,Fiorentina,Serie A,19,2004,22.9,53,30,27,15,11,35,48,72.9,13,25,12,13,18,71,46
1310,Moise Kean,it,FW,,Juventus,Serie A,23,2000,7.3,7,4,3,2,2,1,3,33.3,2,4,1,3,2,9,5
1311,Michael Keane,eng,DF,,Everton,Premier League,30,1993,4.9,7,3,3,3,1,1,7,14.3,6,5,4,1,5,12,18
1312,Ibrahima Kebe,ml,MF,,Girona,La Liga,22,2000,0.1,1,1,0,1,0,0,0,,0,1,0,1,1,2,0
1313,Kévin Keben Biakolo,cm,DF,,Toulouse,Ligue 1,19,2004,5.8,4,2,4,0,0,3,6,50.0,3,7,0,7,8,12,17
1314,Yassine Kechta,ma,MF,,Le Havre,Ligue 1,21,2002,20.5,46,24,24,19,3,31,73,42.5,42,20,3,17,23,69,16
1315,Thilo Kehrer,de,DF,MF,West Ham,Premier League,26,1996,0.2,1,1,0,1,0,0,0,,0,2,2,0,0,1,0
1316,Thilo Kehrer,de,DF,,Monaco,Ligue 1,26,1996,14.7,32,22,22,7,3,22,39,56.4,17,18,6,12,30,62,55
1317,Habib Keita,ml,MF,,Clermont Foot,Ligue 1,21,2002,14.2,34,19,14,15,5,17,28,60.7,11,27,10,17,29,63,30
1318,Naby Keïta,gn,MF,DF,Werder Bremen,Bundesliga,28,1995,1.2,1,1,1,0,0,0,1,0.0,1,2,0,2,2,3,1
1319,Yannik Keitel,de,DF,MF,Freiburg,Bundesliga,23,2000,10.2,20,15,14,5,1,10,15,66.7,5,17,8,9,12,32,44
1320,Caoimhín Kelleher,ie,GK,,Liverpool,Premier League,24,1998,10.0,0,0,0,0,0,0,0,,0,0,0,0,0,0,4
1321,Thomas Keller,de,MF,FW,Heidenheim,Bundesliga,23,1999,0.0,0,0,0,0,0,0,0,,0,0,0,0,0,0,0
1322,Lloyd Kelly,eng,DF,,Bournemouth,Premier League,24,1998,17.3,24,19,10,9,5,14,25,56.0,11,22,12,10,13,37,67
1323,Omari Kellyman,eng,FW,,Aston Villa,Premier League,17,2005,0.4,1,0,0,1,0,1,2,50.0,1,0,0,0,0,1,0
1324,Aljoscha Kemlein,de,MF,,Union Berlin,Bundesliga,18,2004,0.3,0,0,0,0,0,0,3,0.0,3,1,0,1,0,0,0
1325,Tobias Kempe,de,MF,,Darmstadt 98,Bundesliga,34,1989,15.0,20,13,9,8,3,8,24,33.3,16,16,4,12,9,29,12
1326,Milos Kerkez,hu,DF,,Bournemouth,Premier League,19,2003,21.9,47,26,31,13,3,30,42,71.4,12,31,11,20,20,67,60
1327,Kaine Kesler-Hayden,eng,MF,DF,Aston Villa,Premier League,20,2002,0.1,0,0,0,0,0,0,0,,0,0,0,0,0,0,0
1328,Reda Khadra,de,FW,MF,Reims,Ligue 1,22,2001,15.2,16,10,5,4,7,8,20,40.0,12,8,2,6,3,19,13
1329,Wahbi Khazri,tn,FW,,Montpellier,Ligue 1,32,1991,12.6,24,17,8,12,4,14,35,40.0,21,10,0,10,3,27,7
1330,Rani Khedira,de,MF,,Union Berlin,Bundesliga,29,1994,14.9,35,22,15,19,1,17,26,65.4,9,12,5,7,22,57,38
1331,Abdukodir Khusanov,uz,DF,,Lens,Ligue 1,19,2004,9.0,21,12,13,8,0,9,17,52.9,8,13,8,5,13,34,32
1332,Kiké,es,FW,MF,Alavés,La Liga,33,1989,15.8,8,4,2,3,3,4,9,44.4,5,16,5,11,1,9,12
1333,Luca Kilian,de,DF,,Köln,Bundesliga,23,1999,7.1,16,9,15,1,0,9,14,64.3,5,12,5,7,7,23,28
1334,Max Kilman,eng,DF,,Wolves,Premier League,26,1997,38.0,47,21,40,6,1,24,32,75.0,8,64,37,27,39,86,182
1335,Joshua Kimmich,de,MF,DF,Bayern Munich,Bundesliga,28,1995,24.2,45,33,25,15,5,26,39,66.7,13,32,4,28,14,59,28
1336,Jakub Kiwior,pl,DF,,Arsenal,Premier League,23,2000,10.5,20,12,11,8,1,14,19,73.7,5,11,3,8,8,28,28
1337,Simon Kjær,dk,DF,,Milan,Serie A,34,1989,13.0,24,15,11,11,2,14,22,63.6,8,22,16,6,14,38,46
1338,Davy Klaassen,nl,MF,,Inter,Serie A,30,1993,2.3,4,2,0,4,0,1,3,33.3,2,5,1,4,3,7,4
1339,Christoph Klarer,at,DF,,Darmstadt 98,Bundesliga,23,2000,26.2,37,22,30,4,3,24,36,66.7,12,31,20,11,21,58,94
1340,Tim Kleindienst,de,FW,,Heidenheim,Bundesliga,27,1995,31.9,21,12,6,11,4,7,25,28.0,18,32,8,24,12,33,58
1341,Lukas Klostermann,de,DF,,RB Leipzig,Bundesliga,27,1996,16.0,15,10,7,7,1,4,13,30.8,9,25,12,13,13,28,64
1342,Justin Kluivert,nl,MF,FW,Bournemouth,Premier League,24,1999,21.3,28,14,5,12,11,8,30,26.7,22,16,1,15,8,36,11
1343,Ansgar Knauff,de,MF,DF,Eint Frankfurt,Bundesliga,21,2002,23.4,43,26,17,16,10,17,31,54.8,14,40,3,37,20,63,15
1344,Robin Knoche,de,DF,,Union Berlin,Bundesliga,31,1992,21.3,34,22,27,7,0,19,30,63.3,11,27,19,8,13,47,73
1345,Gregor Kobel,ch,GK,,Dortmund,Bundesliga,25,1997,26.3,0,0,0,0,0,0,1,0.0,1,0,0,0,0,0,11
1346,Robin Koch,de,DF,,Eint Frankfurt,Bundesliga,27,1996,30.4,38,23,26,12,0,17,27,63.0,10,33,24,9,32,70,136
1347,Philipp Köhn,ch,GK,,Monaco,Ligue 1,25,1998,22.0,1,1,1,0,0,1,1,100.0,0,0,0,0,1,2,5
1348,Dominik Kohr,de,DF,MF,Mainz 05,Bundesliga,29,1994,24.3,65,42,36,25,4,36,57,63.2,21,27,6,21,43,108,58
1349,Koke,es,MF,,Atlético Madrid,La Liga,31,1992,27.7,66,44,27,32,7,36,79,45.6,43,37,12,25,16,82,34
1350,Sead Kolašinac,ba,DF,,Atalanta,Serie A,30,1993,24.2,44,32,23,19,2,30,49,61.2,19,22,9,13,21,65,47
1351,Luca Koleosho,it,MF,FW,Burnley,Premier League,18,2004,10.8,7,4,2,5,0,2,10,20.0,8,13,0,13,2,9,0
1352,Randal Kolo Muani,fr,FW,MF,Paris S-G,Ligue 1,24,1998,14.1,10,8,5,3,2,5,13,38.5,8,5,0,5,4,14,10
1353,Randal Kolo Muani,fr,FW,,Eint Frankfurt,Bundesliga,24,1998,1.7,0,0,0,0,0,0,0,,0,0,0,0,0,0,1
1354,Mert Kömür,de,MF,DF,Augsburg,Bundesliga,18,2005,1.3,3,3,3,0,0,3,5,60.0,2,0,0,0,0,3,1
1355,Cheick Konaté,ml,DF,,Clermont Foot,Ligue 1,19,2004,11.9,26,15,17,9,0,20,36,55.6,16,16,2,14,13,39,21
1356,Ibrahima Konaté,fr,DF,,Liverpool,Premier League,24,1999,17.5,36,22,22,13,1,18,24,75.0,6,18,12,6,20,56,51
1357,Geoffrey Kondogbia,cf,MF,,Marseille,Ligue 1,30,1993,16.3,48,31,18,25,5,13,32,40.6,19,21,4,17,30,78,25
1358,Abdoul Koné,fr,DF,,Reims,Ligue 1,18,2005,2.1,7,7,5,2,0,4,11,36.4,7,2,0,2,2,9,9
1359,Amadou Koné,ml,MF,,Reims,Ligue 1,18,2005,5.3,13,8,11,2,0,6,10,60.0,4,8,3,5,10,23,10
1360,Ibrahima Koné,ml,FW,,Almería,La Liga,24,1999,3.1,1,0,1,0,0,1,1,100.0,0,1,0,1,0,1,4
1361,Ibrahima Koné,ml,FW,,Lorient,Ligue 1,24,1999,0.4,0,0,0,0,0,0,1,0.0,1,0,0,0,0,0,0
1362,Manu Koné,fr,MF,,Gladbach,Bundesliga,22,2001,17.3,45,26,20,20,5,17,25,68.0,8,22,1,21,15,60,16
1363,Ezri Konsa,eng,DF,,Aston Villa,Premier League,25,1997,34.1,54,32,28,23,3,23,27,85.2,4,36,20,16,28,82,73
1364,Teun Koopmeiners,nl,MF,,Atalanta,Serie A,25,1998,29.2,39,24,12,22,5,17,50,34.0,33,33,3,30,10,49,35
1365,Odilon Kossounou,ci,DF,,Leverkusen,Bundesliga,22,2001,20.1,30,20,11,12,7,15,26,57.7,11,27,3,24,27,57,43
1366,Filip Kostić,rs,DF,,Juventus,Serie A,30,1992,20.2,37,23,20,13,4,17,33,51.5,16,29,8,21,9,46,43
1367,N'Guessan Kouadio,ci,MF,FW,Metz,Ligue 1,20,2003,1.2,3,1,0,3,0,0,3,0.0,3,3,0,3,1,4,0
1368,Christian Kouamé,ci,FW,,Fiorentina,Serie A,25,1997,12.1,13,4,7,6,0,6,10,60.0,4,16,0,16,2,15,10
1369,Rominigue Kouamé,ml,MF,,Cádiz,La Liga,26,1996,9.1,14,9,6,7,1,7,15,46.7,8,10,2,8,13,27,10
1370,Koffi Kouao,ci,DF,,Metz,Ligue 1,25,1998,9.6,20,13,12,7,1,11,17,64.7,6,9,6,3,13,33,38
1371,Tomáš Koubek,cz,GK,,Augsburg,Bundesliga,30,1992,3.0,0,0,0,0,0,0,0,,0,0,0,0,0,0,1
1372,Therence Koudou,fr,DF,,Reims,Ligue 1,18,2004,3.5,2,2,1,1,0,0,2,0.0,2,4,3,1,4,6,9
1373,Jules Koundé,fr,DF,,Barcelona,La Liga,24,1998,32.2,37,23,22,10,5,28,51,54.9,23,32,12,20,25,62,83
1374,Boubakar Kouyaté,ml,DF,,Montpellier,Ligue 1,26,1997,21.4,49,30,39,8,2,28,51,54.9,23,31,20,11,29,78,123
1375,Cheikhou Kouyaté,sn,MF,,Nott'ham Forest,Premier League,33,1989,2.4,8,5,3,3,2,1,4,25.0,3,4,1,3,2,10,10
1376,Mateo Kovačić,hr,MF,,Manchester City,Premier League,29,1994,17.2,36,25,16,15,5,18,28,64.3,10,23,1,22,10,46,10
1377,Viktor Kovalenko,ua,MF,,Empoli,Serie A,27,1996,6.8,5,2,2,2,1,2,8,25.0,6,12,2,10,1,6,7
1378,Matej Kovar,cz,GK,,Leverkusen,Bundesliga,23,2000,1.0,0,0,0,0,0,0,0,,0,0,0,0,0,0,0
1379,Dawid Kownacki,pl,FW,,Werder Bremen,Bundesliga,26,1997,4.2,1,1,1,0,0,1,4,25.0,3,3,1,2,0,1,1
1380,Emil Krafth,se,DF,,Newcastle Utd,Premier League,28,1994,10.1,21,14,10,7,4,12,25,48.0,13,8,3,5,9,30,21
1381,Alex Král,cz,MF,,Union Berlin,Bundesliga,25,1998,15.2,19,14,7,10,2,8,20,40.0,12,15,4,11,11,30,30
1382,Andrej Kramarić,hr,MF,FW,Hoffenheim,Bundesliga,32,1991,24.4,11,2,5,4,2,6,13,46.2,7,14,2,12,10,21,12
1383,Christoph Kramer,de,MF,,Gladbach,Bundesliga,32,1991,2.8,10,5,5,5,0,2,14,14.3,12,7,1,6,4,14,6
1384,Frans Krätzig,de,DF,,Bayern Munich,Bundesliga,20,2003,0.6,2,0,2,0,0,1,2,50.0,1,0,0,0,0,2,0
1385,Tom Krauß,de,MF,,Mainz 05,Bundesliga,22,2001,15.0,57,33,22,31,4,21,58,36.2,37,33,4,29,17,74,28
1386,Rasmus Kristensen,dk,DF,,Roma,Serie A,26,1997,19.4,36,19,25,8,3,28,50,56.0,22,27,7,20,8,44,50
1387,Thomas Kristensen,dk,DF,,Udinese,Serie A,21,2002,23.3,35,24,25,10,0,21,33,63.6,12,29,20,9,29,64,118
1388,Toni Kroos,de,MF,,Real Madrid,La Liga,33,1990,23.6,53,34,19,25,9,24,59,40.7,35,22,4,18,17,70,11
1389,Nikola Krstović,me,FW,,Lecce,Serie A,23,2000,26.4,17,6,3,9,5,6,10,60.0,4,12,4,8,4,21,22
1390,Rade Krunić,ba,MF,,Milan,Serie A,29,1993,7.6,10,8,3,6,1,4,9,44.4,5,7,3,4,11,21,14
1391,Lukas Kübler,de,DF,,Freiburg,Bundesliga,30,1992,20.5,50,24,35,13,2,26,42,61.9,16,36,14,22,37,87,57
1392,Takefusa Kubo,jp,FW,MF,Real Sociedad,La Liga,22,2001,23.9,26,17,15,6,5,9,23,39.1,14,21,2,19,11,37,8
1393,Mahmut Kücüksahin,,MF,,Augsburg,Bundesliga,19,2004,0.0,0,0,0,0,0,0,0,,0,0,0,0,0,0,0
1394,Mohammed Kudus,gh,FW,MF,West Ham,Premier League,22,2000,27.6,65,47,27,27,11,20,40,50.0,20,25,0,25,11,76,9
1395,Christian Kühlwetter,de,MF,,Heidenheim,Bundesliga,27,1996,0.1,0,0,0,0,0,0,0,,0,0,0,0,0,0,0
1396,Dejan Kulusevski,se,FW,MF,Tottenham,Premier League,23,2000,30.7,62,33,19,20,23,25,67,37.3,42,24,1,23,18,80,2
1397,Sael Kumbedi,fr,DF,,Lyon,Ligue 1,18,2005,10.3,30,20,14,12,4,9,22,40.9,13,12,3,9,14,44,18
1398,Marash Kumbulla,al,DF,,Sassuolo,Serie A,23,2000,4.0,3,2,2,1,0,1,2,50.0,1,8,6,2,0,3,22
1399,Justin Kumi,it,FW,,Sassuolo,Serie A,19,2004,0.0,0,0,0,0,0,0,0,,0,0,0,0,0,0,0
1400,Layvin Kurzawa,fr,DF,,Paris S-G,Ligue 1,30,1992,0.1,0,0,0,0,0,0,0,,0,0,0,0,0,0,0
1401,Berkan Kutlu,tr,MF,,Genoa,Serie A,25,1998,2.2,6,4,5,1,0,3,6,50.0,3,3,0,3,4,10,5
1402,Daler Kuzyaev,ru,MF,,Le Havre,Ligue 1,30,1993,23.2,34,19,11,13,10,15,43,34.9,28,18,5,13,22,56,18
1403,Khvicha Kvaratskhelia,ge,FW,,Napoli,Serie A,22,2001,30.4,42,21,11,19,12,15,49,30.6,34,15,1,14,13,55,9
1404,Giorgi Kvernadze,ge,FW,DF,Frosinone,Serie A,20,2003,0.7,3,0,2,0,1,2,2,100.0,0,1,0,1,1,4,0
1405,Moritz-Broni Kwarteng,gh,FW,,Bochum,Bundesliga,25,1998,3.1,3,0,0,3,0,1,7,14.3,6,4,0,4,2,5,0
1406,Grejohn Kyei,fr,FW,,Clermont Foot,Ligue 1,27,1995,11.4,6,4,2,2,2,2,3,66.7,1,5,1,4,1,7,10
1407,Giorgos Kyriakopoulos,gr,DF,,Monza,Serie A,27,1996,19.0,19,10,16,3,0,11,24,45.8,13,18,1,17,13,32,28
1408,Luca de la Torre,us,MF,,Celta Vigo,La Liga,25,1998,21.7,39,21,12,22,5,22,43,51.2,21,23,4,19,12,51,17
1409,Gaëtan Laborde,fr,FW,MF,Nice,Ligue 1,29,1994,21.2,18,12,8,4,6,11,30,36.7,19,20,2,18,6,24,8
1410,Alexandre Lacazette,fr,FW,,Lyon,Ligue 1,32,1991,25.5,19,12,8,9,2,5,17,29.4,12,22,3,19,8,27,9
1411,Maxence Lacroix,fr,DF,,Wolfsburg,Bundesliga,23,2000,26.2,48,29,28,18,2,29,41,70.7,12,35,12,23,24,72,121
1412,Alban Lafont,fr,GK,,Nantes,Ligue 1,24,1999,27.7,0,0,0,0,0,0,2,0.0,2,0,0,0,0,0,14
1413,Yoel Lago,es,DF,,Celta Vigo,La Liga,19,2004,1.0,2,0,2,0,0,0,0,,0,1,0,1,0,2,2
1414,Aïssa Laïdouni,tn,MF,,Union Berlin,Bundesliga,26,1996,11.9,21,12,4,12,5,4,12,33.3,8,26,2,24,12,33,14
1415,Konrad Laimer,at,DF,MF,Bayern Munich,Bundesliga,26,1997,19.7,56,36,25,20,11,22,52,42.3,30,42,6,36,18,74,13
1416,Stefan Lainer,at,DF,MF,Gladbach,Bundesliga,30,1992,8.3,23,16,15,8,0,14,24,58.3,10,13,6,7,5,28,28
1417,Kenny Lala,mg,DF,,Brest,Ligue 1,31,1991,33.0,78,51,39,28,11,30,56,53.6,26,27,6,21,28,106,75
1418,Adam Lallana,eng,MF,FW,Brighton,Premier League,35,1988,9.4,8,3,4,4,0,0,4,0.0,4,2,1,1,3,11,1
1419,Mathis Lambourde,fr,FW,,Rennes,Ligue 1,17,2006,0.1,0,0,0,0,0,0,1,0.0,1,1,0,1,0,0,1
1420,Érik Lamela,ar,FW,MF,Sevilla,La Liga,31,1992,5.1,21,14,4,10,7,10,15,66.7,5,12,0,12,1,22,5
1421,Mohamed Lamine Bayo,gn,FW,,Le Havre,Ligue 1,25,1998,15.4,13,5,2,5,6,2,10,20.0,8,8,1,7,2,15,11
1422,Didier Lamkel Zé,cm,FW,MF,Metz,Ligue 1,26,1996,6.1,7,2,2,4,1,2,5,40.0,3,4,0,4,0,7,11
1423,Tariq Lamptey,gh,DF,FW,Brighton,Premier League,22,2000,10.2,21,14,14,5,2,13,22,59.1,9,7,3,4,6,27,6
1424,Bruno Langa,mz,DF,,Almería,La Liga,25,1997,9.1,17,12,10,5,2,6,14,42.9,8,11,4,7,4,21,33
1425,Gianluca Lapadula,pe,FW,,Cagliari,Serie A,33,1990,13.4,1,1,0,0,1,1,10,10.0,9,2,1,1,2,3,5
1426,Aymeric Laporte,es,DF,,Manchester City,Premier League,29,1994,0.1,0,0,0,0,0,0,0,,0,1,1,0,0,0,1
1427,Julien Laporte,fr,DF,,Lorient,Ligue 1,29,1993,20.2,23,14,15,7,1,16,36,44.4,20,36,26,10,11,34,116
1428,Cyle Larin,ca,FW,,Mallorca,La Liga,28,1995,20.3,17,8,6,4,7,2,7,28.6,5,16,5,11,3,20,17
1429,Yasser Larouci,dz,DF,,Sheffield Utd,Premier League,22,2001,5.9,17,9,10,5,2,10,14,71.4,4,6,1,5,7,24,20
1430,Hugo Larsson,se,MF,,Eint Frankfurt,Bundesliga,19,2004,21.0,32,18,18,10,4,15,28,53.6,13,34,7,27,29,61,30
1431,Jamaal Lascelles,eng,DF,,Newcastle Utd,Premier League,29,1993,12.0,14,9,7,7,0,6,11,54.5,5,17,12,5,5,19,42
1432,Juanmi Latasa,es,FW,,Getafe,La Liga,22,2001,17.3,9,7,0,6,3,1,11,9.1,10,9,0,9,4,13,21
1433,Toni Lato,es,DF,,Mallorca,La Liga,25,1997,17.2,38,23,19,13,6,16,27,59.3,11,17,3,14,17,55,27
1434,Armand Lauriente,fr,FW,,Sassuolo,Serie A,24,1998,32.3,31,20,8,14,9,13,44,29.5,31,29,4,25,15,46,11
1435,Roméo Lavia,be,MF,,Chelsea,Premier League,19,2004,0.4,1,0,0,1,0,0,0,,0,0,0,0,0,1,1
1436,Lázaro,br,FW,MF,Almería,La Liga,21,2002,3.2,4,1,2,0,2,2,8,25.0,6,4,0,4,1,5,1
1437,Valentino Lazaro,at,DF,MF,Torino,Serie A,27,1996,22.2,18,11,7,9,2,13,19,68.4,6,14,1,13,8,26,29
1438,Darko Lazović,rs,FW,MF,Hellas Verona,Serie A,32,1990,21.4,26,16,11,6,9,16,31,51.6,15,10,1,9,6,32,14
1439,Manuel Lazzari,it,DF,,Lazio,Serie A,29,1993,18.6,26,18,13,10,3,18,28,64.3,10,20,4,16,12,38,37
1440,Théo Le Bris,fr,DF,MF,Lorient,Ligue 1,20,2002,16.8,35,22,25,7,3,19,40,47.5,21,24,3,21,12,47,42
1441,Julien Le Cardinal,fr,DF,,Brest,Ligue 1,25,1997,5.3,19,11,11,7,1,8,12,66.7,4,6,3,3,13,32,26
1442,Julien Le Cardinal,fr,DF,,Lens,Ligue 1,25,1997,0.6,6,2,4,2,0,4,9,44.4,5,2,1,1,0,6,0
1443,Jérémy Le Douaron,fr,FW,,Brest,Ligue 1,25,1998,18.0,21,10,7,9,5,11,26,42.3,15,14,1,13,2,23,10
1444,Enzo Le Fée,fr,MF,,Rennes,Ligue 1,23,2000,17.0,50,35,23,17,10,23,47,48.9,24,17,3,14,19,69,20
1445,Vincent Le Goff,fr,DF,MF,Lorient,Ligue 1,33,1989,6.0,5,0,4,0,1,4,8,50.0,4,11,3,8,3,8,10
1446,Robin Le Normand,es,DF,,Real Sociedad,La Liga,26,1996,27.4,31,22,16,15,0,17,30,56.7,13,26,15,11,28,59,96
1447,Nicola Leali,it,GK,,Genoa,Serie A,30,1993,2.0,0,0,0,0,0,0,0,,0,0,0,0,0,0,0
1448,Rafael Leão,pt,FW,,Milan,Serie A,24,1999,27.9,16,10,3,8,5,8,13,61.5,5,15,1,14,9,25,19
1449,Adrien Lebeau,fr,MF,FW,Brest,Ligue 1,24,1999,0.6,0,0,0,0,0,0,3,0.0,3,2,1,1,0,0,1
1450,Jean-Louis Leca,fr,GK,,Lens,Ligue 1,37,1985,1.0,0,0,0,0,0,0,0,,0,0,0,0,0,0,1
1451,Benjamin Lecomte,fr,GK,,Montpellier,Ligue 1,32,1991,30.0,0,0,0,0,0,0,1,0.0,1,0,0,0,0,0,16
1452,Jeremías Ledesma,ar,GK,,Cádiz,La Liga,30,1993,33.9,1,1,1,0,0,1,4,25.0,3,0,0,0,0,1,15
1453,Pierre Lees-Melou,fr,MF,,Brest,Ligue 1,30,1993,28.0,96,67,51,41,4,49,129,38.0,80,61,11,50,43,139,64
1454,Diogo Leite,pt,DF,,Union Berlin,Bundesliga,24,1999,30.0,52,36,31,15,6,25,51,49.0,26,48,22,26,47,99,155
1455,Maxim Leitsch,de,DF,,Mainz 05,Bundesliga,25,1998,4.2,6,3,5,1,0,3,6,50.0,3,2,0,2,4,10,13
1456,Florian Lejeune,fr,DF,,Rayo Vallecano,La Liga,32,1991,37.0,39,25,26,11,2,19,30,63.3,11,33,18,15,23,62,155
1457,Stefan Lekovic,rs,DF,,Villarreal,La Liga,19,2004,0.3,0,0,0,0,0,0,0,,0,1,1,0,0,0,1
1458,Iñigo Lekue,es,DF,,Athletic Club,La Liga,30,1993,22.2,40,22,25,10,5,27,53,50.9,26,24,6,18,15,55,50
1459,Thomas Lemar,fr,MF,,Atlético Madrid,La Liga,27,1995,1.8,3,1,2,1,0,1,2,50.0,1,0,0,0,0,3,0
1460,Mario Lemina,ga,MF,,Wolves,Premier League,29,1993,33.0,90,58,46,33,11,25,47,53.2,22,36,9,27,41,131,64
1461,Álvaro Lemos,es,DF,,Las Palmas,La Liga,30,1993,2.8,4,1,1,3,0,0,2,0.0,2,3,1,2,2,6,4
1462,Ruben Lendinez,es,DF,,Valencia,La Liga,20,2003,0.1,2,2,0,2,0,1,1,100.0,0,0,0,0,0,2,1
1463,Clément Lenglet,fr,DF,,Aston Villa,Premier League,28,1995,12.8,13,9,7,5,1,7,13,53.8,6,19,11,8,7,20,47
1464,Bernd Leno,de,GK,,Fulham,Premier League,31,1992,38.0,0,0,0,0,0,0,0,,0,0,0,0,0,0,14
1465,Christopher Lenz,de,DF,MF,RB Leipzig,Bundesliga,28,1994,0.5,2,1,2,0,0,1,1,100.0,0,0,0,0,2,4,2
1466,Christopher Lenz,de,DF,,Eint Frankfurt,Bundesliga,28,1994,0.1,1,1,0,1,0,1,1,100.0,0,0,0,0,0,1,1
1467,Johann Lepenant,fr,MF,,Lyon,Ligue 1,20,2002,2.8,4,3,2,2,0,1,8,12.5,7,5,0,5,4,8,0
1468,Jefferson Lerma,co,MF,DF,Crystal Palace,Premier League,28,1994,26.7,42,25,15,23,4,19,40,47.5,21,31,12,19,36,78,72
1469,Léo Leroy,fr,MF,,Montpellier,Ligue 1,23,2000,5.5,19,10,8,8,3,6,21,28.6,15,12,3,9,7,26,8
1470,Robert Lewandowski,pl,FW,,Barcelona,La Liga,34,1988,30.6,8,5,0,6,2,4,12,33.3,8,13,4,9,9,17,18
1471,Jamie Leweling,de,FW,MF,Stuttgart,Bundesliga,22,2001,16.9,18,10,4,6,8,5,17,29.4,12,21,1,20,5,23,13
1472,Rico Lewis,eng,DF,MF,Manchester City,Premier League,18,2004,9.0,10,7,4,4,2,3,7,42.9,4,7,1,6,4,14,6
1473,Keane Lewis-Potter,eng,FW,DF,Brentford,Premier League,22,2001,16.0,17,7,5,11,1,7,15,46.7,8,10,2,8,7,24,23
1474,Philipp Lienhart,at,DF,,Freiburg,Bundesliga,27,1996,14.1,20,13,14,5,1,13,23,56.5,10,18,11,7,14,34,51
1475,Matthijs de Ligt,nl,DF,,Bayern Munich,Bundesliga,23,1999,15.4,15,12,4,8,3,6,11,54.5,5,14,10,4,19,34,52
1476,Victor Lindelöf,se,DF,,Manchester Utd,Premier League,29,1994,14.8,15,10,8,7,0,5,13,38.5,8,18,9,9,12,27,40
1477,Jesper Lindstrøm,dk,FW,MF,Napoli,Serie A,23,2000,4.8,8,3,2,3,3,4,8,50.0,4,3,0,3,2,10,6
1478,Jesper Lindstrøm,dk,FW,,Eint Frankfurt,Bundesliga,23,2000,0.9,1,1,1,0,0,0,0,,0,0,0,0,0,1,0
1479,Karol Linetty,pl,MF,,Torino,Serie A,28,1995,20.6,30,21,9,20,1,9,29,31.0,20,24,8,16,23,53,27
1480,Samuel Lino,br,DF,MF,Atlético Madrid,La Liga,23,1999,23.1,61,34,32,17,12,35,70,50.0,35,37,1,36,14,75,27
1481,Luca Lipani,it,MF,,Sassuolo,Serie A,18,2005,4.3,9,7,4,3,2,3,11,27.3,8,9,2,7,6,15,7
1482,Pol Lirola,es,DF,,Frosinone,Serie A,25,1997,17.1,30,18,14,15,1,17,35,48.6,18,12,1,11,19,49,41
1483,Marcin Listkowski,pl,FW,,Lecce,Serie A,25,1998,0.1,0,0,0,0,0,0,0,,0,0,0,0,0,0,0
1484,Valentino Livramento,eng,DF,,Newcastle Utd,Premier League,20,2002,14.6,23,13,15,6,2,10,21,47.6,11,16,7,9,25,48,41
1485,Dejan Ljubicic,at,MF,FW,Köln,Bundesliga,25,1997,22.8,43,27,20,18,5,20,43,46.5,23,22,2,20,18,61,11
1486,Javier Llabrés,es,MF,FW,Mallorca,La Liga,20,2002,2.7,3,1,1,1,1,1,2,50.0,1,1,0,1,3,6,4
1487,Diego Llorente,es,DF,,Roma,Serie A,29,1993,24.1,31,19,20,10,1,11,24,45.8,13,40,27,13,22,53,79
1488,Marcos Llorente,es,MF,DF,Atlético Madrid,La Liga,28,1995,28.5,40,23,18,17,5,16,44,36.4,28,36,11,25,14,54,35
1489,Gautier Lloris,fr,DF,,Le Havre,Ligue 1,28,1995,30.9,50,28,40,9,1,28,42,66.7,14,50,30,20,32,82,142
1490,Abou Lô,sn,MF,DF,Metz,Ligue 1,23,2000,2.2,3,1,2,1,0,1,4,25.0,3,5,2,3,4,7,8
1491,Giovani Lo Celso,ar,MF,,Tottenham,Premier League,27,1996,5.6,22,13,10,8,4,9,14,64.3,5,4,1,3,5,27,2
1492,Stanislav Lobotka,sk,MF,,Napoli,Serie A,28,1994,36.5,61,39,18,30,13,24,60,40.0,36,30,8,22,30,91,29
1493,Manuel Locatelli,it,MF,,Juventus,Serie A,25,1998,33.4,69,43,24,35,10,31,58,53.4,27,43,17,26,25,94,65
1494,Bradley Locko,fr,DF,,Brest,Ligue 1,21,2002,32.9,97,55,57,34,6,47,80,58.8,33,28,1,27,40,137,69
1495,Tom Lockyer,wls,DF,,Luton Town,Premier League,28,1994,13.0,25,16,17,6,2,15,22,68.2,7,23,13,10,23,48,68
1496,Renan Lodi,br,DF,,Marseille,Ligue 1,25,1998,13.7,24,16,8,13,3,13,21,61.9,8,7,2,5,16,40,35
1497,Ruben Loftus-Cheek,eng,MF,,Milan,Serie A,27,1996,23.0,28,18,7,14,7,15,27,55.6,12,24,12,12,9,37,10
1498,Andy Logbo,fr,FW,,Le Havre,Ligue 1,19,2004,2.8,0,0,0,0,0,0,3,0.0,3,7,3,4,0,0,2
1499,Enzo Loiodice,fr,MF,,Las Palmas,La Liga,22,2000,19.9,62,35,15,34,13,20,42,47.6,22,20,2,18,12,74,16
1500,Sean Longstaff,eng,MF,,Newcastle Utd,Premier League,25,1997,30.5,54,30,17,29,8,24,63,38.1,39,43,7,36,17,71,23
1501,Ademola Lookman,ng,FW,MF,Atalanta,Serie A,25,1997,21.0,20,15,2,11,7,8,22,36.4,14,19,0,19,9,29,0
1502,Noah Loosli,ch,DF,,Bochum,Bundesliga,26,1997,3.8,10,7,6,4,0,7,14,50.0,7,7,1,6,7,17,18
1503,Anthony Lopes,pt,GK,,Lyon,Ligue 1,32,1990,31.0,0,0,0,0,0,0,0,,0,0,0,0,0,0,16
1504,David López,es,DF,,Girona,La Liga,33,1989,21.8,33,20,21,12,0,17,22,77.3,5,28,19,9,20,53,63
1505,Diego López,es,MF,FW,Valencia,La Liga,21,2002,29.5,37,25,14,16,7,13,56,23.2,43,23,1,22,20,57,12
1506,Fermin López,es,MF,FW,Barcelona,La Liga,20,2003,16.1,41,21,15,18,8,14,40,35.0,26,14,1,13,4,45,9
1507,Javi López,es,DF,,Alavés,La Liga,21,2002,26.5,23,12,11,9,3,15,26,57.7,11,25,9,16,10,33,77
1508,Maxime Lopez,fr,MF,,Fiorentina,Serie A,25,1997,8.9,18,9,5,10,3,6,12,50.0,6,3,1,2,7,25,6
1509,Maxime Lopez,fr,MF,,Sassuolo,Serie A,25,1997,1.6,2,1,1,1,0,1,2,50.0,1,1,1,0,2,4,0
1510,Pau López,es,GK,,Marseille,Ligue 1,28,1994,32.7,0,0,0,0,0,0,2,0.0,2,0,0,0,0,0,10
1511,Unai López,es,MF,,Rayo Vallecano,La Liga,27,1995,23.4,48,24,18,23,7,21,53,39.6,32,24,3,21,16,64,15
1512,Dion Lopy,sn,MF,,Almería,La Liga,21,2002,21.3,62,37,36,20,6,17,44,38.6,27,23,5,18,15,77,22
1513,Anthony Losilla,fr,MF,,Bochum,Bundesliga,37,1986,28.6,63,37,15,40,8,23,51,45.1,28,37,8,29,25,88,51
1514,Jordan Lotomba,ch,DF,,Nice,Ligue 1,24,1998,20.0,36,28,18,9,9,25,35,71.4,10,30,9,21,16,52,26
1515,Tom Louchet,fr,MF,DF,Nice,Ligue 1,20,2003,4.5,14,5,6,6,2,7,11,63.6,4,7,3,4,3,17,9
1516,Imran Louza,ma,MF,,Lorient,Ligue 1,24,1999,9.6,13,7,2,8,3,2,8,25.0,6,8,1,7,9,22,4
1517,Matteo Lovato,it,DF,,Torino,Serie A,23,2000,6.0,10,7,5,5,0,4,5,80.0,1,9,5,4,13,23,10
1518,Matteo Lovato,it,DF,,Salernitana,Serie A,23,2000,10.5,27,14,17,8,2,16,24,66.7,8,14,7,7,18,45,41
1519,Dejan Lovren,hr,DF,,Lyon,Ligue 1,34,1989,8.0,9,7,6,3,0,3,7,42.9,4,6,5,1,12,21,37
1520,Sandi Lovrić,si,MF,,Udinese,Serie A,25,1998,22.1,25,12,9,11,5,9,23,39.1,14,21,2,19,21,46,24
1521,Max Lowe,eng,DF,MF,Sheffield Utd,Premier League,26,1997,5.6,21,10,13,5,3,8,15,53.3,7,10,4,6,5,26,15
1522,Anthony Lozano,hn,MF,FW,Getafe,La Liga,30,1993,1.0,0,0,0,0,0,0,1,0.0,1,0,0,0,0,0,1
1523,Anthony Lozano,hn,FW,,Almería,La Liga,30,1993,8.6,7,5,2,5,0,4,7,57.1,3,6,1,5,2,9,12
1524,Lucas,br,DF,,Cádiz,La Liga,22,2001,17.1,47,27,32,11,4,32,55,58.2,23,27,4,23,17,64,45
1525,Lorenzo Lucca,it,FW,,Udinese,Serie A,22,2000,28.8,19,11,4,11,4,5,20,25.0,15,18,3,15,3,22,36
1526,Jhon Lucumí,co,DF,,Bologna,Serie A,25,1998,24.6,48,29,31,17,0,27,36,75.0,9,32,17,15,16,64,68
1527,José Luis Gayà,es,DF,,Valencia,La Liga,28,1995,19.9,71,36,44,23,4,43,67,64.2,24,18,3,15,11,82,42
1528,José Luis Morales,es,FW,MF,Villarreal,La Liga,36,1987,11.6,5,3,1,4,0,3,13,23.1,10,9,1,8,7,12,4
1529,José Luis Palomino,ar,DF,,Atalanta,Serie A,33,1990,0.3,2,1,1,1,0,1,1,100.0,0,2,1,1,1,3,6
1530,Douglas Luiz,br,MF,,Aston Villa,Premier League,25,1998,33.3,58,38,21,27,10,25,53,47.2,28,32,8,24,23,81,18
1531,Romelu Lukaku,be,FW,,Roma,Serie A,30,1993,29.3,6,5,1,2,3,2,4,50.0,2,7,1,6,0,6,19
1532,Castello Lukeba,fr,DF,,RB Leipzig,Bundesliga,20,2002,24.3,19,12,10,9,0,10,12,83.3,2,35,13,22,12,31,94
1533,Dodi Lukebakio,be,FW,MF,Sevilla,La Liga,25,1997,12.5,5,2,2,2,1,1,6,16.7,5,9,2,7,2,7,5
1534,Saša Lukić,rs,MF,,Fulham,Premier League,26,1996,12.5,33,19,9,17,7,18,39,46.2,21,18,5,13,16,49,19
1535,Karlo Lulić,hr,MF,,Frosinone,Serie A,27,1996,0.2,0,0,0,0,0,0,0,,0,1,0,1,1,1,0
1536,Andriy Lunin,ua,GK,,Real Madrid,La Liga,24,1999,21.0,0,0,0,0,0,0,1,0.0,1,0,0,0,0,0,15
1537,Sebastiano Luperto,it,DF,,Empoli,Serie A,26,1996,37.8,37,26,25,10,2,15,24,62.5,9,46,35,11,32,69,157
1538,Mateus Lusuardi,br,DF,,Frosinone,Serie A,19,2004,2.4,2,1,1,1,0,1,3,33.3,2,4,2,2,4,6,8
1539,Andreas Luthe,de,GK,,Bochum,Bundesliga,36,1987,1.0,0,0,0,0,0,0,0,,0,0,0,0,0,0,1
1540,Zito Luvumbo,ao,FW,MF,Cagliari,Serie A,21,2002,21.6,9,6,5,2,2,4,15,26.7,11,19,0,19,1,10,2
1541,Charalambos Lykogiannis,gr,DF,,Bologna,Serie A,29,1993,10.0,10,6,5,4,1,5,10,50.0,5,15,5,10,5,15,30
1542,Senne Lynen,be,MF,,Werder Bremen,Bundesliga,24,1999,20.0,64,38,33,27,4,30,70,42.9,40,41,8,33,41,105,56
1543,Joshua M'Bahia,ci,MF,,Clermont Foot,Ligue 1,18,2005,0.2,0,0,0,0,0,0,0,,0,0,0,0,0,0,0
1544,Othmane Maamma,ma,FW,,Montpellier,Ligue 1,17,2005,1.0,3,3,2,0,1,1,1,100.0,0,3,0,3,0,3,0
1545,Ian Maatsen,nl,FW,MF,Chelsea,Premier League,21,2002,2.3,3,2,1,1,1,0,4,0.0,4,4,0,4,3,6,10
1546,Ian Maatsen,nl,DF,,Dortmund,Bundesliga,21,2002,14.0,30,22,15,9,6,16,30,53.3,14,22,4,18,13,43,26
1547,Alexis Mac Allister,ar,MF,,Liverpool,Premier League,24,1998,28.9,99,55,35,50,14,59,125,47.2,66,65,8,57,35,134,25
1548,Deiver Machado,co,DF,,Lens,Ligue 1,29,1993,12.5,24,18,10,10,4,15,20,75.0,5,13,2,11,7,31,8
1549,Darwin Machís,ve,MF,,Cádiz,La Liga,30,1993,8.7,23,14,7,9,7,13,24,54.2,11,8,1,7,4,27,2
1550,James Maddison,eng,MF,,Tottenham,Premier League,26,1996,23.7,33,19,5,18,10,15,29,51.7,14,15,3,12,13,46,10
1551,Noni Madueke,eng,FW,,Chelsea,Premier League,21,2002,11.7,16,10,8,4,4,11,34,32.4,23,11,0,11,4,20,14
1552,Pablo Maffeo,es,DF,,Mallorca,La Liga,26,1997,16.2,35,22,18,13,4,23,40,57.5,17,12,2,10,10,45,23
1553,Gabriel Magalhães,br,DF,,Arsenal,Premier League,25,1997,33.8,48,28,24,22,2,17,22,77.3,5,44,33,11,31,79,100
1554,Soungoutou Magassa,fr,DF,MF,Monaco,Ligue 1,19,2003,15.0,56,26,22,32,2,26,48,54.2,22,21,4,17,21,77,36
1555,Giulio Maggiore,it,MF,,Salernitana,Serie A,25,1998,20.0,49,29,26,22,1,20,42,47.6,22,27,5,22,24,73,38
1556,Matej Maglica,hr,DF,,Darmstadt 98,Bundesliga,24,1998,18.9,35,21,25,10,0,22,36,61.1,14,29,11,18,22,57,92
1557,Giangiacomo Magnani,it,DF,,Hellas Verona,Serie A,27,1995,27.2,33,18,23,10,0,15,25,60.0,10,50,28,22,45,78,118
1558,Hugo Magnetti,fr,MF,,Brest,Ligue 1,25,1998,26.0,49,27,18,26,5,24,58,41.4,34,19,1,18,18,67,18
1559,Yohann Magnin,fr,MF,,Clermont Foot,Ligue 1,26,1997,18.7,49,31,12,32,5,22,47,46.8,25,38,13,25,19,68,26
1560,Frank Magri,cm,FW,MF,Toulouse,Ligue 1,23,1999,16.0,22,14,5,12,5,15,21,71.4,6,16,4,12,4,26,17
1561,Harry Maguire,eng,DF,,Manchester Utd,Premier League,30,1993,18.4,24,17,14,10,0,12,22,54.5,10,33,24,9,25,49,83
1562,Jon Magunacelaya,es,FW,MF,Real Sociedad,La Liga,23,2000,1.3,5,3,2,3,0,4,8,50.0,4,3,0,3,0,5,2
1563,Adel Mahamoud,km,FW,,Nantes,Ligue 1,20,2003,0.1,0,0,0,0,0,0,1,0.0,1,0,0,0,0,0,0
1564,Arne Maier,de,MF,,Augsburg,Bundesliga,24,1999,11.1,14,9,5,8,1,5,14,35.7,9,19,2,17,6,20,11
1565,Habib Maïga,ci,MF,FW,Metz,Ligue 1,27,1996,1.6,2,2,1,0,1,1,3,33.3,2,2,0,2,4,6,2
1566,Mike Maignan,fr,GK,,Milan,Serie A,28,1995,29.0,1,0,1,0,0,1,1,100.0,0,1,0,1,1,2,4
1567,Linton Maina,de,FW,MF,Köln,Bundesliga,24,1999,21.1,18,15,11,5,2,9,28,32.1,19,12,1,11,6,24,12
1568,Patrick Mainka,de,DF,,Heidenheim,Bundesliga,28,1994,34.0,85,49,58,24,3,38,74,51.4,36,66,32,34,49,134,158
1569,Kobbie Mainoo,eng,MF,,Manchester Utd,Premier League,18,2005,21.4,47,27,20,16,11,21,45,46.7,24,20,12,8,22,69,30
1570,Ainsley Maitland-Niles,eng,DF,MF,Lyon,Ligue 1,25,1997,15.9,34,18,12,14,8,19,37,51.4,18,16,6,10,17,51,29
1571,Radosław Majecki,pl,GK,,Monaco,Ligue 1,23,1999,12.0,0,0,0,0,0,0,0,,0,1,0,1,0,0,5
1572,Lovro Majer,hr,MF,,Rennes,Ligue 1,25,1998,0.2,0,0,0,0,0,0,0,,0,0,0,0,0,0,1
1573,Lovro Majer,hr,MF,FW,Wolfsburg,Bundesliga,25,1998,23.4,39,18,17,22,0,12,31,38.7,19,20,1,19,12,51,13
1574,Jean-Victor Makengo,fr,MF,FW,Lorient,Ligue 1,25,1998,5.3,5,4,3,2,0,2,6,33.3,4,12,1,11,8,13,5
1575,Jordy Makengo,fr,DF,,Freiburg,Bundesliga,21,2001,11.4,17,11,11,5,1,6,10,60.0,4,16,4,12,11,28,37
1576,Antoine Makoumbou,cg,MF,,Cagliari,Serie A,25,1998,30.0,41,24,21,15,5,15,30,50.0,15,23,4,19,16,57,27
1577,Nemanja Maksimović,rs,MF,,Getafe,La Liga,28,1995,36.3,65,43,26,31,8,23,41,56.1,18,56,23,33,46,111,61
1578,Julián Malatini,ar,DF,,Werder Bremen,Bundesliga,22,2001,6.7,18,13,12,3,3,16,24,66.7,8,8,1,7,13,31,26
1579,Daniel Maldini,it,MF,FW,Monza,Serie A,21,2001,3.7,3,2,0,2,1,3,6,50.0,3,2,0,2,2,5,1
1580,Daniel Maldini,it,FW,MF,Empoli,Serie A,21,2001,2.9,4,2,0,2,2,2,2,100.0,0,5,0,5,2,6,2
1581,Youssef Maleh,ma,MF,,Empoli,Serie A,24,1998,28.9,74,48,30,36,8,23,52,44.2,29,62,7,55,25,99,29
1582,Donyell Malen,nl,FW,MF,Dortmund,Bundesliga,24,1999,19.8,11,7,5,3,3,2,6,33.3,4,11,4,7,2,13,8
1583,Ruslan Malinovskyi,ua,MF,,Genoa,Serie A,30,1993,17.2,35,20,18,11,6,17,41,41.5,24,22,8,14,5,40,16
1584,Lennard Maloney,us,MF,,Heidenheim,Bundesliga,23,1999,25.4,43,26,14,24,5,25,59,42.4,34,33,9,24,25,68,88
1585,Aaron Malouda,fr,FW,,Lille,Ligue 1,17,2005,0.0,0,0,0,0,0,0,0,,0,0,0,0,0,0,0
1586,Giorgi Mamardashvili,ge,GK,,Valencia,La Liga,22,2000,36.5,4,3,4,0,0,4,4,100.0,0,1,0,1,2,6,22
1587,David Mamutovic,de,FW,DF,Mainz 05,Bundesliga,22,2000,0.1,1,1,0,1,0,1,1,100.0,0,0,0,0,0,1,0
1588,Wilson Manafá,pt,DF,MF,Granada,La Liga,29,1994,2.7,6,4,3,2,1,4,7,57.1,3,1,0,1,1,7,4
1589,Hianga Mananga Mbock,fr,MF,FW,Brest,Ligue 1,23,1999,0.1,1,0,0,0,1,1,2,50.0,1,0,0,0,1,2,0
1590,Gianluca Mancini,it,DF,,Roma,Serie A,27,1996,31.9,34,20,21,11,2,11,27,40.7,16,38,26,12,36,70,77
1591,Marco Mancosu,it,MF,FW,Cagliari,Serie A,34,1988,1.7,3,0,0,2,1,1,2,50.0,1,0,0,0,0,3,0
1592,Steve Mandanda,fr,GK,,Rennes,Ligue 1,38,1985,34.0,2,0,2,0,0,2,4,50.0,2,0,0,0,0,2,6
1593,Christos Mandas,gr,GK,,Lazio,Serie A,21,2001,8.0,0,0,0,0,0,0,1,0.0,1,0,0,0,1,1,3
1594,Reinildo Mandava,mz,DF,,Atlético Madrid,La Liga,29,1994,8.1,30,22,16,11,3,19,22,86.4,3,10,2,8,15,45,21
1595,Aïssa Mandi,dz,DF,,Villarreal,La Liga,31,1991,12.4,13,8,8,5,0,7,14,50.0,7,10,7,3,8,21,41
1596,Rolando Mandragora,it,MF,,Fiorentina,Serie A,26,1997,17.6,26,11,8,13,5,10,22,45.5,12,14,3,11,9,35,18
1597,Orel Mangala,be,MF,,Nott'ham Forest,Premier League,25,1998,17.4,27,13,16,10,1,14,29,48.3,15,12,6,6,26,53,32
1598,Orel Mangala,be,MF,,Lyon,Ligue 1,25,1998,4.4,5,3,0,2,3,1,3,33.3,2,3,2,1,5,10,6
1599,Vito Mannone,it,GK,,Lille,Ligue 1,35,1988,1.0,0,0,0,0,0,0,0,,0,0,0,0,0,0,0
1600,Kostas Manolas,gr,DF,,Salernitana,Serie A,32,1991,5.4,9,5,6,3,0,6,8,75.0,2,10,7,3,2,11,20
1601,Javier Manquillo,es,DF,MF,Celta Vigo,La Liga,29,1994,8.3,15,11,6,5,4,8,15,53.3,7,14,3,11,3,18,17
1602,Braydon Manu,gh,MF,,Darmstadt 98,Bundesliga,26,1997,1.9,2,0,0,1,1,0,0,,0,1,0,1,0,2,0
1603,Benson Manuel,ao,MF,FW,Burnley,Premier League,26,1997,1.3,3,2,2,1,0,0,0,,0,1,0,1,0,3,0
1604,Faitout Maouassa,fr,DF,MF,Granada,La Liga,25,1998,2.5,8,5,6,1,1,4,5,80.0,1,6,0,6,1,9,3
1605,Faitout Maouassa,fr,MF,DF,Lens,Ligue 1,25,1998,0.8,1,1,1,0,0,1,1,100.0,0,1,0,1,0,1,3
1606,Marcão,br,DF,,Sevilla,La Liga,27,1996,3.9,9,6,5,4,0,6,10,60.0,4,8,6,2,4,13,11
1607,Solly March,eng,FW,DF,Brighton,Premier League,29,1994,6.2,19,14,9,7,3,8,14,57.1,6,5,0,5,11,30,8
1608,Riccardo Marchizza,it,DF,,Frosinone,Serie A,25,1998,12.8,7,6,4,3,0,3,13,23.1,10,10,2,8,7,14,33
1609,Gian Marco Ferrari,it,DF,,Sassuolo,Serie A,31,1992,25.2,22,10,11,11,0,12,18,66.7,6,28,17,11,25,47,76
1610,Óscar de Marcos,es,DF,,Athletic Club,La Liga,34,1989,25.1,56,39,26,24,6,42,71,59.2,29,28,6,22,15,71,44
1611,Alberto Marí,es,FW,,Valencia,La Liga,22,2001,3.1,4,2,0,1,3,1,1,100.0,0,3,0,3,0,4,5
1612,José Mari,es,MF,FW,Cádiz,La Liga,35,1987,0.2,2,1,0,2,0,1,2,50.0,1,0,0,0,0,2,0
1613,Pablo Marí,es,DF,,Monza,Serie A,29,1993,29.1,41,25,34,7,0,22,34,64.7,12,40,25,15,37,78,115
1614,José María Giménez,uy,DF,,Atlético Madrid,La Liga,28,1995,14.7,18,10,10,7,1,5,16,31.3,11,16,12,4,10,28,95
1615,Mariano,do,FW,MF,Sevilla,La Liga,29,1993,2.7,1,1,0,1,0,0,1,0.0,1,1,0,1,0,1,2
1616,Mirko Marić,hr,FW,,Monza,Serie A,28,1995,3.2,4,0,2,1,1,0,2,0.0,2,4,0,4,2,6,3
1617,Rafa Marín,es,DF,,Alavés,La Liga,21,2002,27.1,32,20,23,9,0,14,27,51.9,13,34,21,13,33,65,129
1618,Răzvan Marin,ro,MF,,Empoli,Serie A,27,1996,20.2,40,22,13,23,4,19,29,65.5,10,16,4,12,6,46,30
1619,Diego Mariño,es,GK,,Almería,La Liga,33,1990,1.0,0,0,0,0,0,0,0,,0,0,0,0,0,0,1
1620,Guillermo Maripán,cl,DF,,Monaco,Ligue 1,29,1994,19.6,22,8,15,6,1,10,27,37.0,17,26,13,13,30,52,106
1621,Mika Màrmol,es,DF,,Las Palmas,La Liga,21,2002,35.3,70,42,44,24,2,35,53,66.0,18,39,19,20,44,114,147
1622,Omar Marmoush,eg,FW,MF,Eint Frankfurt,Bundesliga,24,1999,25.6,21,11,7,8,6,6,16,37.5,10,13,0,13,11,32,7
1623,Marquinhos,br,FW,MF,Nantes,Ligue 1,20,2003,1.7,3,2,2,0,1,1,4,25.0,3,7,2,5,6,9,1
1624,Marquinhos,br,DF,,Paris S-G,Ligue 1,29,1994,17.1,19,11,10,7,2,11,17,64.7,6,29,19,10,17,36,58
1625,Unai Marrero,es,GK,,Real Sociedad,La Liga,21,2001,1.6,0,0,0,0,0,0,0,,0,0,0,0,0,0,0
1626,Agustín Martegani,ar,MF,,Salernitana,Serie A,23,2000,8.1,13,7,7,3,3,6,18,33.3,12,4,1,3,4,17,7
1627,Eric Martel,de,MF,,Köln,Bundesliga,21,2002,27.3,70,43,32,34,4,37,67,55.2,30,65,19,46,43,113,80
1628,Roger Martí,es,FW,,Cádiz,La Liga,32,1991,15.1,12,6,1,9,2,2,7,28.6,5,16,1,15,7,19,4
1629,Anthony Martial,fr,FW,,Manchester Utd,Premier League,27,1995,5.0,4,1,1,1,2,1,1,100.0,0,4,0,4,0,4,3
1630,Aarón Martín,es,DF,,Genoa,Serie A,26,1997,15.3,21,10,7,10,4,9,22,40.9,13,12,4,8,9,30,15
1631,Iván Martín,es,MF,,Girona,La Liga,24,1999,30.3,44,25,22,15,7,22,57,38.6,35,25,3,22,21,65,14
1632,Jon Martin,es,DF,,Real Sociedad,La Liga,17,2006,0.3,0,0,0,0,0,0,0,,0,0,0,0,0,0,3
1633,Jonas Martin,fr,MF,,Brest,Ligue 1,33,1990,13.4,43,27,17,24,2,21,36,58.3,15,16,2,14,9,52,28
1634,Mario Martín,es,MF,,Real Madrid,La Liga,19,2004,0.2,5,1,0,2,3,3,4,75.0,1,2,1,1,0,5,0
1635,Gabriel Martinelli,br,FW,,Arsenal,Premier League,22,2001,22.4,30,24,9,12,9,13,32,40.6,19,23,1,22,5,35,9
1636,Tommaso Martinelli,it,GK,,Fiorentina,Serie A,17,2006,1.0,0,0,0,0,0,0,0,,0,0,0,0,0,0,0
1637,Arnau Martinez,es,DF,,Girona,La Liga,20,2003,13.8,25,16,17,6,2,15,32,46.9,17,15,5,10,10,35,41
1638,Emiliano Martínez,ar,GK,,Aston Villa,Premier League,30,1992,33.5,0,0,0,0,0,0,0,,0,0,0,0,0,0,12
1639,Iñigo Martínez,es,DF,,Barcelona,La Liga,32,1991,14.4,10,7,9,1,0,6,8,75.0,2,13,10,3,11,21,50
1640,Josep Martinez,es,GK,,Genoa,Serie A,25,1998,36.0,0,0,0,0,0,0,0,,0,0,0,0,1,1,21
1641,Lautaro Martínez,ar,FW,,Inter,Serie A,25,1997,29.5,22,16,4,13,5,4,19,21.1,15,30,1,29,20,42,10
1642,Lisandro Martínez,ar,DF,,Manchester Utd,Premier League,25,1998,7.2,12,8,8,4,0,5,12,41.7,7,10,8,2,5,17,26
1643,Marc Martínez,es,GK,,Granada,La Liga,33,1990,3.0,0,0,0,0,0,0,1,0.0,1,0,0,0,0,0,1
1644,Lucas Martínez Quarta,ar,DF,,Fiorentina,Serie A,27,1996,25.5,75,47,43,28,4,36,54,66.7,18,38,14,24,30,105,69
1645,Adam Marušić,me,DF,,Lazio,Serie A,30,1992,34.4,45,31,24,19,2,27,49,55.1,22,27,7,20,29,74,63
1646,Marvin,es,FW,DF,Las Palmas,La Liga,23,2000,20.6,39,25,18,17,4,18,36,50.0,18,28,2,26,14,53,18
1647,Omar Mascarell,gq,MF,,Mallorca,La Liga,30,1993,17.5,33,16,16,17,0,18,35,51.4,17,24,8,16,31,64,30
1648,Adam Masina,ma,DF,,Udinese,Serie A,29,1994,0.7,4,0,2,2,0,2,4,50.0,2,2,1,1,2,6,5
1649,Adam Masina,ma,DF,,Torino,Serie A,29,1994,11.4,17,12,8,8,1,5,20,25.0,15,12,6,6,11,28,30
1650,Erhan Mašović,rs,DF,MF,Bochum,Bundesliga,24,1998,24.7,64,40,37,22,5,37,70,52.9,33,32,10,22,25,89,75
1651,Han-Noah Massengo,fr,MF,DF,Burnley,Premier League,22,2001,0.2,1,1,1,0,0,0,0,,0,1,0,1,0,1,0
1652,Roberto Massimo,de,FW,DF,Stuttgart,Bundesliga,22,2000,0.9,1,0,1,0,0,1,2,50.0,1,0,0,0,0,1,1
1653,Clinton Mata,ao,DF,,Lyon,Ligue 1,30,1992,24.7,43,24,29,8,6,23,40,57.5,17,35,16,19,40,83,61
1654,Jaime Mata,es,FW,MF,Getafe,La Liga,34,1988,19.9,24,15,12,8,4,11,26,42.3,15,18,1,17,17,41,31
1655,Pape Matar Sarr,sn,MF,,Tottenham,Premier League,20,2002,23.0,34,24,11,17,6,15,36,41.7,21,21,5,16,31,65,28
1656,Eliot Matazo,be,MF,,Monaco,Ligue 1,21,2002,1.1,3,1,0,3,0,2,4,50.0,2,1,1,0,3,6,0
1657,Jean-Philippe Mateta,fr,FW,,Crystal Palace,Premier League,26,1997,25.4,22,15,4,11,7,6,10,60.0,4,13,4,9,4,26,14
1658,Nemanja Matić,rs,MF,,Rennes,Ligue 1,34,1988,11.4,19,10,7,9,3,9,12,75.0,3,15,7,8,27,46,19
1659,Nemanja Matić,rs,MF,,Lyon,Ligue 1,34,1988,13.9,17,11,8,7,2,9,19,47.4,10,17,6,11,16,33,17
1660,Joël Matip,cm,DF,,Liverpool,Premier League,31,1991,8.7,12,6,7,4,1,8,12,66.7,4,16,12,4,9,21,43
1661,Alex Matos,eng,MF,,Chelsea,Premier League,18,2004,0.0,0,0,0,0,0,0,0,,0,0,0,0,0,0,0
1662,Chrislain Matsima,fr,DF,,Clermont Foot,Ligue 1,21,2002,13.1,18,11,11,7,0,10,18,55.6,8,14,10,4,13,31,74
1663,Chrislain Matsima,fr,DF,,Monaco,Ligue 1,21,2002,3.3,9,7,5,3,1,2,7,28.6,5,4,1,3,4,13,4
1664,Jean Mattéo Bahoya,fr,MF,FW,Eint Frankfurt,Bundesliga,18,2005,2.0,3,1,0,3,0,1,4,25.0,3,2,0,2,1,4,1
1665,Remi Matthews,eng,GK,,Crystal Palace,Premier League,29,1994,0.0,0,0,0,0,0,0,0,,0,0,0,0,0,0,1
1666,Alan Matturro,uy,DF,,Genoa,Serie A,18,2004,1.2,1,1,1,0,0,1,1,100.0,0,6,3,3,2,3,4
1667,Azor Matusiwa,nl,MF,,Reims,Ligue 1,25,1998,15.4,39,27,17,19,3,22,32,68.8,10,21,3,18,33,72,32
1668,Azor Matusiwa,nl,MF,,Rennes,Ligue 1,25,1998,8.8,7,3,3,4,0,4,7,57.1,3,9,2,7,11,18,17
1669,Neal Maupay,fr,FW,,Brentford,Premier League,26,1996,14.7,10,7,4,5,1,3,13,23.1,10,11,0,11,2,12,3
1670,Neal Maupay,fr,FW,,Everton,Premier League,26,1996,1.2,0,0,0,0,0,0,1,0.0,1,2,0,2,0,0,1
1671,Aïman Maurer,ma,MF,FW,Clermont Foot,Ligue 1,18,2004,0.6,1,1,1,0,0,1,3,33.3,2,0,0,0,0,1,0
1672,Konstantinos Mavropanos,gr,DF,,West Ham,Premier League,25,1997,16.7,28,16,17,9,2,17,21,81.0,4,21,13,8,23,51,79
1673,Christian Mawissa,fr,DF,,Toulouse,Ligue 1,18,2005,12.4,22,15,14,4,4,9,23,39.1,14,22,11,11,22,44,41
1674,Philipp Max,de,DF,,Eint Frankfurt,Bundesliga,29,1993,15.0,26,17,6,18,2,19,26,73.1,7,18,1,17,7,33,18
1675,Eric Maxim Choupo-Moting,cm,MF,FW,Bayern Munich,Bundesliga,34,1989,8.0,17,12,8,5,4,6,14,42.9,8,5,0,5,7,24,7
1676,Luís Maximiano,pt,GK,,Almería,La Liga,24,1999,33.0,0,0,0,0,0,0,1,0.0,1,0,0,0,0,0,19
1677,Noam Mayoka-Tika,be,MF,,Marseille,Ligue 1,19,2003,0.0,0,0,0,0,0,0,0,,0,0,0,0,0,0,0
1678,Borja Mayoral,es,FW,,Getafe,La Liga,26,1997,23.9,9,5,2,2,5,5,22,22.7,17,7,0,7,4,13,16
1679,Senny Mayulu,fr,FW,MF,Paris S-G,Ligue 1,17,2006,3.6,13,8,6,6,1,6,7,85.7,1,1,0,1,3,16,0
1680,Youssef Maziz,fr,FW,MF,Metz,Ligue 1,25,1998,1.4,0,0,0,0,0,0,2,0.0,2,1,0,1,1,1,2
1681,Noussair Mazraoui,ma,DF,,Bayern Munich,Bundesliga,25,1997,13.3,32,21,14,11,7,13,21,61.9,8,14,1,13,20,52,27
1682,Luca Mazzitelli,it,MF,,Frosinone,Serie A,27,1995,24.6,45,23,15,24,6,26,49,53.1,23,23,7,16,19,64,62
1683,Pasquale Mazzocchi,it,DF,,Salernitana,Serie A,28,1995,14.1,25,19,14,10,1,16,29,55.2,13,14,6,8,5,30,31
1684,Pasquale Mazzocchi,it,DF,,Napoli,Serie A,28,1995,4.8,5,2,1,2,2,2,3,66.7,1,5,1,4,1,6,13
1685,Kevin Mbabu,ch,DF,,Augsburg,Bundesliga,28,1995,22.7,51,39,25,18,8,23,40,57.5,17,29,9,20,24,75,48
1686,Noah Mbamba,be,MF,,Leverkusen,Bundesliga,18,2005,0.2,0,0,0,0,0,0,0,,0,0,0,0,1,1,0
1687,Ethan Mbappé,fr,MF,DF,Paris S-G,Ligue 1,16,2006,0.5,0,0,0,0,0,0,2,0.0,2,1,0,1,0,0,0
1688,Kylian Mbappé,fr,FW,,Paris S-G,Ligue 1,24,1998,24.0,4,1,1,1,2,4,9,44.4,5,4,0,4,2,6,2
1689,Malick Mbaye,sn,MF,FW,Metz,Ligue 1,19,2004,1.7,5,1,0,1,4,1,2,50.0,1,1,0,1,1,6,2
1690,Mamadou Mbaye,sn,DF,,Cádiz,La Liga,25,1998,3.2,6,3,3,3,0,2,5,40.0,3,10,7,3,5,11,26
1691,Chancel Mbemba,cd,DF,,Marseille,Ligue 1,28,1994,24.5,33,21,25,7,1,17,30,56.7,13,21,13,8,13,46,95
1692,Nolan Mbemba,cg,MF,,Le Havre,Ligue 1,28,1995,0.2,2,1,0,1,1,1,2,50.0,1,0,0,0,0,2,0
1693,Bryan Mbeumo,cm,FW,,Brentford,Premier League,23,1999,21.8,15,10,6,6,3,5,19,26.3,14,26,2,24,7,22,13
1694,Christ Mbondi,fr,FW,,Reims,Ligue 1,18,2004,0.0,1,1,1,0,0,1,1,100.0,0,0,0,0,0,1,0
1695,Jordi Mboula,es,FW,MF,Hellas Verona,Serie A,24,1999,3.4,4,4,1,2,1,4,7,57.1,3,4,1,3,1,5,0
1696,Nathanael Mbuku,cd,FW,,Augsburg,Bundesliga,21,2002,0.1,0,0,0,0,0,0,0,,0,1,0,1,0,0,0
1697,James Mcatee,eng,MF,FW,Sheffield Utd,Premier League,20,2002,20.2,32,21,9,13,10,13,33,39.4,20,20,0,20,11,43,18
1698,James Mcatee,eng,MF,,Manchester City,Premier League,20,2002,0.0,0,0,0,0,0,0,0,,0,1,0,1,0,0,0
1699,Oliver McBurnie,sct,FW,,Sheffield Utd,Premier League,27,1996,14.2,17,7,4,7,6,5,12,41.7,7,18,2,16,5,22,28
1700,James McConnell,eng,MF,,Liverpool,Premier League,18,2004,0.0,0,0,0,0,0,0,0,,0,1,0,1,1,1,0
1701,John McGinn,sct,MF,FW,Aston Villa,Premier League,28,1994,33.3,59,35,18,34,7,32,77,41.6,45,33,4,29,21,80,21
1702,Scott McKenna,sct,DF,,Nott'ham Forest,Premier League,26,1996,4.6,4,0,3,1,0,2,3,66.7,1,6,4,2,5,9,27
1703,Weston McKennie,us,MF,DF,Juventus,Serie A,24,1998,28.8,48,29,31,11,6,17,27,63.0,10,28,7,21,18,66,69
1704,Dwight McNeil,eng,MF,FW,Everton,Premier League,23,1999,32.1,44,27,16,14,14,24,55,43.6,31,44,7,37,22,66,37
1705,Scott McTominay,sct,MF,FW,Manchester Utd,Premier League,26,1996,21.1,49,25,23,24,2,22,33,66.7,11,34,12,22,14,63,54
1706,Facundo Medina,ar,DF,,Lens,Ligue 1,24,1999,30.2,64,38,25,31,8,44,69,63.8,25,38,13,25,24,88,59
1707,Ben Mee,eng,DF,,Brentford,Premier League,33,1989,14.1,26,15,12,12,2,17,22,77.3,5,21,13,8,13,39,63
1708,Marvin Mehlem,de,MF,,Darmstadt 98,Bundesliga,25,1997,16.5,28,21,10,14,4,11,27,40.7,16,21,2,19,33,61,15
1709,Bamo Meïté,ci,DF,,Marseille,Ligue 1,21,2001,7.1,16,10,13,3,0,8,12,66.7,4,11,5,6,11,27,35
1710,Bamo Meïté,ci,DF,,Lorient,Ligue 1,21,2001,1.6,2,1,2,0,0,0,1,0.0,1,3,2,1,3,5,9
1711,Hannibal Mejbri,tn,MF,FW,Manchester Utd,Premier League,20,2003,1.5,3,3,1,2,0,1,3,33.3,2,1,1,0,0,3,0
1712,Hannibal Mejbri,tn,MF,,Sevilla,La Liga,20,2003,1.2,3,3,1,2,0,0,1,0.0,1,1,0,1,0,3,0
1713,Óscar Melendo,es,MF,FW,Granada,La Liga,25,1997,12.5,14,6,4,10,0,4,12,33.3,8,13,0,13,5,19,4
1714,Gonzalo Melero,es,MF,FW,Almería,La Liga,29,1994,12.3,14,8,7,5,2,7,19,36.8,12,12,4,8,4,18,11
1715,Birger Meling,no,DF,,Rennes,Ligue 1,28,1994,0.2,1,1,1,0,0,1,1,100.0,0,1,0,1,0,1,0
1716,Arthur Melo,br,MF,,Fiorentina,Serie A,26,1996,22.1,45,30,17,24,4,26,42,61.9,16,27,3,24,18,63,8
1717,Memphis,nl,FW,,Atlético Madrid,La Liga,29,1994,9.9,5,2,0,3,2,3,6,50.0,3,2,0,2,1,6,0
1718,Houboulang Mendes,gw,DF,,Almería,La Liga,25,1998,4.4,16,13,11,5,0,8,16,50.0,8,4,2,2,1,17,17
1719,Nuno Mendes,pt,DF,,Paris S-G,Ligue 1,21,2002,3.0,5,5,4,1,0,4,7,57.1,3,4,0,4,4,9,2
1720,Tomás Mendes,es,MF,,Alavés,La Liga,18,2004,0.1,0,0,0,0,0,0,0,,0,0,0,0,0,0,0
1721,Brais Méndez,es,MF,FW,Real Sociedad,La Liga,26,1997,26.8,42,28,13,20,9,15,43,34.9,28,23,4,19,12,54,21
1722,Bruno Méndez,uy,DF,,Granada,La Liga,23,1999,14.8,36,17,19,12,5,21,37,56.8,16,24,6,18,26,62,45
1723,Diego Méndez,es,MF,,Rayo Vallecano,La Liga,19,2003,0.1,1,1,1,0,0,1,1,100.0,0,0,0,0,1,2,0
1724,Leonardo Mendicino,it,MF,,Atalanta,Serie A,17,2006,0.0,0,0,0,0,0,0,0,,0,0,0,0,0,0,0
1725,Antoine Mendy,fr,DF,,Nice,Ligue 1,19,2004,4.6,7,5,4,3,0,3,7,42.9,4,4,1,3,8,15,16
1726,Benjamin Mendy,fr,DF,,Lorient,Ligue 1,29,1994,7.9,3,1,2,1,0,1,5,20.0,4,8,2,6,7,10,20
1727,Ferland Mendy,fr,DF,,Real Madrid,La Liga,28,1995,19.1,15,10,12,2,1,11,14,78.6,3,12,2,10,13,28,26
1728,Formose Mendy,sn,DF,,Lorient,Ligue 1,22,2001,14.0,33,19,24,8,1,20,33,60.6,13,23,12,11,20,53,59
1729,Nampalys Mendy,sn,MF,,Lens,Ligue 1,31,1992,11.7,29,18,10,13,6,16,20,80.0,4,11,4,7,14,43,14
1730,Teden Mengi,eng,DF,,Luton Town,Premier League,21,2002,27.4,54,22,33,20,1,19,30,63.3,11,39,27,12,57,111,140
1731,Chris Mepham,wls,DF,,Bournemouth,Premier League,25,1997,6.9,12,11,9,3,0,9,14,64.3,5,13,6,7,7,19,30
1732,Jorge Meré,es,DF,,Cádiz,La Liga,26,1997,7.5,8,7,6,2,0,4,7,57.1,3,5,3,2,8,16,33
1733,Alex Meret,it,GK,,Napoli,Serie A,26,1997,30.8,1,0,1,0,0,1,2,50.0,1,0,0,0,0,1,10
1734,Mikel Merino,es,MF,,Real Sociedad,La Liga,27,1996,27.6,77,43,25,34,18,22,48,45.8,26,36,11,25,16,93,55
1735,Quentin Merlin,fr,DF,,Marseille,Ligue 1,21,2002,7.8,13,12,7,5,1,8,20,40.0,12,4,0,4,6,19,14
1736,Quentin Merlin,fr,DF,,Nantes,Ligue 1,21,2002,14.3,29,20,15,12,2,16,25,64.0,9,22,1,21,18,47,22
1737,Junior Messias,br,MF,DF,Genoa,Serie A,32,1991,11.7,26,20,19,5,2,8,19,42.1,11,9,1,8,5,31,22
1738,Thomas Meunier,be,DF,,Dortmund,Bundesliga,31,1991,6.5,5,1,3,2,0,3,13,23.1,10,8,2,6,4,9,22
1739,Bastien Meupiyou,fr,DF,,Nantes,Ligue 1,17,2006,0.1,0,0,0,0,0,0,0,,0,0,0,0,0,0,1
1740,Alexander Meyer,de,GK,,Dortmund,Bundesliga,32,1991,7.7,1,1,1,0,0,1,1,100.0,0,0,0,0,0,1,2
1741,Omenuke Mfulu,cd,MF,FW,Las Palmas,La Liga,29,1994,0.9,4,3,3,1,0,0,1,0.0,1,1,1,0,2,6,5
1742,Lucas Michal,fr,FW,,Monaco,Ligue 1,18,2005,0.1,0,0,0,0,0,0,0,,0,0,0,0,0,0,0
1743,Sven Michel,de,FW,MF,Augsburg,Bundesliga,33,1990,6.5,7,5,2,1,4,2,7,28.6,5,1,0,1,0,7,4
1744,Miguel,es,FW,MF,Alavés,La Liga,23,1999,0.7,0,0,0,0,0,0,0,,0,2,0,2,0,0,0
1745,Georges Mikautadze,ge,FW,,Metz,Ligue 1,22,2000,19.4,4,3,1,2,1,0,9,0.0,9,11,0,11,8,12,3
1746,Nikola Milenković,rs,DF,,Fiorentina,Serie A,25,1997,27.9,41,21,24,14,3,22,36,61.1,14,22,14,8,27,68,95
1747,Lewis Miley,eng,MF,,Newcastle Utd,Premier League,17,2006,13.4,33,21,6,20,7,15,32,46.9,17,20,3,17,8,41,18
1748,Arkadiusz Milik,pl,FW,,Juventus,Serie A,29,1994,10.2,9,5,2,5,2,3,5,60.0,2,7,1,6,5,14,3
1749,Vanja Milinković-Savić,rs,GK,,Torino,Serie A,26,1997,36.0,1,0,1,0,0,1,1,100.0,0,0,0,0,1,2,14
1750,Éder Militão,br,DF,,Real Madrid,La Liga,25,1998,5.5,7,3,4,3,0,6,9,66.7,3,4,3,1,4,11,19
1751,Luis Milla,es,MF,,Getafe,La Liga,28,1994,23.5,57,33,19,28,10,28,47,59.6,19,20,1,19,32,89,10
1752,Enzo Millot,fr,MF,FW,Stuttgart,Bundesliga,21,2002,24.9,40,22,9,21,10,18,39,46.2,21,24,2,22,16,56,7
1753,James Milner,eng,DF,MF,Brighton,Premier League,37,1986,8.6,20,14,9,10,1,9,14,64.3,5,9,0,9,8,28,16
1754,Jovan Milošević,rs,FW,MF,Stuttgart,Bundesliga,18,2005,0.3,0,0,0,0,0,0,0,,0,0,0,0,0,0,0
1755,Marko Milovanović,rs,FW,MF,Almería,La Liga,19,2003,3.4,4,4,1,3,0,2,4,50.0,2,2,0,2,0,4,5
1756,Kim Min-jae,kr,DF,,Bayern Munich,Bundesliga,26,1996,21.9,37,24,21,11,5,12,24,50.0,12,29,19,10,45,82,70
1757,Yerry Mina,co,DF,MF,Fiorentina,Serie A,28,1994,0.5,1,1,1,0,0,1,2,50.0,1,0,0,0,0,1,2
1758,Yerry Mina,co,DF,,Cagliari,Serie A,28,1994,13.5,20,13,14,6,0,13,19,68.4,6,23,14,9,4,24,77
1759,Takumi Minamino,jp,MF,,Monaco,Ligue 1,28,1995,23.5,34,17,10,13,11,16,54,29.6,38,29,1,28,11,45,8
1760,Lucas Mincarelli,fr,DF,MF,Montpellier,Ligue 1,19,2004,10.9,29,16,19,6,4,17,34,50.0,17,17,4,13,8,37,27
1761,Tyrone Mings,eng,DF,,Aston Villa,Premier League,30,1993,0.3,0,0,0,0,0,0,0,,0,0,0,0,1,1,1
1762,Óscar Mingueza,es,DF,MF,Celta Vigo,La Liga,24,1999,33.3,62,38,44,11,7,37,80,46.3,43,38,7,31,17,79,49
1763,Ignasi Miquel,es,DF,,Granada,La Liga,30,1992,33.2,47,30,39,6,2,23,40,57.5,17,32,16,16,45,92,132
1764,Rafa Mir,es,FW,MF,Sevilla,La Liga,26,1997,4.3,2,2,1,1,0,1,2,50.0,1,2,0,2,1,3,1
1765,Ignacio Miramon,ar,MF,,Lille,Ligue 1,20,2003,0.4,1,0,0,1,0,0,1,0.0,1,1,0,1,0,1,0
1766,Aleksei Miranchuk,ru,MF,FW,Atalanta,Serie A,27,1995,13.1,12,6,6,4,2,5,13,38.5,8,6,1,5,2,14,5
1767,Juan Miranda,es,DF,,Betis,La Liga,23,2000,20.6,38,24,21,13,4,17,31,54.8,14,31,6,25,19,57,62
1768,Kevin Miranda,it,DF,,Sassuolo,Serie A,20,2003,0.2,0,0,0,0,0,0,0,,0,0,0,0,0,0,1
1769,Antonio Mirante,it,GK,,Milan,Serie A,40,1983,2.0,0,0,0,0,0,0,0,,0,0,0,0,0,0,1
1770,Fabio Miretti,it,MF,,Juventus,Serie A,19,2003,12.3,18,14,6,8,4,10,26,38.5,16,10,1,9,7,25,6
1771,Filippo Missori,it,DF,,Sassuolo,Serie A,19,2004,3.0,6,3,2,4,0,4,11,36.4,7,3,2,1,4,10,8
1772,Tyrick Mitchell,eng,DF,MF,Crystal Palace,Premier League,23,1999,35.6,105,60,75,21,9,43,60,71.7,17,63,10,53,26,131,104
1773,Kaoru Mitoma,jp,FW,,Brighton,Premier League,26,1997,16.5,13,6,3,7,3,5,19,26.3,14,15,1,14,5,18,12
1774,Aleksandar Mitrović,rs,FW,,Fulham,Premier League,28,1994,0.4,0,0,0,0,0,0,0,,0,0,0,0,0,0,0
1775,Stefan Mitrović,rs,FW,MF,Hellas Verona,Serie A,20,2002,4.3,6,3,0,5,1,2,5,40.0,3,6,1,5,0,6,4
1776,Stefan Mitrović,rs,DF,,Getafe,La Liga,33,1990,7.8,9,3,7,2,0,4,8,50.0,4,3,2,1,6,15,26
1777,Maximilian Mittelstädt,de,DF,,Stuttgart,Bundesliga,26,1997,23.4,91,51,46,39,6,53,89,59.6,36,36,6,30,46,137,65
1778,Henrikh Mkhitaryan,am,MF,,Inter,Serie A,34,1989,30.9,62,34,18,35,9,24,49,49.0,25,23,4,19,29,91,43
1779,Marko Mladenović,rs,MF,,Eint Frankfurt,Bundesliga,18,2005,0.1,0,0,0,0,0,0,0,,0,0,0,0,0,0,0
1780,Jakub Moder,pl,MF,DF,Brighton,Premier League,24,1999,6.9,19,10,9,5,5,9,18,50.0,9,8,2,6,2,21,12
1781,Luka Modrić,hr,MF,,Real Madrid,La Liga,37,1985,18.8,22,15,10,6,6,9,25,36.0,16,13,4,9,21,43,9
1782,Max Moerstedt,de,DF,FW,Hoffenheim,Bundesliga,,,0.1,0,0,0,0,0,0,1,0.0,1,0,0,0,0,0,0
1783,Terem Moffi,ng,FW,,Nice,Ligue 1,24,1999,21.7,7,4,0,5,2,3,12,25.0,9,14,1,13,3,10,15
1784,Mostafa Mohamed,eg,FW,,Nantes,Ligue 1,25,1997,22.2,21,14,7,11,3,6,28,21.4,22,21,5,16,12,33,29
1785,Dion Moise Sahi,ci,MF,FW,Strasbourg,Ligue 1,21,2001,7.0,5,5,1,2,2,0,3,0.0,3,11,1,10,1,6,7
1786,Johan Mojica,co,DF,,Osasuna,La Liga,30,1992,22.7,30,22,11,15,4,16,25,64.0,9,15,2,13,21,51,40
1787,Alberto Moleiro,es,FW,MF,Las Palmas,La Liga,19,2003,20.0,15,6,4,7,4,6,30,20.0,24,11,0,11,7,22,10
1788,Nahuel Molina,ar,DF,,Atlético Madrid,La Liga,25,1998,20.6,38,22,16,18,4,26,54,48.1,28,19,3,16,9,47,36
1789,Florent Mollet,fr,MF,FW,Nantes,Ligue 1,31,1991,23.1,18,11,8,6,4,10,31,32.3,21,18,5,13,13,31,17
1790,Jon Moncayola,es,MF,,Osasuna,La Liga,25,1998,20.0,27,18,14,10,3,17,42,40.5,25,31,5,26,15,42,21
1791,Enzo Mongo,fr,DF,,Nantes,Ligue 1,18,2005,0.1,1,1,1,0,0,1,2,50.0,1,1,1,0,1,2,0
1792,Ilario Monterisi,it,DF,,Frosinone,Serie A,21,2001,16.3,23,13,14,7,2,12,26,46.2,14,22,18,4,8,31,63
1793,César Montes,mx,DF,,Almería,La Liga,26,1997,19.9,22,13,13,9,0,9,18,50.0,9,21,9,12,11,33,94
1794,Gonzalo Montiel,ar,DF,,Nott'ham Forest,Premier League,26,1997,8.9,22,19,12,8,2,16,29,55.2,13,8,3,5,9,31,31
1795,Lorenzo Montipò,it,GK,,Hellas Verona,Serie A,27,1996,37.0,1,1,1,0,0,1,3,33.3,2,0,0,0,0,1,25
1796,Kieffer Moore,wls,FW,MF,Bournemouth,Premier League,30,1992,1.2,0,0,0,0,0,0,0,,0,0,0,0,0,0,0
1797,Mikey Moore,eng,MF,,Tottenham,Premier League,15,2007,0.0,0,0,0,0,0,0,0,,0,0,0,0,0,0,1
1798,Álvaro Morata,es,FW,,Atlético Madrid,La Liga,30,1992,21.2,16,10,4,7,5,3,5,60.0,2,18,3,15,1,17,26
1799,Diego Moreira,pt,FW,MF,Lyon,Ligue 1,18,2004,3.0,0,0,0,0,0,0,3,0.0,3,3,0,3,2,2,5
1800,Alberto Moreno,es,DF,,Villarreal,La Liga,31,1992,16.5,31,21,19,10,2,10,30,33.3,20,12,2,10,24,55,33
1801,Álex Moreno,es,DF,,Aston Villa,Premier League,30,1993,11.5,18,12,18,0,0,12,19,63.2,7,11,2,9,13,31,37
1802,Gerard Moreno,es,FW,,Villarreal,La Liga,31,1992,24.6,25,12,10,7,8,11,25,44.0,14,24,7,17,9,34,24
1803,Jorge Moreno,es,DF,,Osasuna,La Liga,22,2001,0.2,0,0,0,0,0,0,0,,0,1,0,1,0,0,3
1804,Mateu Morey,es,DF,,Dortmund,Bundesliga,23,2000,1.2,2,2,1,1,0,2,4,50.0,2,3,1,2,1,3,3
1805,Ilaix Moriba,gn,MF,FW,Getafe,La Liga,20,2003,6.7,20,11,3,11,6,4,9,44.4,5,3,1,2,4,24,10
1806,Manu Morlanes,es,MF,,Mallorca,La Liga,24,1999,17.9,50,29,23,26,1,23,53,43.4,30,13,1,12,20,70,21
1807,Nikola Moro,hr,MF,,Bologna,Serie A,25,1998,9.3,21,16,8,12,1,8,15,53.3,7,14,1,13,7,28,10
1808,Carlton Morris,eng,FW,MF,Luton Town,Premier League,27,1995,31.8,15,8,4,6,5,9,15,60.0,6,24,5,19,1,16,53
1809,Cristhian Mosquera,es,DF,,Valencia,La Liga,19,2004,34.2,57,34,36,18,3,25,39,64.1,14,42,23,19,36,93,137
1810,Yerson Mosquera,co,DF,,Villarreal,La Liga,22,2001,13.7,27,13,18,7,2,12,15,80.0,3,12,2,10,17,44,65
1811,Dany Mota,pt,FW,MF,Monza,Serie A,25,1998,22.8,13,7,2,5,6,8,17,47.1,9,4,1,3,2,15,18
1812,Lebo Mothiba,za,FW,,Strasbourg,Ligue 1,27,1996,6.9,5,2,1,4,0,3,4,75.0,1,6,1,5,0,5,11
1813,Youssoufa Moukoko,de,FW,,Dortmund,Bundesliga,18,2004,6.9,4,1,2,2,0,3,7,42.9,4,4,1,3,2,6,4
1814,Steve Mounié,bj,FW,,Brest,Ligue 1,28,1994,19.7,8,7,0,3,5,3,11,27.3,8,13,3,10,2,10,18
1815,Mason Mount,eng,MF,FW,Manchester Utd,Premier League,24,1999,5.7,22,14,6,10,6,6,16,37.5,10,6,1,5,6,28,3
1816,Samuel Moutoussamy,cd,MF,,Nantes,Ligue 1,26,1996,12.3,38,20,14,17,7,17,37,45.9,20,16,3,13,11,49,13
1817,Loris Mouyokolo,fr,DF,,Lorient,Ligue 1,22,2001,1.0,4,1,4,0,0,1,1,100.0,0,1,0,1,0,4,3
1818,Divin Mubama,eng,FW,,West Ham,Premier League,18,2004,0.9,0,0,0,0,0,0,0,,0,0,0,0,0,0,0
1819,Mykhailo Mudryk,ua,FW,,Chelsea,Premier League,22,2001,17.5,21,12,9,7,5,10,32,31.3,22,14,1,13,9,30,9
1820,François Mughe,cm,MF,DF,Marseille,Ligue 1,19,2004,2.0,0,0,0,0,0,0,3,0.0,3,2,0,2,1,1,1
1821,Nordi Mukiele,fr,DF,,Paris S-G,Ligue 1,25,1997,8.8,12,8,6,5,1,8,15,53.3,7,17,4,13,14,26,28
1822,Samuele Mulattieri,it,FW,MF,Sassuolo,Serie A,22,2000,5.1,1,1,0,0,1,1,2,50.0,1,7,2,5,1,2,2
1823,Andreas Müller,de,MF,,Darmstadt 98,Bundesliga,23,2000,3.9,14,9,8,5,1,4,9,44.4,5,5,2,3,4,18,5
1824,Jannik Müller,de,DF,MF,Darmstadt 98,Bundesliga,29,1994,12.6,33,16,21,9,3,16,27,59.3,11,24,12,12,17,50,39
1825,Kevin Müller,de,GK,,Heidenheim,Bundesliga,32,1991,34.0,3,0,3,0,0,3,5,60.0,2,0,0,0,0,3,6
1826,Marcus Müller,de,MF,,Mainz 05,Bundesliga,20,2002,0.2,0,0,0,0,0,0,0,,0,0,0,0,0,0,0
1827,Thomas Müller,de,MF,FW,Bayern Munich,Bundesliga,33,1989,18.4,26,16,5,10,11,13,35,37.1,22,22,0,22,3,29,6
1828,Abdul Mumin,gh,DF,,Rayo Vallecano,La Liga,25,1998,18.8,19,10,13,4,2,8,10,80.0,2,27,19,8,22,41,82
1829,Marshall Munetsi,zw,MF,,Reims,Ligue 1,27,1996,24.1,61,39,18,34,9,33,61,54.1,28,21,7,14,14,75,33
1830,Iker Muniain,es,MF,FW,Athletic Club,La Liga,30,1992,6.6,5,1,2,3,0,1,3,33.3,2,4,1,3,0,5,0
1831,Rodrigo Muniz,br,FW,,Fulham,Premier League,22,2001,17.7,7,3,1,5,1,1,6,16.7,5,9,3,6,6,13,20
1832,Aihen Muñoz,es,DF,,Real Sociedad,La Liga,25,1997,12.5,36,21,20,10,6,24,35,68.6,11,16,8,8,9,45,33
1833,Daniel Muñoz,co,DF,MF,Crystal Palace,Premier League,27,1996,16.0,55,35,31,14,10,19,38,50.0,19,29,7,22,24,79,47
1834,Iker Muñoz,es,MF,,Osasuna,La Liga,20,2002,20.6,32,18,13,17,2,15,31,48.4,16,16,5,11,11,43,50
1835,Javier Muñoz,es,MF,,Las Palmas,La Liga,28,1995,29.3,42,23,14,22,6,16,44,36.4,28,40,4,36,20,62,29
1836,Finley Munroe,eng,MF,,Aston Villa,Premier League,18,2005,0.0,0,0,0,0,0,0,0,,0,0,0,0,0,0,0
1837,Arijanet Muric,xk,GK,,Burnley,Premier League,24,1998,10.0,1,1,1,0,0,1,1,100.0,0,0,0,0,0,1,10
1838,Luis Muriel,co,FW,MF,Atalanta,Serie A,32,1991,4.5,3,2,0,2,1,1,1,100.0,0,4,0,4,1,4,0
1839,Murillo,br,DF,,Nott'ham Forest,Premier League,21,2002,31.0,50,31,36,13,1,19,33,57.6,14,41,24,17,37,87,188
1840,Vedat Muriqi,xk,FW,,Mallorca,La Liga,29,1994,25.9,11,6,4,3,4,2,14,14.3,12,11,4,7,6,17,26
1841,Alex Murphy,ie,DF,FW,Newcastle Utd,Premier League,19,2004,0.1,1,1,0,1,0,1,2,50.0,1,1,0,1,1,2,0
1842,Jacob Murphy,eng,FW,DF,Newcastle Utd,Premier League,28,1995,13.2,20,10,8,4,8,12,26,46.2,14,17,0,17,6,26,16
1843,Yunus Musah,us,MF,FW,Milan,Serie A,20,2002,16.4,25,14,15,6,4,8,15,53.3,7,18,4,14,10,35,16
1844,Jamal Musiala,de,MF,FW,Bayern Munich,Bundesliga,20,2003,19.5,40,25,9,21,10,14,36,38.9,22,25,1,24,16,56,5
1845,Florent Muslija,xk,MF,FW,Freiburg,Bundesliga,25,1998,1.2,5,4,3,2,0,2,5,40.0,3,1,0,1,0,5,2
1846,Juan Musso,ar,GK,,Atalanta,Serie A,29,1994,11.0,1,0,1,0,0,1,1,100.0,0,0,0,0,0,1,6
1847,Kingstone Mutandwa,zm,FW,MF,Cagliari,Serie A,20,2003,0.4,1,0,1,0,0,1,4,25.0,3,1,0,1,0,1,2
1848,Yvon Mvogo,ch,GK,,Lorient,Ligue 1,29,1994,34.0,0,0,0,0,0,0,1,0.0,1,0,0,0,0,0,15
1849,Joel Mvuka,no,DF,FW,Lorient,Ligue 1,20,2002,2.2,5,3,3,1,1,3,7,42.9,4,1,0,1,2,7,1
1850,Junior Mwanga,fr,MF,FW,Strasbourg,Ligue 1,20,2003,16.1,40,20,23,12,5,12,24,50.0,12,20,5,15,18,58,19
1851,Phillipp Mwene,at,DF,,Mainz 05,Bundesliga,29,1994,22.2,34,15,15,16,3,16,33,48.5,17,27,3,24,17,51,47
1852,Vitaliy Mykolenko,ua,DF,,Everton,Premier League,24,1999,27.4,69,38,46,21,2,41,66,62.1,25,36,11,25,36,105,92
1853,Joakim Mæhle,dk,DF,MF,Wolfsburg,Bundesliga,26,1997,27.2,62,39,33,18,11,41,64,64.1,23,43,5,38,29,91,65
1854,Obite N'Dicka,ci,DF,,Roma,Serie A,23,1999,24.1,32,18,12,19,1,12,20,60.0,8,30,16,14,16,48,75
1855,Kévin N'Doram,fr,MF,,Metz,Ligue 1,27,1996,17.8,31,22,20,9,2,17,38,44.7,21,17,8,9,27,58,38
1856,Nathan N'Goumou,fr,FW,MF,Gladbach,Bundesliga,23,2000,15.4,37,22,17,18,2,16,34,47.1,18,22,0,22,5,42,17
1857,Stanley N'Soki,fr,DF,,Hoffenheim,Bundesliga,24,1999,7.0,21,10,12,8,1,17,29,58.6,12,13,2,11,8,29,33
1858,Nacho,es,DF,,Real Madrid,La Liga,33,1990,19.4,18,10,9,7,2,6,13,46.2,7,23,13,10,18,36,56
1859,Bilal Nadir,fr,MF,FW,Marseille,Ligue 1,19,2003,1.3,4,3,2,2,0,1,2,50.0,1,0,0,0,2,6,2
1860,Mahamadou Nagida,cm,DF,,Rennes,Ligue 1,18,2005,1.2,1,1,0,0,1,0,2,0.0,2,2,1,1,4,5,0
1861,Marvelous Nakamba,zw,MF,,Luton Town,Premier League,29,1994,12.6,40,24,24,14,2,24,42,57.1,18,23,6,17,11,51,11
1862,Keito Nakamura,jp,FW,MF,Reims,Ligue 1,23,2000,15.3,28,11,9,10,9,17,37,45.9,20,15,2,13,6,34,7
1863,Nahitan Nández,uy,MF,DF,Cagliari,Serie A,27,1995,26.0,59,40,27,23,9,27,64,42.2,37,25,2,23,19,78,32
1864,Matija Nastasić,rs,DF,,Mallorca,La Liga,30,1993,25.1,35,17,26,9,0,24,32,75.0,8,33,20,13,29,64,114
1865,Natan,br,DF,,Napoli,Serie A,22,2001,10.6,14,10,10,3,1,5,10,50.0,5,12,9,3,8,22,32
1866,Lapo Nava,it,GK,,Milan,Serie A,19,2004,0.0,0,0,0,0,0,0,0,,0,0,0,0,0,0,0
1867,Roberto Navarro,es,MF,FW,Cádiz,La Liga,21,2002,21.0,46,29,20,21,5,22,43,51.2,21,33,0,33,19,65,7
1868,Jesús Navas,es,DF,,Sevilla,La Liga,37,1985,22.3,37,27,21,14,2,22,40,55.0,18,15,7,8,22,59,48
1869,Keylor Navas,cr,GK,,Paris S-G,Ligue 1,36,1986,4.0,0,0,0,0,0,0,0,,0,0,0,0,0,0,2
1870,Michel Ndary Adopo,fr,MF,,Atalanta,Serie A,23,2000,1.2,4,3,0,3,1,1,1,100.0,0,0,0,0,0,4,2
1871,Youssouf Ndayishimiye,bi,MF,DF,Nice,Ligue 1,24,1998,19.0,31,20,17,12,2,12,23,52.2,11,19,11,8,12,43,47
1872,Bassirou Ndiaye,sn,FW,,Lorient,Ligue 1,21,2002,1.7,5,2,2,2,1,3,5,60.0,2,1,1,0,1,6,0
1873,Iliman Ndiaye,sn,FW,MF,Marseille,Ligue 1,23,2000,18.0,21,18,5,11,5,11,29,37.9,18,14,2,12,6,27,6
1874,Massamba Ndiaye,sn,GK,,Clermont Foot,Ligue 1,21,2001,4.0,0,0,0,0,0,0,0,,0,0,0,0,0,0,2
1875,Rassoul Ndiaye,sn,MF,FW,Le Havre,Ligue 1,21,2001,5.8,25,17,8,16,1,12,24,50.0,12,2,1,1,4,29,5
1876,Michael Ndiweni,eng,FW,,Newcastle Utd,Premier League,19,2003,0.0,0,0,0,0,0,0,0,,0,0,0,0,0,0,0
1877,Cher Ndour,it,MF,,Paris S-G,Ligue 1,19,2004,0.3,2,2,0,2,0,1,2,50.0,1,0,0,0,0,2,0
1878,Dan Ndoye,ch,FW,MF,Bologna,Serie A,22,2000,19.7,30,15,17,11,2,17,39,43.6,22,20,1,19,10,40,14
1879,Joseph Nduquidi,fr,MF,DF,Metz,Ligue 1,18,2004,8.3,11,4,6,3,2,1,9,11.1,8,11,3,8,11,22,15
1880,Loïc Nego,hu,DF,MF,Le Havre,Ligue 1,32,1991,17.3,37,26,21,12,4,18,30,60.0,12,12,2,10,16,53,17
1881,Álvaro Negredo,es,FW,MF,Cádiz,La Liga,37,1985,0.6,0,0,0,0,0,0,0,,0,1,0,1,1,1,0
1882,Reiss Nelson,eng,FW,,Arsenal,Premier League,23,1999,3.0,9,6,5,1,3,8,10,80.0,2,5,1,4,1,10,5
1883,Zack Nelson,eng,MF,DF,Luton Town,Premier League,18,2004,0.1,1,0,1,0,0,0,0,,0,0,0,0,0,1,0
1884,Neto,br,GK,,Bournemouth,Premier League,34,1989,32.0,0,0,0,0,0,0,0,,0,1,0,1,1,1,12
1885,Pedro Neto,pt,FW,MF,Wolves,Premier League,23,2000,16.8,7,3,3,2,2,5,15,33.3,10,5,1,4,5,12,2
1886,Luca Netz,de,DF,,Gladbach,Bundesliga,20,2003,24.7,38,22,19,16,3,23,43,53.5,20,36,10,26,22,60,76
1887,Manuel Neuer,de,GK,,Bayern Munich,Bundesliga,37,1986,22.8,1,1,1,0,0,0,0,,0,0,0,0,0,1,14
1888,Florian Neuhaus,de,MF,,Gladbach,Bundesliga,26,1997,13.6,15,12,7,8,0,8,26,30.8,18,8,6,2,14,29,8
1889,Carlos Neva,es,DF,,Granada,La Liga,27,1996,35.0,32,21,22,9,1,17,40,42.5,23,39,14,25,30,62,108
1890,Jessic Ngankam,de,FW,MF,Mainz 05,Bundesliga,23,2000,2.0,1,1,0,1,0,0,0,,0,3,1,2,3,4,0
1891,Jessic Ngankam,de,FW,,Eint Frankfurt,Bundesliga,23,2000,3.1,3,2,1,1,1,0,0,,0,0,0,0,0,3,1
1892,Cyril Ngonge,be,FW,MF,Hellas Verona,Serie A,23,2000,15.9,14,9,5,3,6,5,14,35.7,9,7,1,6,4,18,10
1893,Cyril Ngonge,be,FW,,Napoli,Serie A,23,2000,3.5,5,3,1,4,0,2,2,100.0,0,2,0,2,0,5,2
1894,Steve Ngoura,fr,FW,MF,Le Havre,Ligue 1,18,2005,2.5,2,1,1,1,0,1,4,25.0,3,0,0,0,0,2,3
1895,Moussa Niakhate,sn,DF,,Nott'ham Forest,Premier League,27,1996,16.2,42,25,33,9,0,20,25,80.0,5,19,12,7,14,56,51
1896,M'Baye Niang,sn,FW,,Empoli,Serie A,28,1994,7.9,3,1,0,1,2,0,6,0.0,6,7,1,6,3,6,10
1897,Tanguy Nianzou,fr,DF,,Sevilla,La Liga,21,2002,3.5,12,8,9,2,1,8,11,72.7,3,2,0,2,3,15,9
1898,Shamar Nicholson,jm,FW,,Clermont Foot,Ligue 1,26,1997,16.5,6,2,0,4,2,1,4,25.0,3,6,2,4,0,6,15
1899,Rasmus Nicolaisen,dk,DF,,Toulouse,Ligue 1,26,1997,32.5,50,30,39,11,0,26,44,59.1,18,44,33,11,42,92,158
1900,Moritz Nicolas,de,GK,,Gladbach,Bundesliga,25,1997,27.0,1,0,1,0,0,1,3,33.3,2,0,0,0,0,1,12
1901,Hans Nicolussi Caviglia,it,MF,,Juventus,Serie A,23,2000,3.0,5,2,1,3,1,4,6,66.7,2,5,1,4,0,5,2
1902,Saúl Ñíguez,es,MF,,Atlético Madrid,La Liga,28,1994,15.3,64,39,29,29,6,30,49,61.2,19,36,9,27,14,78,56
1903,Justin Njinmah,de,FW,,Werder Bremen,Bundesliga,22,2000,11.3,5,1,2,2,1,3,9,33.3,6,9,1,8,2,7,6
1904,Eddie Nketiah,eng,FW,,Arsenal,Premier League,24,1999,12.0,12,7,2,6,4,2,7,28.6,5,11,0,11,4,16,4
1905,Niels Nkounkou,fr,DF,MF,Eint Frankfurt,Bundesliga,22,2000,14.5,54,30,34,17,3,29,64,45.3,35,30,2,28,16,70,30
1906,Christopher Nkunku,fr,FW,MF,Chelsea,Premier League,25,1997,4.9,5,4,0,4,1,1,2,50.0,1,4,1,3,2,7,4
1907,Felix Nmecha,de,MF,,Dortmund,Bundesliga,22,2000,11.3,19,13,7,8,4,11,22,50.0,11,18,5,13,11,30,19
1908,Lukas Nmecha,de,FW,,Wolfsburg,Bundesliga,24,1998,0.5,1,1,0,0,1,0,0,,0,1,0,1,0,1,0
1909,Peru Nolaskoain,es,DF,MF,Athletic Club,La Liga,24,1998,0.1,1,1,1,0,0,1,1,100.0,0,0,0,0,0,1,1
1910,Joseph Nonge,be,MF,,Juventus,Serie A,18,2005,0.3,0,0,0,0,0,0,0,,0,0,0,0,0,0,1
1911,Jonathan Norbye,no,MF,,RB Leipzig,Bundesliga,16,2007,0.0,0,0,0,0,0,0,0,,0,0,0,0,0,0,0
1912,Arnaud Nordin,fr,FW,MF,Montpellier,Ligue 1,25,1998,13.8,12,6,3,5,4,6,16,37.5,10,11,0,11,2,14,10
1913,Rhys Norrington-Davies,wls,DF,,Sheffield Utd,Premier League,24,1999,1.2,1,1,1,0,0,0,1,0.0,1,2,0,2,1,2,2
1914,Oliver Norwood,nir,MF,,Sheffield Utd,Premier League,32,1991,16.0,41,26,18,18,5,20,47,42.6,27,24,9,15,21,62,39
1915,Tijjani Noslin,nl,FW,MF,Hellas Verona,Serie A,24,1999,14.9,18,8,5,7,6,6,16,37.5,10,17,2,15,2,20,14
1916,Randy Nteka,ao,FW,MF,Rayo Vallecano,La Liga,25,1997,6.4,11,4,1,6,4,4,10,40.0,6,6,1,5,2,13,11
1917,Ernest Nuamah,gh,FW,MF,Lyon,Ligue 1,19,2003,20.4,28,14,18,6,4,12,38,31.6,26,15,1,14,8,36,9
1918,Alexander Nübel,de,GK,,Stuttgart,Bundesliga,26,1996,30.0,2,2,2,0,0,2,4,50.0,2,0,0,0,0,2,13
1919,Kasim Nuhu,gh,DF,,Hoffenheim,Bundesliga,28,1995,0.1,0,0,0,0,0,0,0,,0,0,0,0,0,0,0
1920,Matheus Nunes,pt,MF,,Wolves,Premier League,24,1998,2.0,3,1,3,0,0,2,6,33.3,4,0,0,0,6,9,1
1921,Matheus Nunes,pt,MF,,Manchester City,Premier League,24,1998,7.3,10,4,1,7,2,5,16,31.3,11,7,1,6,1,11,8
1922,Darwin Núñez,uy,FW,,Liverpool,Premier League,24,1999,22.7,22,12,2,10,10,11,23,47.8,12,18,6,12,3,25,9
1923,Unai Núñez,es,DF,,Celta Vigo,La Liga,26,1997,31.1,51,28,30,19,2,23,49,46.9,26,38,24,14,52,103,153
1924,Fabian Nürnberger,bg,DF,MF,Darmstadt 98,Bundesliga,24,1999,16.8,29,22,22,6,1,22,41,53.7,19,11,1,10,17,46,26
1925,Ethan Nwaneri,eng,FW,,Arsenal,Premier League,16,2007,0.2,0,0,0,0,0,0,0,,0,1,0,1,0,0,0
1926,Simeon Nwankwo,ng,FW,,Salernitana,Serie A,31,1992,7.6,6,3,0,2,4,1,3,33.3,2,7,0,7,0,6,4
1927,Gerzino Nyamsi,fr,DF,,Strasbourg,Ligue 1,26,1997,12.1,18,14,13,5,0,12,18,66.7,6,19,11,8,10,28,43
1928,Ørjan Nyland,no,GK,,Sevilla,La Liga,32,1990,24.0,0,0,0,0,0,0,1,0.0,1,0,0,0,0,0,9
1929,Rabby Nzingoula,cg,MF,FW,Strasbourg,Ligue 1,17,2005,1.5,3,3,0,3,0,3,4,75.0,1,4,0,4,5,8,0
1930,M'Bala Nzola,ao,FW,,Fiorentina,Serie A,26,1996,17.2,11,8,1,4,6,6,7,85.7,1,10,1,9,0,11,22
1931,Christian Nørgaard,dk,MF,,Brentford,Premier League,29,1994,27.8,81,50,42,31,8,32,87,36.8,55,48,6,42,54,135,50
1932,Jake O'Brien,ie,DF,,Lyon,Ligue 1,22,2001,26.3,22,16,16,5,1,14,20,70.0,6,23,18,5,12,34,98
1933,Mark O'Mahony,ie,FW,,Brighton,Premier League,18,2005,0.7,1,0,1,0,0,1,2,50.0,1,2,1,1,0,1,1
1934,Dara O'Shea,ie,DF,,Burnley,Premier League,24,1999,32.1,39,20,22,14,3,11,26,42.3,15,41,30,11,35,74,158
1935,Michael Obafemi,ie,FW,MF,Burnley,Premier League,23,2000,0.2,0,0,0,0,0,0,0,,0,1,0,1,0,0,0
1936,Adam Obert,sk,DF,,Cagliari,Serie A,20,2002,10.5,17,9,8,8,1,8,17,47.1,9,13,7,6,21,38,41
1937,Pedro Obiang,gq,MF,,Sassuolo,Serie A,31,1992,5.0,8,4,3,4,1,2,10,20.0,8,6,4,2,8,16,10
1938,Jan Oblak,si,GK,,Atlético Madrid,La Liga,30,1993,38.0,0,0,0,0,0,0,0,,0,0,0,0,0,0,10
1939,Brian Ocampo,uy,MF,FW,Cádiz,La Liga,24,1999,2.8,4,3,1,3,0,2,5,40.0,3,4,0,4,3,7,0
1940,Lucas Ocampos,ar,FW,MF,Sevilla,La Liga,29,1994,31.9,66,47,22,27,17,29,58,50.0,29,34,1,33,21,87,29
1941,Guillermo Ochoa,mx,GK,,Salernitana,Serie A,38,1985,21.0,0,0,0,0,0,0,1,0.0,1,0,0,0,0,0,9
1942,Jens Odgaard,dk,FW,MF,Bologna,Serie A,24,1999,4.8,4,4,1,1,2,1,3,33.3,2,9,0,9,1,5,3
1943,Wilson Odobert,fr,MF,FW,Burnley,Premier League,18,2004,23.3,17,13,8,5,4,6,22,27.3,16,26,2,24,6,23,14
1944,Álvaro Odriozola,es,DF,,Real Sociedad,La Liga,27,1995,4.4,9,7,7,1,1,5,5,100.0,0,2,1,1,8,17,7
1945,Tim Oermann,de,DF,,Bochum,Bundesliga,19,2003,7.9,19,11,11,4,4,9,14,64.3,5,15,6,9,2,21,22
1946,Odeluga Offiah,eng,DF,,Brighton,Premier League,20,2002,1.4,1,0,1,0,0,1,1,100.0,0,0,0,0,1,2,0
1947,Chiedozie Ogbene,ie,MF,DF,Luton Town,Premier League,26,1997,22.2,17,10,10,7,0,12,22,54.5,10,14,3,11,7,24,34
1948,Angelo Ogbonna,it,DF,,West Ham,Premier League,35,1988,7.1,11,5,9,2,0,6,7,85.7,1,13,10,3,3,14,29
1949,Florent Ogier,fr,DF,,Clermont Foot,Ligue 1,34,1989,10.5,19,9,13,6,0,11,18,61.1,7,25,19,6,9,28,35
1950,Noah Okafor,ch,FW,MF,Milan,Serie A,23,2000,9.9,6,4,1,4,1,3,10,30.0,7,8,1,7,0,6,10
1951,David Okereke,ng,FW,MF,Torino,Serie A,25,1997,2.8,3,1,1,1,1,0,3,0.0,3,2,0,2,1,4,0
1952,Caleb Okoli,it,DF,,Frosinone,Serie A,22,2001,32.4,56,34,33,22,1,29,44,65.9,15,48,32,16,29,85,156
1953,Maduka Okoye,ng,GK,,Udinese,Serie A,23,1999,21.0,0,0,0,0,0,0,0,,0,0,0,0,1,1,4
1954,Masaya Okugawa,jp,FW,DF,Augsburg,Bundesliga,27,1996,0.4,0,0,0,0,0,0,0,,0,0,0,0,0,0,2
1955,Joseph Okumu,ke,DF,,Reims,Ligue 1,26,1997,19.4,44,28,28,14,2,24,38,63.2,14,27,19,8,35,79,112
1956,Aingeru Olabarrieta,es,FW,,Athletic Club,La Liga,17,2005,0.1,0,0,0,0,0,0,0,,0,0,0,0,0,0,0
1957,Michael Olakigbe,eng,DF,FW,Brentford,Premier League,19,2004,0.7,3,0,2,1,0,2,4,50.0,2,7,0,7,1,4,0
1958,Olasagasti,es,MF,,Real Sociedad,La Liga,22,2000,4.0,16,13,4,7,5,5,8,62.5,3,2,0,2,3,19,5
1959,Finn Ole Becker,de,MF,,Hoffenheim,Bundesliga,23,2000,6.7,10,9,8,2,0,4,17,23.5,13,9,1,8,1,11,10
1960,Mathias Olesen,lu,MF,FW,Köln,Bundesliga,22,2001,1.2,0,0,0,0,0,0,0,,0,0,0,0,2,2,2
1961,Michael Olise,fr,FW,MF,Crystal Palace,Premier League,21,2001,14.2,19,10,7,10,2,8,24,33.3,16,21,0,21,11,30,9
1962,Mathías Olivera,uy,DF,,Napoli,Serie A,25,1997,17.4,50,29,29,15,6,23,39,59.0,16,35,6,29,20,70,25
1963,Dani Olmo,es,MF,,RB Leipzig,Bundesliga,25,1998,16.1,26,18,14,8,4,10,22,45.5,12,7,0,7,13,39,12
1964,Robin Olsen,se,GK,,Aston Villa,Premier League,33,1990,4.5,0,0,0,0,0,0,0,,0,0,0,0,0,0,1
1965,Warmed Omari,km,DF,,Rennes,Ligue 1,23,2000,23.0,32,19,23,7,2,16,28,57.1,12,30,20,10,33,65,77
1966,Becir Omeragic,ch,DF,MF,Montpellier,Ligue 1,21,2002,25.7,48,29,31,13,4,20,33,60.6,13,51,29,22,27,75,65
1967,Jonas Omlin,ch,GK,,Gladbach,Bundesliga,29,1994,7.0,1,0,1,0,0,1,1,100.0,0,0,0,0,0,1,3
1968,Andrew Omobamidele,ie,DF,,Nott'ham Forest,Premier League,21,2002,8.7,10,3,9,1,0,5,8,62.5,3,12,8,4,13,23,42
1969,Samu Omorodion,es,FW,,Alavés,La Liga,19,2004,21.3,6,3,1,4,1,0,4,0.0,4,11,2,9,1,7,14
1970,Samu Omorodion,es,FW,,Granada,La Liga,19,2004,0.9,1,1,0,1,0,1,1,100.0,0,0,0,0,0,1,0
1971,Amadou Onana,be,MF,,Everton,Premier League,21,2001,23.2,71,38,32,31,8,21,42,50.0,21,25,6,19,21,92,31
1972,André Onana,cm,GK,,Manchester Utd,Premier League,27,1996,38.0,2,0,2,0,0,2,2,100.0,0,0,0,0,0,2,11
1973,Jean Onana,cm,MF,,Marseille,Ligue 1,23,2000,6.3,23,14,6,14,3,13,25,52.0,12,10,2,8,11,34,11
1974,Ryan One,sct,FW,,Sheffield Utd,Premier League,17,2006,0.1,0,0,0,0,0,0,0,,0,0,0,0,0,0,0
1975,Karim Onisiwo,at,FW,MF,Mainz 05,Bundesliga,31,1992,16.6,17,8,4,6,7,6,11,54.5,5,18,4,14,2,19,7
1976,Tyler Onyango,eng,MF,,Everton,Premier League,20,2003,0.0,0,0,0,0,0,0,0,,0,0,0,0,0,0,0
1977,Fred Onyedinma,eng,DF,MF,Luton Town,Premier League,26,1996,4.5,10,6,7,3,0,5,12,41.7,7,3,0,3,1,11,13
1978,Frank Onyeka,ng,MF,,Brentford,Premier League,25,1998,12.9,37,24,9,23,5,16,29,55.2,13,15,7,8,23,60,17
1979,Loïs Openda,be,FW,,RB Leipzig,Bundesliga,23,2000,30.0,3,3,0,1,2,0,6,0.0,6,19,3,16,5,8,14
1980,Royce Openda Owaga,ga,FW,,Lorient,Ligue 1,21,2002,0.2,0,0,0,0,0,0,0,,0,0,0,0,0,0,0
1981,Christopher Operi,ci,DF,,Le Havre,Ligue 1,26,1997,27.2,55,36,37,15,3,32,59,54.2,27,45,7,38,35,90,68
1982,Leon Opitz,de,FW,DF,Werder Bremen,Bundesliga,18,2005,0.2,2,2,1,1,0,2,3,66.7,1,0,0,0,0,2,0
1983,Gift Orban,ng,FW,,Lyon,Ligue 1,21,2002,5.3,4,3,0,1,3,1,4,25.0,3,2,0,2,1,5,2
1984,Willi Orban,hu,DF,,RB Leipzig,Bundesliga,30,1992,17.6,20,12,8,10,2,9,18,50.0,9,22,13,9,16,36,76
1985,Ivan Ordets,ua,DF,,Bochum,Bundesliga,31,1992,20.9,19,14,11,6,2,10,17,58.8,7,41,29,12,31,50,130
1986,Divock Origi,be,FW,,Nott'ham Forest,Premier League,28,1995,6.7,6,4,5,0,1,0,0,,0,6,0,6,2,8,4
1987,Gaetano Oristanio,it,FW,MF,Cagliari,Serie A,20,2002,12.3,20,10,5,14,1,5,17,29.4,12,11,0,11,9,29,8
1988,Aimar Oroz,es,MF,,Osasuna,La Liga,21,2001,26.0,43,26,18,20,5,13,37,35.1,24,27,2,25,16,59,11
1989,Riccardo Orsolini,it,FW,MF,Bologna,Serie A,26,1997,19.9,23,14,13,4,6,9,30,30.0,21,25,3,22,8,31,19
1990,Stefan Ortega,de,GK,,Manchester City,Premier League,30,1992,7.1,0,0,0,0,0,0,0,,0,0,0,0,0,0,2
1991,Eneko Ortiz,es,DF,,Alavés,La Liga,20,2003,0.2,0,0,0,0,0,0,0,,0,0,0,0,0,0,0
1992,Asier Osambela,es,MF,,Osasuna,La Liga,19,2004,0.1,2,1,0,1,1,0,0,,0,0,0,0,0,2,0
1993,Ben Osborn,eng,DF,MF,Sheffield Utd,Premier League,28,1994,15.2,22,9,11,9,2,8,17,47.1,9,18,2,16,8,30,30
1994,Gabriel Osho,ng,DF,,Luton Town,Premier League,24,1998,20.5,41,22,21,19,1,16,27,59.3,11,37,20,17,31,72,92
1995,Victor Osimhen,ng,FW,,Napoli,Serie A,24,1998,22.0,9,5,0,4,5,2,4,50.0,2,5,1,4,2,11,18
1996,Milutin Osmajić,me,MF,,Cádiz,La Liga,24,1999,0.1,0,0,0,0,0,0,0,,0,0,0,0,0,0,0
1997,Patrick Osterhage,de,MF,,Bochum,Bundesliga,23,2000,20.7,38,26,14,23,1,17,36,47.2,19,36,9,27,27,65,32
1998,William Osula,dk,FW,,Sheffield Utd,Premier League,19,2003,8.7,2,2,1,0,1,1,2,50.0,1,3,1,2,2,4,9
1999,Dango Ouattara,bf,FW,DF,Bournemouth,Premier League,21,2002,13.7,45,27,22,11,12,19,34,55.9,15,18,3,15,22,67,35
2000,Kassoum Ouattara,fr,DF,FW,Monaco,Ligue 1,18,2004,7.1,17,12,8,5,4,9,20,45.0,11,11,0,11,13,30,20
2001,Remi Oudin,fr,MF,FW,Lecce,Serie A,26,1996,20.2,26,14,12,12,2,12,19,63.2,7,13,1,12,20,46,22
2002,Alexandre Oukidja,dz,GK,,Metz,Ligue 1,35,1988,33.2,2,1,2,0,0,1,2,50.0,1,1,0,1,3,5,24
2003,Azzedine Ounahi,ma,MF,,Marseille,Ligue 1,23,2000,13.4,25,11,9,14,2,11,32,34.4,21,6,1,5,11,36,8
2004,Adam Ounas,dz,FW,,Lille,Ligue 1,26,1996,4.6,4,3,2,2,0,2,7,28.6,5,2,0,2,6,10,1
2005,Patrick Ouotro,ci,FW,,Strasbourg,Ligue 1,17,2005,0.1,0,0,0,0,0,0,0,,0,0,0,0,0,0,0
2006,Aiham Ousou,sy,DF,,Cádiz,La Liga,23,2000,4.8,8,5,6,2,0,5,5,100.0,0,1,0,1,7,15,15
2007,Jesús Owono,gq,GK,,Alavés,La Liga,22,2001,4.0,0,0,0,0,0,0,0,,0,0,0,0,0,0,3
2008,Mikel Oyarzabal,es,FW,MF,Real Sociedad,La Liga,26,1997,24.0,23,18,7,11,5,7,21,33.3,14,25,4,21,4,27,12
2009,Anthony Oyono,ga,DF,,Frosinone,Serie A,22,2001,13.3,37,26,21,14,2,23,34,67.6,11,17,3,14,9,46,32
2010,Salih Özcan,tr,MF,,Dortmund,Bundesliga,25,1998,13.2,20,12,11,8,1,10,18,55.6,8,28,3,25,17,37,18
2011,Cenk Özkacar,tr,DF,,Valencia,La Liga,22,2000,17.8,26,15,22,4,0,15,23,65.2,8,18,7,11,18,44,84
2012,David Ozoh,eng,MF,DF,Crystal Palace,Premier League,18,2005,1.7,10,6,3,6,1,5,6,83.3,1,2,0,2,0,10,2
2013,Jon Pacheco,es,DF,,Real Sociedad,La Liga,22,2001,17.0,25,15,21,4,0,14,22,63.6,8,17,6,11,10,35,53
2014,Willian Pacho,ec,DF,,Eint Frankfurt,Bundesliga,21,2001,33.0,62,37,38,23,1,31,53,58.5,22,51,22,29,47,109,152
2015,Gonçalo Paciência,pt,FW,MF,Bochum,Bundesliga,28,1994,7.2,8,4,2,2,4,3,6,50.0,3,5,0,5,0,8,7
2016,Simone Pafundi,it,MF,,Udinese,Serie A,17,2006,0.1,0,0,0,0,0,0,0,,0,0,0,0,0,0,0
2017,Riccardo Pagano,it,MF,DF,Roma,Serie A,18,2004,0.6,2,2,1,1,0,0,6,0.0,6,3,2,1,0,2,2
2018,Pablo Pagis,fr,MF,,Lorient,Ligue 1,20,2002,1.8,10,6,5,4,1,6,10,60.0,4,2,0,2,3,13,1
2019,Exequiel Palacios,ar,MF,,Leverkusen,Bundesliga,24,1998,20.3,60,34,28,26,6,26,53,49.1,27,24,0,24,29,89,20
2020,Isaac Palazón Camacho,es,MF,FW,Rayo Vallecano,La Liga,28,1994,31.0,46,25,16,21,9,20,58,34.5,38,29,2,27,16,62,41
2021,João Palhinha,pt,MF,,Fulham,Premier League,28,1995,30.0,152,75,80,60,12,103,152,67.8,49,57,9,48,46,198,58
2022,Nicolas Pallois,fr,DF,,Nantes,Ligue 1,35,1987,17.7,34,19,21,11,2,19,35,54.3,16,37,26,11,26,60,111
2023,Cole Palmer,eng,FW,MF,Chelsea,Premier League,21,2002,29.0,23,12,9,6,8,8,19,42.1,11,20,2,18,20,43,13
2024,Cole Palmer,eng,MF,,Manchester City,Premier League,21,2002,0.1,0,0,0,0,0,0,0,,0,0,0,0,0,0,0
2025,Emerson Palmieri,it,DF,,West Ham,Premier League,28,1994,34.9,106,68,48,42,16,57,90,63.3,33,47,15,32,43,149,96
2026,Joaquín Panichelli,ar,FW,MF,Alavés,La Liga,20,2002,2.5,3,3,1,1,1,1,2,50.0,1,1,0,1,1,4,4
2027,Miloš Pantović,rs,MF,,Union Berlin,Bundesliga,27,1996,0.2,0,0,0,0,0,0,0,,0,0,0,0,0,0,0
2028,Antonios Papadopoulos,de,DF,,Dortmund,Bundesliga,23,1999,1.3,6,3,6,0,0,6,7,85.7,1,3,2,1,2,8,7
2029,Christos Papadopoulos,gr,FW,,Genoa,Serie A,18,2004,0.0,0,0,0,0,0,0,1,0.0,1,0,0,0,0,0,0
2030,Sokratis Papastathopoulos,gr,DF,,Betis,La Liga,35,1988,12.6,21,14,16,5,0,13,17,76.5,4,15,9,6,6,27,60
2031,Merveille Papela,de,MF,DF,Mainz 05,Bundesliga,22,2001,2.9,5,4,2,3,0,0,4,0.0,4,1,0,1,4,9,2
2032,Leart Paqarada,xk,DF,,Köln,Bundesliga,28,1994,11.9,21,11,9,9,3,11,22,50.0,11,17,5,12,10,31,30
2033,Lucas Paquetá,br,FW,MF,West Ham,Premier League,25,1997,29.1,71,48,38,26,7,25,52,48.1,27,28,1,27,21,92,28
2034,Victor Parada,es,FW,MF,Alavés,La Liga,21,2002,0.0,1,1,0,1,0,1,1,100.0,0,0,0,0,0,1,0
2035,Aitor Paredes,es,DF,,Athletic Club,La Liga,23,2000,30.0,20,11,11,9,0,7,14,50.0,7,23,11,12,33,53,104
2036,Kevin Paredes,us,FW,MF,Wolfsburg,Bundesliga,20,2003,15.9,42,21,22,13,7,20,34,58.8,14,27,2,25,23,65,26
2037,Leandro Paredes,ar,MF,,Roma,Serie A,29,1994,29.3,57,36,30,22,5,33,77,42.9,44,26,7,19,29,86,43
2038,Daniel Parejo,es,MF,,Villarreal,La Liga,34,1989,28.7,43,30,16,21,6,20,46,43.5,26,25,9,16,21,64,29
2039,Fabiano Parisi,it,DF,,Fiorentina,Serie A,22,2000,16.2,30,15,11,12,7,15,26,57.7,11,21,5,16,17,47,26
2040,Ben Parkinson,eng,FW,,Newcastle Utd,Premier League,18,2005,0.3,0,0,0,0,0,0,0,,0,1,0,1,0,0,1
2041,Thomas Partey,gh,MF,DF,Arsenal,Premier League,30,1993,8.8,14,11,9,4,1,5,10,50.0,5,9,3,6,11,25,9
2042,Mario Pašalić,hr,MF,,Atalanta,Serie A,28,1995,22.8,28,17,9,18,1,14,31,45.2,17,29,6,23,16,44,34
2043,Triantafyllos Pasaridīs,gr,DF,,Salernitana,Serie A,27,1996,5.0,11,7,9,2,0,9,14,64.3,5,7,3,4,3,14,19
2044,Pascu,es,FW,,Villarreal,La Liga,20,2003,0.2,0,0,0,0,0,0,0,,0,0,0,0,0,0,0
2045,Felix Passlack,de,DF,,Bochum,Bundesliga,25,1998,10.7,21,14,9,10,2,14,24,58.3,10,13,2,11,10,31,21
2046,Patric,es,DF,,Lazio,Serie A,30,1993,17.9,13,8,10,3,0,8,18,44.4,10,15,9,6,6,19,44
2047,Rui Patrício,pt,GK,,Roma,Serie A,35,1988,23.0,0,0,0,0,0,0,1,0.0,1,1,0,1,0,0,3
2048,Nathan Patterson,sct,DF,,Everton,Premier League,21,2001,11.2,34,24,21,11,2,14,37,37.8,23,14,3,11,9,43,33
2049,Gabriel Paulista,br,DF,,Atlético Madrid,La Liga,32,1990,4.5,7,5,4,3,0,3,4,75.0,1,5,3,2,4,11,27
2050,Gabriel Paulista,br,DF,,Valencia,La Liga,32,1990,15.5,10,7,8,2,0,6,11,54.5,5,15,7,8,24,34,78
2051,Benjamin Pavard,fr,DF,,Inter,Serie A,27,1996,18.6,34,21,21,11,2,20,24,83.3,4,25,15,10,32,66,44
2052,Jiří Pavlenka,cz,GK,,Werder Bremen,Bundesliga,31,1992,7.0,0,0,0,0,0,0,0,,0,0,0,0,0,0,2
2053,Aleksandar Pavlovic,de,MF,,Bayern Munich,Bundesliga,19,2004,13.6,28,16,10,14,4,17,33,51.5,16,13,3,10,17,45,12
2054,Leonardo Pavoletti,it,FW,,Cagliari,Serie A,34,1988,7.0,1,1,0,0,1,0,1,0.0,1,2,1,1,0,1,7
2055,Martín Payero,ar,MF,,Udinese,Serie A,24,1998,20.0,54,32,28,19,7,19,46,41.3,27,25,7,18,15,69,21
2056,Nicolás Paz,ar,MF,FW,Real Madrid,La Liga,18,2004,0.3,0,0,0,0,0,0,0,,0,2,0,2,1,1,0
2057,Myles Peart-Harris,eng,DF,MF,Brentford,Premier League,20,2002,0.1,0,0,0,0,0,0,0,,0,0,0,0,0,0,1
2058,Sydie Peck,eng,MF,,Sheffield Utd,Premier League,18,2004,0.1,0,0,0,0,0,0,0,,0,0,0,0,0,0,0
2059,Mads Pedersen,dk,DF,,Augsburg,Bundesliga,26,1996,19.8,64,39,31,27,6,24,44,54.5,20,20,3,17,19,83,46
2060,Marcus Pedersen,no,DF,,Sassuolo,Serie A,23,2000,17.9,36,24,25,5,6,21,25,84.0,4,19,5,14,10,46,51
2061,Alfonso Pedraza,es,DF,,Villarreal,La Liga,27,1996,12.4,25,9,18,5,2,9,17,52.9,8,16,7,9,13,38,19
2062,Pedri,es,MF,FW,Barcelona,La Liga,20,2002,16.4,33,24,16,13,4,8,27,29.6,19,27,3,24,14,47,10
2063,Pedro,es,FW,MF,Lazio,Serie A,36,1987,9.1,16,12,5,7,4,3,12,25.0,9,16,2,14,3,19,1
2064,Adrià Pedrosa,es,DF,,Sevilla,La Liga,25,1998,19.5,46,26,28,14,4,23,34,67.6,11,26,6,20,15,61,54
2065,Jordan Pefok,us,FW,,Gladbach,Bundesliga,27,1996,15.8,10,4,0,8,2,3,8,37.5,5,12,3,9,5,15,28
2066,Jordan Pefok,us,FW,,Union Berlin,Bundesliga,27,1996,0.3,0,0,0,0,0,0,0,,0,1,1,0,0,0,0
2067,Dženan Pejčinović,de,FW,,Wolfsburg,Bundesliga,18,2005,0.4,0,0,0,0,0,0,0,,0,1,0,1,0,0,0
2068,Pejiño,es,FW,,Las Palmas,La Liga,27,1996,5.6,12,8,3,6,3,6,18,33.3,12,4,0,4,2,14,5
2069,Pietro Pellegri,it,FW,,Torino,Serie A,22,2001,8.4,5,1,1,4,0,1,5,20.0,4,4,1,3,2,7,3
2070,Lorenzo Pellegrini,it,MF,,Roma,Serie A,27,1996,20.7,35,20,14,16,5,17,51,33.3,34,28,5,23,20,55,22
2071,Luca Pellegrini,it,DF,,Lazio,Serie A,24,1999,8.7,18,13,7,10,1,9,17,52.9,8,7,3,4,9,27,20
2072,Marco Pellegrino,,DF,,Salernitana,Serie A,,,6.1,8,6,4,3,1,5,10,50.0,5,11,6,5,10,18,28
2073,Marco Pellegrino,,DF,,Milan,Serie A,,,0.8,1,1,0,0,1,0,2,0.0,2,1,1,0,1,2,2
2074,Facundo Pellistri,uy,FW,MF,Manchester Utd,Premier League,21,2001,1.9,5,3,4,1,0,1,3,33.3,2,7,1,6,1,6,5
2075,Facundo Pellistri,uy,MF,FW,Granada,La Liga,21,2001,13.7,29,19,12,10,7,6,21,28.6,15,18,0,18,4,33,7
2076,Andy Pelmard,fr,DF,,Clermont Foot,Ligue 1,23,2000,33.2,51,38,41,9,1,32,40,80.0,8,37,20,17,33,84,99
2077,Aurélien Pelon,fr,DF,,Lorient,Ligue 1,19,2004,1.0,1,0,1,0,0,0,2,0.0,2,2,2,0,0,1,7
2078,Faris Pemi Moumbagna,cm,FW,,Marseille,Ligue 1,23,2000,6.1,2,1,0,2,0,0,3,0.0,3,4,0,4,3,5,1
2079,Iñaki Peña,es,GK,,Barcelona,La Liga,24,1999,10.0,0,0,0,0,0,0,1,0.0,1,0,0,0,0,0,5
2080,Marcos Peña,es,MF,,Almería,La Liga,18,2005,4.9,19,14,12,7,0,6,12,50.0,6,9,3,6,13,32,8
2081,Rubén Peña,es,DF,FW,Osasuna,La Liga,32,1991,23.2,47,25,22,18,7,20,49,40.8,29,37,8,29,30,77,39
2082,Pepín,gq,MF,FW,Monza,Serie A,26,1996,2.7,6,1,1,4,1,2,4,50.0,2,5,2,3,0,6,6
2083,Alberto Perea,es,MF,FW,Granada,La Liga,32,1990,0.0,0,0,0,0,0,0,2,0.0,2,0,0,0,0,0,0
2084,Andreas Pereira,br,MF,,Fulham,Premier League,27,1996,29.0,25,12,4,12,9,11,41,26.8,30,16,2,14,4,29,12
2085,Danilo Pereira,pt,DF,,Paris S-G,Ligue 1,31,1991,22.2,22,12,14,6,2,9,17,52.9,8,29,26,3,23,45,100
2086,Mathias Pereira Lage,pt,FW,MF,Brest,Ligue 1,26,1996,13.2,21,15,7,8,6,7,28,25.0,21,14,5,9,10,31,13
2087,Pedro Pereira,pt,DF,,Monza,Serie A,25,1998,9.3,19,13,14,4,1,9,17,52.9,8,15,2,13,4,23,18
2088,Daniel Peretz,il,GK,,Bayern Munich,Bundesliga,23,2000,0.2,0,0,0,0,0,0,0,,0,0,0,0,0,0,0
2089,Roberto Pereyra,ar,FW,MF,Udinese,Serie A,32,1991,20.6,19,9,11,5,3,11,29,37.9,18,20,4,16,7,26,18
2090,Ayoze Pérez,es,FW,,Betis,La Liga,30,1993,25.5,59,32,16,33,10,21,49,42.9,28,42,4,38,22,81,18
2091,Carles Pérez,es,MF,DF,Celta Vigo,La Liga,25,1998,8.6,13,5,6,5,2,7,18,38.9,11,14,1,13,5,18,8
2092,Francisco Perez,es,MF,FW,Valencia,La Liga,20,2002,22.8,30,17,10,14,6,15,44,34.1,29,19,0,19,14,44,5
2093,Kike Pérez,es,MF,FW,Rayo Vallecano,La Liga,26,1997,9.3,27,11,11,15,1,11,23,47.8,12,11,0,11,8,35,6
2094,Nehuén Pérez,ar,DF,,Udinese,Serie A,23,2000,36.0,72,48,42,28,2,39,48,81.3,9,53,26,27,45,117,158
2095,Matteo Perez Vinlöf,se,FW,,Bayern Munich,Bundesliga,17,2005,0.2,0,0,0,0,0,0,0,,0,0,0,0,1,1,0
2096,Simone Perilli,it,GK,,Hellas Verona,Serie A,28,1995,1.0,0,0,0,0,0,0,0,,0,0,0,0,0,0,0
2097,Mattia Perin,it,GK,,Juventus,Serie A,30,1992,2.5,0,0,0,0,0,0,0,,0,0,0,0,0,0,1
2098,Samuele Perisan,it,GK,,Empoli,Serie A,25,1997,1.0,0,0,0,0,0,0,0,,0,0,0,0,0,0,0
2099,Ivan Perišić,hr,FW,,Tottenham,Premier League,34,1989,1.1,3,2,1,1,1,3,5,60.0,2,1,0,1,2,5,1
2100,Romain Perraud,fr,DF,FW,Nice,Ligue 1,25,1997,4.1,7,6,5,1,1,4,11,36.4,7,4,0,4,6,13,15
2101,Lucas Perrin,fr,DF,,Strasbourg,Ligue 1,24,1998,30.3,47,30,33,14,0,28,46,60.9,18,45,32,13,28,75,113
2102,Máximo Perrone,ar,MF,,Las Palmas,La Liga,20,2003,18.0,42,21,17,22,3,19,39,48.7,20,27,4,23,24,66,21
2103,Pavao Pervan,at,GK,,Wolfsburg,Bundesliga,35,1987,9.0,0,0,0,0,0,0,0,,0,0,0,0,0,0,4
2104,Matteo Pessina,it,MF,,Monza,Serie A,26,1997,35.8,44,25,20,20,4,23,49,46.9,26,29,11,18,27,71,46
2105,Andrea Petagna,it,FW,,Cagliari,Serie A,28,1995,11.1,4,2,1,0,3,1,2,50.0,1,6,3,3,1,5,4
2106,Denis Petrić,rs,GK,,Nantes,Ligue 1,35,1988,0.3,0,0,0,0,0,0,0,,0,0,0,0,0,0,0
2107,Njegoš Petrović,rs,MF,FW,Granada,La Liga,24,1999,1.7,5,2,4,1,0,2,3,66.7,1,2,0,2,1,6,3
2108,Đorđe Petrović,rs,GK,,Chelsea,Premier League,23,1999,22.1,0,0,0,0,0,0,0,,0,0,0,0,0,0,12
2109,Jens Petter Hauge,no,MF,FW,Eint Frankfurt,Bundesliga,23,1999,1.6,2,1,1,0,1,2,7,28.6,5,5,1,4,0,2,1
2110,Germán Pezzella,ar,DF,,Betis,La Liga,32,1991,30.7,34,24,24,10,0,23,38,60.5,15,31,18,13,31,65,150
2111,Giuseppe Pezzella,it,DF,,Empoli,Serie A,25,1997,12.1,25,14,19,5,1,20,28,71.4,8,17,6,11,2,27,35
2112,Luca Pfeiffer,de,FW,MF,Darmstadt 98,Bundesliga,26,1996,18.0,11,6,2,6,3,5,11,45.5,6,5,1,4,2,13,21
2113,Patric Pfeiffer,de,DF,,Augsburg,Bundesliga,23,1999,5.7,11,7,6,4,1,5,6,83.3,1,10,6,4,11,22,21
2114,Maximilian Philipp,de,FW,MF,Freiburg,Bundesliga,29,1994,3.6,8,5,4,4,0,1,6,16.7,5,7,0,7,1,9,3
2115,Kalvin Phillips,eng,MF,,West Ham,Premier League,27,1995,3.4,11,6,2,8,1,5,9,55.6,4,4,1,3,4,15,2
2116,Kalvin Phillips,eng,MF,,Manchester City,Premier League,27,1995,1.0,3,3,1,1,1,0,0,,0,0,0,0,2,5,2
2117,Jaden Philogene Bidace,eng,FW,,Aston Villa,Premier League,21,2002,0.0,0,0,0,0,0,0,0,,0,0,0,0,0,0,0
2118,Kamil Piątkowski,pl,DF,,Granada,La Liga,23,2000,5.6,18,10,16,1,1,10,14,71.4,4,6,5,1,8,26,28
2119,Roberto Piccoli,it,FW,,Empoli,Serie A,22,2001,0.4,1,1,0,0,1,1,1,100.0,0,0,0,0,0,1,0
2120,Roberto Piccoli,it,FW,,Lecce,Serie A,22,2001,15.3,10,6,3,5,2,1,4,25.0,3,17,1,16,4,14,16
2121,Florian Pick,de,MF,FW,Heidenheim,Bundesliga,27,1995,3.6,4,4,3,0,1,2,3,66.7,1,2,0,2,2,6,2
2122,Jordan Pickford,eng,GK,,Everton,Premier League,29,1994,38.0,1,0,1,0,0,1,1,100.0,0,3,0,3,0,1,19
2123,Amos Pieper,de,DF,,Werder Bremen,Bundesliga,25,1998,6.6,14,11,8,6,0,7,13,53.8,6,12,7,5,9,23,36
2124,Marvin Pieringer,de,MF,FW,Heidenheim,Bundesliga,23,1999,16.8,19,12,5,11,3,8,20,40.0,12,28,4,24,12,31,21
2125,Santiago Pierotti,ar,MF,FW,Lecce,Serie A,22,2001,2.2,8,8,2,5,1,2,8,25.0,6,5,0,5,1,9,0
2126,Niccolò Pierozzi,it,DF,,Salernitana,Serie A,21,2001,9.7,17,11,13,4,0,11,22,50.0,11,24,7,17,11,28,36
2127,Ronaël Pierre-Gabriel,fr,DF,,Nantes,Ligue 1,25,1998,6.6,15,9,12,2,1,5,7,71.4,2,13,4,9,8,23,25
2128,Andrea Pinamonti,it,FW,,Sassuolo,Serie A,24,1999,34.2,13,8,1,6,6,5,22,22.7,17,19,2,17,1,14,40
2129,Ethan Pinnock,jm,DF,,Brentford,Premier League,30,1993,28.0,35,23,22,13,0,9,20,45.0,11,40,24,16,43,78,170
2130,Yeremi Pino,es,MF,FW,Villarreal,La Liga,20,2002,5.3,25,18,12,10,3,9,18,50.0,9,11,1,10,5,30,5
2131,Carlo Pinsoglio,it,GK,,Juventus,Serie A,33,1990,0.5,0,0,0,0,0,0,0,,0,0,0,0,0,0,0
2132,Lorenzo Pirola,it,DF,,Salernitana,Serie A,21,2002,22.1,39,23,25,14,0,15,28,53.6,13,46,30,16,25,64,93
2133,Niccolò Pisilli,it,MF,,Roma,Serie A,18,2004,0.1,0,0,0,0,0,0,0,,0,0,0,0,0,0,0
2134,Alassane Pléa,fr,FW,MF,Gladbach,Bundesliga,30,1993,21.3,17,7,5,8,4,7,15,46.7,8,11,0,11,2,19,6
2135,Tommaso Pobega,it,MF,,Milan,Serie A,24,1999,3.5,16,9,11,5,0,6,13,46.2,7,10,2,8,6,22,7
2136,Paul Pogba,fr,MF,,Juventus,Serie A,30,1993,0.6,1,1,0,1,0,1,1,100.0,0,0,0,0,1,2,1
2137,Ole Pohlmann,de,MF,,Dortmund,Bundesliga,22,2001,0.6,1,0,0,1,0,1,2,50.0,1,0,0,0,0,1,1
2138,Matteo Politano,it,FW,,Napoli,Serie A,29,1993,26.2,19,8,8,7,4,11,34,32.4,23,9,1,8,15,34,11
2139,Sebastian Polter,de,FW,,Darmstadt 98,Bundesliga,32,1991,5.0,1,0,1,0,0,0,1,0.0,1,5,1,4,0,1,4
2140,Julien Ponceau,fr,MF,,Lorient,Ligue 1,22,2000,24.9,32,15,12,14,6,9,30,30.0,21,22,1,21,19,51,20
2141,Marin Pongračić,hr,DF,,Lecce,Serie A,25,1997,35.8,43,30,22,20,1,19,25,76.0,6,37,26,11,51,94,130
2142,Nick Pope,eng,GK,,Newcastle Utd,Premier League,31,1992,14.9,0,0,0,0,0,0,1,0.0,1,0,0,0,0,0,7
2143,Pedro Porro,es,DF,,Tottenham,Premier League,23,1999,34.3,91,63,43,34,14,62,120,51.7,58,63,18,45,34,125,102
2144,Portu,es,FW,,Getafe,La Liga,31,1992,1.1,5,3,4,0,1,5,6,83.3,1,0,0,0,0,5,0
2145,Portu,es,MF,FW,Girona,La Liga,31,1992,13.2,18,13,3,10,5,3,18,16.7,15,9,1,8,4,22,6
2146,Stefan Posch,at,DF,,Bologna,Serie A,26,1997,26.8,77,46,35,38,4,49,88,55.7,39,27,8,19,18,95,72
2147,Yussuf Poulsen,dk,FW,,RB Leipzig,Bundesliga,29,1994,13.5,13,8,1,9,3,4,14,28.6,10,13,3,10,4,17,15
2148,José Pozo,es,MF,,Rayo Vallecano,La Liga,27,1996,0.2,1,1,0,1,0,1,1,100.0,0,1,0,1,0,1,0
2149,Alejandro Pozo Pozo,es,DF,MF,Almería,La Liga,24,1999,10.8,19,12,11,6,2,12,20,60.0,8,14,4,10,7,26,21
2150,Beñat Prados,es,MF,DF,Athletic Club,La Liga,22,2001,16.1,45,28,11,23,11,23,42,54.8,19,32,5,27,23,68,27
2151,Matteo Prati,it,MF,,Cagliari,Serie A,19,2003,21.9,45,25,15,27,3,26,42,61.9,16,29,6,23,15,60,26
2152,Abdón Prats,es,FW,MF,Mallorca,La Liga,30,1992,14.1,6,4,2,2,2,3,5,60.0,2,6,3,3,2,8,12
2153,Sanjin Prcić,ba,MF,,Strasbourg,Ligue 1,29,1993,1.0,0,0,0,0,0,0,1,0.0,1,2,1,1,3,3,1
2154,Grischa Prömel,de,MF,,Hoffenheim,Bundesliga,28,1995,23.8,32,18,11,15,6,14,32,43.8,18,22,6,16,22,54,36
2155,Ivan Provedel,it,GK,,Lazio,Serie A,29,1994,30.0,1,0,1,0,0,1,3,33.3,2,0,0,0,0,1,12
2156,Marc Pubill,es,DF,,Almería,La Liga,20,2003,20.9,47,23,35,8,4,22,39,56.4,17,20,8,12,15,62,83
2157,Gustavo Puerta,co,DF,MF,Leverkusen,Bundesliga,20,2003,0.5,5,3,2,2,1,1,2,50.0,1,2,0,2,0,5,0
2158,Antonio Puertas,es,MF,FW,Granada,La Liga,31,1992,8.1,12,8,6,5,1,6,15,40.0,9,5,0,5,6,18,4
2159,Arnau Puigmal,es,FW,DF,Almería,La Liga,22,2001,2.8,2,1,1,1,0,1,3,33.3,2,3,0,3,3,5,2
2160,Christian Pulisic,us,FW,MF,Milan,Serie A,24,1998,28.9,35,26,14,11,10,17,30,56.7,13,20,1,19,10,45,10
2161,George Pușcaș,ro,FW,,Genoa,Serie A,27,1996,2.1,0,0,0,0,0,0,3,0.0,3,1,0,1,0,0,1
2162,Jarell Quansah,eng,DF,,Liverpool,Premier League,20,2003,13.2,25,22,17,7,1,14,20,70.0,6,16,8,8,17,42,39
2163,Domingos Quina,pt,MF,,Udinese,Serie A,23,1999,0.1,1,1,1,0,0,0,0,,0,0,0,0,0,1,0
2164,Adrien Rabiot,fr,MF,,Juventus,Serie A,28,1995,29.5,58,39,22,30,6,30,45,66.7,15,26,6,20,25,83,34
2165,Uroš Račić,rs,MF,,Sassuolo,Serie A,25,1998,9.1,10,4,6,4,0,0,9,0.0,9,16,7,9,7,17,22
2166,Nemanja Radonjić,rs,MF,FW,Torino,Serie A,27,1996,4.2,1,1,0,0,1,1,3,33.3,2,3,0,3,0,1,0
2167,Nemanja Radonjić,rs,MF,DF,Mallorca,La Liga,27,1996,3.9,4,2,1,3,0,1,4,25.0,3,2,0,2,3,7,3
2168,Aleksandar Radovanović,rs,DF,,Almería,La Liga,29,1993,6.3,8,7,7,1,0,6,6,100.0,0,8,8,0,11,19,48
2169,Ionuț Radu,ro,GK,,Bournemouth,Premier League,26,1997,2.0,0,0,0,0,0,0,0,,0,0,0,0,0,0,0
2170,Boris Radunović,rs,GK,,Cagliari,Serie A,27,1996,7.0,0,0,0,0,0,0,0,,0,0,0,0,1,1,1
2171,Hamza Rafia,tn,MF,,Lecce,Serie A,24,1999,13.4,44,31,13,27,4,13,30,43.3,17,27,1,26,11,55,13
2172,Abdellah Raihani,ma,FW,,Atlético Madrid,La Liga,19,2004,0.1,0,0,0,0,0,0,1,0.0,1,0,0,0,0,0,0
2173,Antonio Raillo,es,DF,,Mallorca,La Liga,31,1991,24.4,30,23,18,12,0,17,23,73.9,6,44,30,14,37,67,104
2174,Luca Raimund,de,FW,MF,Stuttgart,Bundesliga,18,2005,0.3,3,1,2,1,0,0,0,,0,2,0,2,0,3,0
2175,Predrag Rajković,rs,GK,,Mallorca,La Liga,27,1995,36.0,2,1,2,0,0,2,2,100.0,0,0,0,0,0,2,14
2176,Jesurun Rak Sakyi,eng,MF,FW,Crystal Palace,Premier League,20,2002,1.5,4,1,3,1,0,2,3,66.7,1,2,0,2,3,7,1
2177,Ivan Rakitić,hr,MF,,Sevilla,La Liga,35,1988,15.8,30,16,9,12,9,11,19,57.9,8,16,5,11,14,44,12
2178,Ylber Ramadani,al,MF,,Lecce,Serie A,27,1996,33.0,68,41,32,29,7,37,96,38.5,59,54,13,41,44,112,44
2179,Largie Ramazani,be,FW,MF,Almería,La Liga,22,2001,17.3,12,7,5,6,1,6,26,23.1,20,16,2,14,34,46,10
2180,Benito Ramírez,es,FW,MF,Las Palmas,La Liga,28,1995,4.3,5,3,2,3,0,3,6,50.0,3,7,1,6,3,8,0
2181,Sandro Ramírez,es,FW,,Las Palmas,La Liga,28,1995,20.1,12,8,4,6,2,6,15,40.0,9,13,1,12,4,16,14
2182,Chris Ramos,es,FW,MF,Cádiz,La Liga,26,1997,29.0,28,15,9,15,4,8,27,29.6,19,23,7,16,9,37,44
2183,Gonçalo Ramos,pt,FW,,Paris S-G,Ligue 1,22,2001,15.8,25,15,4,12,9,6,20,30.0,14,12,2,10,5,30,16
2184,Sergio Ramos,es,DF,,Sevilla,La Liga,37,1986,28.0,45,30,32,11,2,27,40,67.5,13,35,30,5,41,86,156
2185,Aaron Ramsdale,eng,GK,,Arsenal,Premier League,25,1998,6.0,0,0,0,0,0,0,0,,0,0,0,0,0,0,3
2186,Aaron Ramsey,eng,MF,FW,Burnley,Premier League,20,2003,5.9,17,14,7,5,5,8,16,50.0,8,11,2,9,1,18,10
2187,Jacob Ramsey,eng,FW,MF,Aston Villa,Premier League,22,2001,9.5,16,8,7,6,3,5,15,33.3,10,15,2,13,3,19,8
2188,Luca Ranieri,it,DF,,Fiorentina,Serie A,24,1999,22.9,14,10,11,1,2,8,13,61.5,5,25,11,14,29,43,64
2189,Filippo Ranocchia,it,MF,DF,Empoli,Serie A,22,2001,5.3,16,11,7,9,0,7,16,43.8,9,9,1,8,3,19,14
2190,Grant Ranos,am,MF,FW,Gladbach,Bundesliga,20,2003,0.5,1,0,0,0,1,0,0,,0,0,0,0,0,1,0
2191,Raphinha,br,FW,MF,Barcelona,La Liga,26,1996,15.2,14,8,6,6,2,4,18,22.2,14,17,1,16,13,27,11
2192,Nicolai Rapp,de,DF,,Werder Bremen,Bundesliga,26,1996,0.8,3,2,2,1,0,2,2,100.0,0,2,0,2,2,5,8
2193,Elba Rashani,xk,MF,FW,Clermont Foot,Ligue 1,30,1993,13.1,30,18,4,17,9,11,24,45.8,13,17,3,14,12,42,15
2194,Marcus Rashford,eng,FW,,Manchester Utd,Premier League,25,1997,25.2,19,12,9,4,6,9,26,34.6,17,15,1,14,4,23,21
2195,Giacomo Raspadori,it,FW,MF,Napoli,Serie A,23,2000,17.6,21,10,6,10,5,6,15,40.0,9,15,1,14,3,24,7
2196,Andrei Ratiu,ro,DF,MF,Rayo Vallecano,La Liga,25,1998,7.0,12,4,6,5,1,8,15,53.3,7,4,1,3,0,12,12
2197,Raúl,es,FW,,Osasuna,La Liga,22,2000,15.1,10,4,4,2,4,2,10,20.0,8,9,1,8,5,15,11
2198,David Raum,de,DF,,RB Leipzig,Bundesliga,25,1998,30.4,58,35,24,29,5,34,58,58.6,24,51,9,42,27,85,82
2199,Federico Ravaglia,it,GK,,Bologna,Serie A,23,1999,5.9,0,0,0,0,0,0,0,,0,0,0,0,0,0,2
2200,David Raya,es,GK,,Arsenal,Premier League,27,1995,32.0,1,1,1,0,0,1,1,100.0,0,0,0,0,0,1,8
2201,Tim Ream,us,DF,,Fulham,Premier League,35,1987,16.7,20,9,13,5,2,9,18,50.0,9,23,15,8,25,45,61
2202,Abderrahman Rebbach,dz,FW,MF,Alavés,La Liga,24,1998,8.0,9,5,4,2,3,5,15,33.3,10,10,1,9,3,12,7
2203,Nathan Redmond,eng,FW,MF,Burnley,Premier League,29,1994,1.6,2,1,0,0,2,1,4,25.0,3,1,0,1,0,2,3
2204,Harrison Reed,eng,MF,,Fulham,Premier League,28,1995,14.7,29,18,9,17,3,13,31,41.9,18,19,9,10,11,40,24
2205,Sergio Reguilón,es,DF,,Manchester Utd,Premier League,26,1996,4.6,13,8,6,2,5,8,17,47.1,9,10,0,10,5,18,7
2206,Sergio Reguilón,es,DF,,Brentford,Premier League,26,1996,12.4,45,20,26,18,1,24,40,60.0,16,23,6,17,16,61,41
2207,Bobby Reid,jm,FW,,Fulham,Premier League,30,1993,15.8,22,14,5,15,2,4,16,25.0,12,24,2,22,5,27,14
2208,Tijjani Reijnders,nl,MF,,Milan,Serie A,25,1998,31.3,46,25,10,31,5,21,43,48.8,22,26,8,18,18,64,26
2209,Pepe Reina,es,GK,,Villarreal,La Liga,40,1982,2.0,0,0,0,0,0,0,0,,0,0,0,0,0,0,1
2210,Reinier,br,MF,FW,Frosinone,Serie A,21,2002,11.8,21,10,6,12,3,5,17,29.4,12,24,4,20,10,31,5
2211,Rocco Reitz,de,MF,,Gladbach,Bundesliga,21,2002,23.7,61,36,28,29,4,28,55,50.9,27,61,20,41,44,105,31
2212,Álex Remiro,es,GK,,Real Sociedad,La Liga,28,1995,36.4,0,0,0,0,0,0,0,,0,0,0,0,0,0,24
2213,Guillaume Restes,fr,GK,,Toulouse,Ligue 1,18,2005,34.0,0,0,0,0,0,0,3,0.0,3,0,0,0,0,0,19
2214,Mateo Retegui,it,FW,,Genoa,Serie A,24,1999,24.6,17,9,7,8,2,6,20,30.0,14,18,2,16,0,17,30
2215,Marco Reus,de,MF,FW,Dortmund,Bundesliga,34,1989,17.8,37,25,20,14,3,12,27,44.4,15,17,2,15,5,42,18
2216,Elvis Rexhbeçaj,xk,MF,,Augsburg,Bundesliga,25,1997,22.1,30,19,14,13,3,18,36,50.0,18,32,7,25,20,50,20
2217,Gio Reyna,us,FW,MF,Nott'ham Forest,Premier League,20,2002,2.6,7,3,4,0,3,3,6,50.0,3,3,0,3,2,9,0
2218,Gio Reyna,us,MF,FW,Dortmund,Bundesliga,20,2002,3.1,9,6,3,4,2,2,5,40.0,3,5,1,4,2,11,5
2219,Chadi Riad,ma,DF,,Betis,La Liga,20,2003,24.0,35,24,17,18,0,17,27,63.0,10,23,14,9,23,58,108
2220,Alexsandro Ribeiro,br,DF,,Lille,Ligue 1,23,1999,24.7,32,22,24,8,0,16,31,51.6,15,25,15,10,35,67,116
2221,Rodrigo Ribeiro,pt,MF,FW,Nott'ham Forest,Premier League,18,2005,0.2,0,0,0,0,0,0,1,0.0,1,1,0,1,1,1,0
2222,Samuele Ricci,it,MF,,Torino,Serie A,21,2001,26.6,33,18,17,12,4,15,23,65.2,8,21,3,18,27,60,25
2223,Declan Rice,eng,MF,,Arsenal,Premier League,24,1999,35.8,83,51,37,38,8,32,57,56.1,25,37,11,26,44,127,52
2224,Chris Richards,us,DF,MF,Crystal Palace,Premier League,23,2000,23.3,46,28,21,22,3,20,30,66.7,10,32,12,20,27,73,109
2225,Amir Richardson,ma,MF,,Reims,Ligue 1,21,2002,15.0,33,23,12,18,3,10,22,45.5,12,26,5,21,15,48,30
2226,Richarlison,br,FW,,Tottenham,Premier League,26,1997,16.6,16,11,4,8,4,2,10,20.0,8,32,6,26,8,24,23
2227,Marco Richter,de,MF,FW,Mainz 05,Bundesliga,25,1997,8.0,10,4,5,3,2,4,11,36.4,7,9,0,9,2,12,1
2228,Diego Rico,es,DF,,Getafe,La Liga,30,1993,28.2,64,48,32,23,9,41,76,53.9,35,25,8,17,41,105,76
2229,Clemens Riedel,de,DF,,Darmstadt 98,Bundesliga,20,2003,8.4,22,13,16,5,1,15,24,62.5,9,11,3,8,11,33,26
2230,Fabian Rieder,ch,MF,,Rennes,Ligue 1,21,2002,4.1,13,7,2,9,2,6,11,54.5,5,3,1,2,5,18,2
2231,Jaïro Riedewald,nl,MF,FW,Crystal Palace,Premier League,26,1996,2.6,9,3,2,4,3,3,6,50.0,3,0,0,0,2,11,2
2232,Manuel Riemann,de,GK,,Bochum,Bundesliga,34,1988,33.0,2,1,2,0,0,2,4,50.0,2,0,0,0,1,3,25
2233,Luis Rioja,es,FW,MF,Alavés,La Liga,29,1993,27.8,27,19,10,12,5,14,43,32.6,29,28,1,27,16,43,28
2234,Rémy Riou,fr,GK,,Lyon,Ligue 1,35,1987,3.0,0,0,0,0,0,0,1,0.0,1,0,0,0,0,0,1
2235,Rodrigo Riquelme,es,DF,MF,Atlético Madrid,La Liga,23,2000,17.0,30,19,18,4,8,18,46,39.1,28,19,0,19,9,39,20
2236,Alberto Risco,es,MF,,Getafe,La Liga,17,2005,1.5,2,2,1,1,0,0,4,0.0,4,0,0,0,0,2,1
2237,Mihailo Ristić,rs,DF,MF,Celta Vigo,La Liga,27,1995,9.0,15,9,9,6,0,9,12,75.0,3,9,2,7,10,25,23
2238,Matt Ritchie,sct,FW,MF,Newcastle Utd,Premier League,33,1989,1.4,5,3,2,2,1,2,4,50.0,2,3,2,1,1,6,5
2239,Gorka Rivera Alonso,es,DF,,Getafe,La Liga,18,2004,0.0,0,0,0,0,0,0,0,,0,0,0,0,0,0,0
2240,Sergi Roberto,es,MF,DF,Barcelona,La Liga,31,1992,9.6,15,10,4,10,1,3,11,27.3,8,7,2,5,8,23,7
2241,Lucas Robertone,ar,MF,,Almería,La Liga,26,1997,26.5,61,33,28,23,10,25,50,50.0,25,43,9,34,51,112,43
2242,Connor Roberts,wls,DF,,Burnley,Premier League,27,1995,9.1,12,5,6,4,2,8,17,47.1,9,8,6,2,4,16,25
2243,Andrew Robertson,sct,DF,,Liverpool,Premier League,29,1994,18.8,35,24,21,11,3,26,43,60.5,17,20,6,14,13,48,40
2244,Antonee Robinson,us,DF,,Fulham,Premier League,25,1997,36.3,93,58,60,26,7,52,110,47.3,58,56,8,48,80,173,117
2245,Jack Robinson,eng,DF,,Sheffield Utd,Premier League,29,1993,32.1,43,28,29,14,0,25,39,64.1,14,49,33,16,33,76,132
2246,Marc Roca,es,MF,,Betis,La Liga,26,1996,22.0,52,36,17,29,6,30,53,56.6,23,29,6,23,17,69,23
2247,Sebastian Rode,de,MF,,Eint Frankfurt,Bundesliga,32,1990,0.7,6,4,0,5,1,4,6,66.7,2,0,0,0,1,7,1
2248,Sergio Rodelas,es,FW,DF,Granada,La Liga,18,2004,1.4,3,2,1,0,2,0,3,0.0,3,0,0,0,0,3,0
2249,Rodri,es,MF,,Manchester City,Premier League,27,1996,32.6,70,43,25,33,12,29,60,48.3,31,32,8,24,26,96,41
2250,Rodri,es,FW,MF,Betis,La Liga,23,2000,11.7,17,10,6,7,4,8,21,38.1,13,11,0,11,8,25,2
2251,Álvaro Rodríguez,uy,FW,,Real Madrid,La Liga,19,2004,0.0,0,0,0,0,0,0,0,,0,0,0,0,0,0,1
2252,Óscar Rodríguez Arnaiz,es,MF,FW,Getafe,La Liga,25,1998,10.7,24,13,2,15,7,9,15,60.0,6,12,1,11,5,29,5
2253,Damián Rodríguez,es,MF,,Celta Vigo,La Liga,20,2003,2.9,6,3,1,3,2,1,3,33.3,2,4,2,2,1,7,2
2254,Dani Rodríguez,es,MF,,Mallorca,La Liga,35,1988,29.1,47,24,21,20,6,21,45,46.7,24,34,5,29,15,62,21
2255,Guido Rodríguez,ar,MF,,Betis,La Liga,29,1994,20.5,53,30,21,24,8,34,55,61.8,21,27,6,21,29,82,44
2256,Jay Rodriguez,eng,FW,,Burnley,Premier League,34,1989,9.1,14,9,7,4,3,7,13,53.8,6,11,1,10,1,15,8
2257,Kirian Rodríguez,es,MF,,Las Palmas,La Liga,27,1996,35.7,52,32,22,25,5,24,67,35.8,43,39,3,36,28,80,23
2258,Miguel Rodríguez,es,MF,,Celta Vigo,La Liga,20,2003,3.3,6,3,3,1,2,3,9,33.3,6,8,0,8,4,10,0
2259,Ricardo Rodríguez,ch,DF,,Torino,Serie A,30,1992,30.8,45,26,21,22,2,28,45,62.2,17,22,9,13,24,69,64
2260,Rodrygo,br,FW,,Real Madrid,La Liga,22,2001,26.4,16,15,2,9,5,5,19,26.3,14,14,0,14,8,24,6
2261,Mads Roerslev,dk,DF,,Brentford,Premier League,24,1999,22.1,48,31,34,9,5,27,54,50.0,27,15,3,12,19,67,71
2262,Rogério,br,DF,,Wolfsburg,Bundesliga,25,1998,10.1,14,6,7,5,2,10,14,71.4,4,16,5,11,5,19,23
2263,Morgan Rogers,eng,MF,FW,Aston Villa,Premier League,21,2002,7.1,8,1,3,2,3,2,11,18.2,9,11,0,11,3,11,11
2264,Merlin Röhl,de,MF,FW,Freiburg,Bundesliga,21,2002,16.4,21,13,10,9,2,8,21,38.1,13,27,3,24,9,30,22
2265,Alessio Romagnoli,it,DF,,Lazio,Serie A,28,1995,26.8,25,18,14,11,0,16,24,66.7,8,29,17,12,29,54,115
2266,Simone Romagnoli,it,DF,,Frosinone,Serie A,33,1990,30.2,35,15,23,11,1,15,20,75.0,5,51,36,15,29,64,147
2267,Carlos Romero,es,DF,,Villarreal,La Liga,21,2001,2.9,11,5,8,1,2,7,12,58.3,5,3,0,3,1,12,11
2268,Cristian Romero,ar,DF,,Tottenham,Premier League,25,1998,31.0,66,40,35,25,6,32,44,72.7,12,46,22,24,44,110,106
2269,Isaac Romero,es,FW,,Sevilla,La Liga,23,2000,11.5,6,3,2,2,2,5,9,55.6,4,12,0,12,0,6,11
2270,Luka Romero,ar,FW,MF,Milan,Serie A,18,2004,1.0,0,0,0,0,0,0,3,0.0,3,2,0,2,0,0,0
2271,Luka Romero,ar,FW,,Almería,La Liga,18,2004,4.9,5,1,2,3,0,2,4,50.0,2,12,1,11,1,6,2
2272,Oriol Romeu,es,MF,,Barcelona,La Liga,31,1991,10.4,34,20,17,14,3,13,24,54.2,11,12,2,10,10,44,18
2273,Valentin Rongier,fr,MF,,Marseille,Ligue 1,28,1994,9.5,23,12,9,12,2,14,26,53.8,12,16,4,12,15,38,18
2274,Frank Ronstadt,de,DF,MF,Darmstadt 98,Bundesliga,26,1997,0.8,1,0,0,1,0,0,1,0.0,1,1,0,1,1,2,3
2275,Marten de Roon,nl,MF,DF,Atalanta,Serie A,32,1991,28.9,80,43,36,32,12,35,82,42.7,47,36,10,26,40,120,54
2276,Unai Ropero,es,MF,,Alavés,La Liga,21,2001,0.1,0,0,0,0,0,0,0,,0,0,0,0,0,0,0
2277,Vitor Roque,br,FW,,Barcelona,La Liga,18,2005,3.6,3,2,2,0,1,0,2,0.0,2,3,0,3,0,3,5
2278,Pablo Rosario,nl,MF,DF,Nice,Ligue 1,26,1997,22.3,36,25,15,16,5,23,34,67.6,11,27,13,14,29,65,39
2279,Valentin Rosier,fr,DF,MF,Nice,Ligue 1,26,1996,0.6,1,0,1,0,0,0,0,,0,1,0,1,2,3,5
2280,Francesco Rossi,it,GK,,Atalanta,Serie A,32,1991,0.1,0,0,0,0,0,0,0,,0,0,0,0,0,0,0
2281,Joe Rothwell,eng,MF,,Bournemouth,Premier League,28,1995,4.3,7,2,4,2,1,2,8,25.0,6,4,2,2,3,10,2
2282,Anthony Rouault,fr,DF,,Stuttgart,Bundesliga,22,2001,11.2,21,12,14,5,2,13,21,61.9,8,14,8,6,8,29,28
2283,Jérôme Roussillon,fr,DF,,Union Berlin,Bundesliga,30,1993,8.4,16,9,6,7,3,8,12,66.7,4,13,4,9,5,21,26
2284,Nicolò Rovella,it,MF,,Lazio,Serie A,21,2001,14.6,46,28,25,17,4,16,36,44.4,20,27,6,21,23,69,29
2285,Amir Rrahmani,xk,DF,,Napoli,Serie A,29,1994,28.9,33,27,17,14,2,16,32,50.0,16,24,10,14,20,53,90
2286,Ruan,br,DF,,Sassuolo,Serie A,24,1999,16.8,25,15,11,10,4,10,18,55.6,8,18,15,3,24,49,68
2287,Pelly Ruddock Mpanzu,cd,MF,,Luton Town,Premier League,30,1993,12.2,13,5,6,6,1,5,9,55.6,4,15,7,8,9,22,16
2288,Antonio Rüdiger,de,DF,,Real Madrid,La Liga,30,1993,30.1,26,15,18,4,4,16,20,80.0,4,27,20,7,11,37,89
2289,Fabian Rüdlin,de,MF,,Freiburg,Bundesliga,26,1997,0.1,1,0,0,0,1,0,0,,0,0,0,0,0,1,0
2290,Javier Rueda Garcia,es,MF,DF,Celta Vigo,La Liga,21,2002,0.2,0,0,0,0,0,0,0,,0,0,0,0,0,0,0
2291,Daniele Rugani,it,DF,,Juventus,Serie A,29,1994,13.2,11,9,7,3,1,4,5,80.0,1,11,4,7,9,20,42
2292,Matteo Ruggeri,it,DF,,Atalanta,Serie A,21,2002,27.2,29,15,14,7,8,16,30,53.3,14,46,4,42,23,52,44
2293,Mário Rui,pt,DF,,Napoli,Serie A,32,1991,13.4,27,15,17,5,5,14,21,66.7,7,17,2,15,15,42,19
2294,Aitor Ruibal,es,DF,FW,Betis,La Liga,27,1996,11.3,46,27,28,13,5,32,59,54.2,27,12,1,11,14,60,33
2295,Fabián Ruiz Peña,es,MF,,Paris S-G,Ligue 1,27,1996,13.3,34,23,17,14,3,23,42,54.8,19,8,2,6,11,45,21
2296,Sergio Ruiz,es,MF,,Granada,La Liga,28,1994,27.7,83,46,43,36,4,38,84,45.2,46,24,6,18,28,111,43
2297,Julian Ryerson,no,DF,,Dortmund,Bundesliga,25,1997,19.6,41,23,26,11,4,27,47,57.4,20,31,7,24,10,51,35
2298,Frederik Rønnow,dk,GK,,Union Berlin,Bundesliga,30,1992,33.0,1,1,1,0,0,0,0,,0,0,0,0,1,2,20
2299,José Sá,pt,GK,,Wolves,Premier League,30,1993,33.7,0,0,0,0,0,0,1,0.0,1,3,0,3,0,0,21
2300,Youssouf Sabaly,sn,DF,,Betis,La Liga,30,1993,11.6,16,11,12,3,1,8,12,66.7,4,6,3,3,11,27,27
2301,Emmanuel Sabbi,us,FW,MF,Le Havre,Ligue 1,25,1997,17.6,38,19,15,15,8,16,39,41.0,23,26,2,24,19,57,7
2302,Stefano Sabelli,it,DF,,Genoa,Serie A,30,1993,27.0,50,24,28,19,3,15,46,32.6,31,27,6,21,23,73,35
2303,Marcel Sabitzer,at,MF,,Dortmund,Bundesliga,29,1994,21.8,39,24,18,20,1,23,42,54.8,19,31,12,19,12,51,34
2304,Falaye Sacko,ml,DF,,Montpellier,Ligue 1,28,1995,15.4,28,16,13,10,5,21,32,65.6,11,19,7,12,24,52,37
2305,Dominic Sadi,eng,FW,,Bournemouth,Premier League,19,2003,0.0,0,0,0,0,0,0,0,,0,0,0,0,0,0,0
2306,Umar Sadiq,ng,FW,,Real Sociedad,La Liga,26,1997,12.0,15,10,2,8,5,4,8,50.0,4,9,0,9,0,15,10
2307,Alexis Saelemaekers,be,FW,MF,Bologna,Serie A,24,1999,21.0,32,22,13,14,5,12,27,44.4,15,13,1,12,13,45,10
2308,Pablo Saenz,es,MF,,Granada,La Liga,22,2001,0.2,3,3,2,0,1,1,3,33.3,2,0,0,0,0,3,0
2309,Modibo Sagnan,ml,DF,,Montpellier,Ligue 1,24,1999,11.7,34,22,23,9,2,15,25,60.0,10,13,9,4,15,49,67
2310,Wesley Saïd,fr,FW,MF,Lens,Ligue 1,28,1995,11.3,8,4,1,2,5,2,9,22.2,7,4,0,4,4,12,3
2311,Théo Sainte-Luce,fr,DF,,Montpellier,Ligue 1,24,1998,3.8,17,7,10,6,1,11,19,57.9,8,9,4,5,3,20,15
2312,Bukayo Saka,eng,FW,,Arsenal,Premier League,21,2001,32.4,66,35,22,24,20,26,59,44.1,33,43,2,41,15,81,24
2313,Mamadou Sakho,fr,DF,,Montpellier,Ligue 1,33,1990,0.1,1,1,1,0,0,1,1,100.0,0,0,0,0,0,1,1
2314,Ibrahim Salah,ma,FW,MF,Rennes,Ligue 1,21,2001,5.8,15,7,5,6,4,11,18,61.1,7,4,0,4,10,25,5
2315,Mohamed Salah,eg,FW,,Liverpool,Premier League,31,1992,28.2,17,11,1,8,8,6,21,28.6,15,19,1,18,2,19,1
2316,Amine Salama,fr,FW,,Reims,Ligue 1,23,2000,3.5,0,0,0,0,0,0,0,,0,1,0,1,1,1,1
2317,Kike Salas,es,DF,,Sevilla,La Liga,21,2002,17.8,41,23,26,12,3,22,36,61.1,14,25,14,11,26,67,91
2318,William Saliba,fr,DF,,Arsenal,Premier League,22,2001,38.0,41,26,28,12,1,20,27,74.1,7,32,17,15,29,70,81
2319,Mohammed Salisu,gh,DF,,Monaco,Ligue 1,24,1999,11.5,27,12,11,13,3,17,26,65.4,9,21,12,9,22,49,44
2320,Roland Sallai,hu,MF,FW,Freiburg,Bundesliga,26,1997,20.4,17,10,5,5,7,8,20,40.0,12,21,1,20,6,23,23
2321,Yoann Salmier,gf,DF,,Le Havre,Ligue 1,30,1992,17.4,22,10,13,6,3,13,20,65.0,7,21,15,6,21,43,57
2322,Salvi,es,MF,,Rayo Vallecano,La Liga,32,1991,0.3,0,0,0,0,0,0,4,0.0,4,0,0,0,1,1,0
2323,Lazar Samardzic,rs,MF,,Udinese,Serie A,21,2002,26.4,40,19,18,18,4,16,39,41.0,23,26,6,20,10,50,25
2324,Diadie Samassékou,ml,MF,,Cádiz,La Liga,27,1996,1.0,5,3,2,2,1,5,6,83.3,1,0,0,0,3,8,1
2325,Diadie Samassékou,ml,MF,,Hoffenheim,Bundesliga,27,1996,0.0,0,0,0,0,0,0,0,,0,0,0,0,1,1,0
2326,Mama Samba Baldé,gw,FW,MF,Lyon,Ligue 1,27,1995,6.1,8,5,1,2,5,3,9,33.3,6,0,0,0,3,11,1
2327,Brice Samba,fr,GK,,Lens,Ligue 1,29,1994,33.0,1,1,1,0,0,1,1,100.0,0,0,0,0,0,1,10
2328,Albert Sambi Lokonga,be,MF,,Luton Town,Premier League,23,1999,14.5,29,18,14,12,3,17,24,70.8,7,23,13,10,11,40,14
2329,Junior Sambia,fr,DF,MF,Salernitana,Serie A,26,1996,11.5,12,5,8,1,3,6,11,54.5,5,15,7,8,11,23,28
2330,Fede San Emeterio,es,MF,,Cádiz,La Liga,26,1997,1.7,3,2,2,1,0,1,4,25.0,3,3,2,1,2,5,1
2331,Antonio Sanabria,py,FW,MF,Torino,Serie A,27,1996,23.7,18,15,5,9,4,4,9,44.4,5,7,1,6,6,24,12
2332,Oihan Sancet,es,MF,,Athletic Club,La Liga,23,2000,21.9,19,11,3,10,6,8,21,38.1,13,5,1,4,10,29,5
2333,Renato Sanches,pt,MF,,Roma,Serie A,25,1997,1.6,2,1,1,1,0,2,3,66.7,1,2,0,2,0,2,1
2334,Ricard Sánchez,es,DF,,Granada,La Liga,23,2000,25.5,29,18,15,8,6,12,24,50.0,12,32,4,28,13,42,64
2335,Alexis Sánchez,cl,FW,MF,Inter,Serie A,34,1988,8.5,7,6,0,5,2,1,4,25.0,3,4,1,3,1,8,3
2336,Antonio Sánchez,es,MF,,Mallorca,La Liga,26,1997,16.1,25,11,13,10,2,11,32,34.4,21,24,5,19,13,38,13
2337,Davinson Sánchez,co,DF,,Tottenham,Premier League,27,1996,0.9,0,0,0,0,0,0,0,,0,3,2,1,1,1,2
2338,Juanlu Sánchez,es,DF,,Sevilla,La Liga,19,2003,13.1,56,35,34,18,4,34,58,58.6,24,24,7,17,12,68,36
2339,Manu Sánchez,es,DF,MF,Celta Vigo,La Liga,22,2000,19.7,54,28,21,25,8,31,55,56.4,24,23,3,20,19,73,65
2340,Robert Sánchez,es,GK,,Chelsea,Premier League,25,1997,15.9,0,0,0,0,0,0,0,,0,0,0,0,0,0,11
2341,Jadon Sancho,eng,FW,MF,Manchester Utd,Premier League,23,2000,0.9,1,0,1,0,0,1,3,33.3,2,1,0,1,1,2,0
2342,Jadon Sancho,eng,FW,MF,Dortmund,Bundesliga,23,2000,10.5,5,4,1,3,1,0,4,0.0,4,11,0,11,4,9,6
2343,Alex Sandro,br,DF,,Juventus,Serie A,32,1991,8.0,13,7,7,6,0,4,5,80.0,1,13,7,6,15,28,23
2344,Ibou Sané,sn,MF,FW,Metz,Ligue 1,18,2005,1.4,6,4,2,1,3,2,2,100.0,0,3,0,3,1,7,2
2345,Leroy Sané,de,FW,,Bayern Munich,Bundesliga,27,1996,23.7,15,8,6,6,3,4,19,21.1,15,12,0,12,7,22,3
2346,Sadibou Sané,sn,DF,,Metz,Ligue 1,19,2004,9.4,19,12,16,2,1,6,7,85.7,1,14,9,5,8,27,64
2347,Arouna Sangante,sn,DF,,Le Havre,Ligue 1,21,2002,29.9,53,33,27,23,3,24,40,60.0,16,35,18,17,66,119,93
2348,Ibrahim Sangaré,ci,MF,,Nott'ham Forest,Premier League,25,1997,11.5,42,23,25,13,4,12,29,41.4,17,24,7,17,16,58,21
2349,Morgan Sanson,fr,MF,,Nice,Ligue 1,28,1994,21.8,26,19,12,7,7,12,31,38.7,19,34,5,29,20,46,16
2350,Nicola Sansone,it,FW,MF,Lecce,Serie A,31,1991,8.5,11,6,6,2,3,5,16,31.3,11,7,1,6,4,15,5
2351,Baptiste Santamaria,fr,MF,,Rennes,Ligue 1,28,1995,21.4,52,33,21,25,6,29,46,63.0,17,15,6,9,34,86,33
2352,Jesús Santiago,es,MF,,Getafe,La Liga,19,2004,7.3,17,8,8,5,4,4,7,57.1,3,3,0,3,0,17,8
2353,Andrey Santos,br,MF,,Nott'ham Forest,Premier League,19,2004,0.1,0,0,0,0,0,0,0,,0,1,0,1,0,0,0
2354,Andrey Santos,br,MF,,Strasbourg,Ligue 1,19,2004,9.2,29,18,15,13,1,17,26,65.4,9,8,0,8,10,39,11
2355,Tiago Santos,pt,DF,,Lille,Ligue 1,21,2002,26.3,63,42,31,19,13,30,52,57.7,22,24,5,19,15,78,37
2356,Paco Sanz,es,DF,,Almería,La Liga,18,2004,0.3,0,0,0,0,0,0,1,0.0,1,0,0,0,0,0,4
2357,Riccardo Saponara,it,FW,MF,Hellas Verona,Serie A,31,1991,3.8,3,1,2,0,1,1,7,14.3,6,4,0,4,0,3,2
2358,Pablo Sarabia,es,MF,FW,Wolves,Premier League,31,1992,19.4,20,13,8,8,4,12,36,33.3,24,17,1,16,10,30,9
2359,Amin Sarr,se,FW,MF,Lyon,Ligue 1,22,2001,1.1,1,0,0,1,0,0,0,,0,1,0,1,0,1,1
2360,Amin Sarr,se,FW,MF,Wolfsburg,Bundesliga,22,2001,4.3,3,2,1,2,0,1,2,50.0,1,6,1,5,2,5,1
2361,Bouna Sarr,sn,DF,,Bayern Munich,Bundesliga,31,1992,1.2,2,0,1,1,0,2,2,100.0,0,3,0,3,0,2,1
2362,Ismaila Sarr,sn,FW,MF,Marseille,Ligue 1,25,1998,16.1,14,8,2,10,2,6,17,35.3,11,21,6,15,13,27,11
2363,Mamadou Sarr,fr,DF,,Lyon,Ligue 1,17,2005,0.1,0,0,0,0,0,0,0,,0,0,0,0,0,0,0
2364,Martin Satriano,uy,FW,,Brest,Ligue 1,22,2001,20.7,24,16,6,13,5,10,25,40.0,15,19,7,12,7,31,28
2365,Téji Savanier,fr,MF,,Montpellier,Ligue 1,31,1991,30.7,37,20,16,15,6,14,63,22.2,49,36,8,28,33,70,28
2366,Stefan Savić,me,DF,,Atlético Madrid,La Liga,32,1991,18.1,27,19,16,7,4,15,30,50.0,15,29,15,14,27,54,61
2367,Sávio,br,FW,MF,Girona,La Liga,19,2004,33.1,42,25,14,22,6,16,28,57.1,12,34,0,34,18,60,11
2368,Zanos Savva,cy,DF,MF,Torino,Serie A,17,2005,0.3,1,1,0,1,0,1,3,33.3,2,0,0,0,0,1,1
2369,Saba Sazonov,ge,DF,,Torino,Serie A,21,2002,4.0,9,7,4,5,0,3,3,100.0,0,8,5,3,3,12,22
2370,Joe Scally,us,DF,,Gladbach,Bundesliga,20,2002,24.8,41,28,21,17,3,23,40,57.5,17,31,11,20,18,59,78
2371,Giorgio Scalvini,it,DF,,Atalanta,Serie A,19,2003,28.3,53,33,29,19,5,19,40,47.5,21,44,17,27,59,112,71
2372,Gianluca Scamacca,it,FW,,Atalanta,Serie A,24,1999,16.1,15,9,4,5,6,7,14,50.0,7,7,1,6,4,19,9
2373,Dane Scarlett,eng,FW,,Tottenham,Premier League,19,2004,0.2,1,1,0,0,1,0,1,0.0,1,0,0,0,0,1,0
2374,Kevin Schade,de,FW,MF,Brentford,Premier League,21,2001,3.7,3,1,1,2,0,0,5,0.0,5,2,0,2,1,4,4
2375,András Schäfer,hu,MF,,Union Berlin,Bundesliga,24,1999,13.5,29,16,9,15,5,11,20,55.0,9,25,4,21,20,49,25
2376,Fabian Schär,ch,DF,,Newcastle Utd,Premier League,31,1991,33.9,42,24,27,13,2,18,40,45.0,22,50,38,12,36,78,133
2377,Patrik Schick,cz,FW,,Leverkusen,Bundesliga,27,1996,11.8,6,4,0,3,3,1,5,20.0,4,2,0,2,1,7,7
2378,Stefan Schimmer,de,MF,FW,Heidenheim,Bundesliga,29,1994,1.7,1,1,0,1,0,0,3,0.0,3,2,0,2,1,2,6
2379,Xaver Schlager,at,MF,,RB Leipzig,Bundesliga,25,1997,27.5,81,50,35,38,8,21,53,39.6,32,41,8,33,19,100,27
2380,Keven Schlotterbeck,de,DF,,Bochum,Bundesliga,26,1997,24.3,42,22,26,14,2,25,30,83.3,5,33,23,10,33,75,104
2381,Nico Schlotterbeck,de,DF,,Dortmund,Bundesliga,23,1999,31.8,70,50,36,27,7,41,65,63.1,24,52,25,27,45,115,101
2382,Jeffrey Schlupp,gh,FW,MF,Crystal Palace,Premier League,30,1992,15.0,38,24,14,16,8,9,18,50.0,9,13,2,11,8,46,24
2383,Romano Schmid,at,MF,FW,Werder Bremen,Bundesliga,23,2000,28.9,35,20,7,22,6,14,46,30.4,32,36,7,29,11,46,17
2384,Kenneth Schmidt,de,DF,,Freiburg,Bundesliga,21,2002,0.8,2,2,2,0,0,2,4,50.0,2,1,0,1,1,3,2
2385,Niklas Schmidt,de,MF,,Toulouse,Ligue 1,25,1998,14.1,36,21,13,19,4,16,33,48.5,17,14,7,7,4,40,13
2386,Benno Schmitz,de,DF,,Köln,Bundesliga,28,1994,12.8,27,15,20,7,0,17,34,50.0,17,19,4,15,7,34,29
2387,Fabian Schnellhardt,de,MF,,Darmstadt 98,Bundesliga,29,1994,2.6,4,1,2,1,1,1,3,33.3,2,1,0,1,4,8,5
2388,Jan Schöppner,de,MF,,Heidenheim,Bundesliga,24,1999,22.2,48,26,26,20,2,21,42,50.0,21,37,7,30,26,74,57
2389,Marcel Schuhen,de,GK,,Darmstadt 98,Bundesliga,30,1993,31.0,1,0,1,0,0,1,3,33.3,2,0,0,0,2,3,11
2390,Perr Schuurs,nl,DF,,Torino,Serie A,23,1999,8.6,20,12,11,8,1,3,9,33.3,6,10,2,8,9,29,23
2391,Marvin Schwäbe,de,GK,,Köln,Bundesliga,28,1995,34.0,1,0,1,0,0,1,1,100.0,0,0,0,0,0,1,10
2392,Alexander Schwolow,de,GK,,Union Berlin,Bundesliga,31,1992,1.0,0,0,0,0,0,0,0,,0,0,0,0,0,0,2
2393,Alex Scott,eng,MF,,Bournemouth,Premier League,19,2003,11.3,24,15,8,10,6,12,28,42.9,16,14,4,10,12,36,18
2394,Simone Scuffet,it,GK,,Cagliari,Serie A,27,1996,31.0,1,0,1,0,0,1,2,50.0,1,1,0,1,1,2,9
2395,Jérémy Sebas,mq,FW,MF,Strasbourg,Ligue 1,20,2003,4.4,7,1,2,3,2,3,5,60.0,2,3,1,2,1,8,1
2396,Demba Seck,sn,MF,,Torino,Serie A,22,2001,4.7,5,3,1,4,0,3,4,75.0,1,1,0,1,1,6,0
2397,Demba Seck,sn,FW,MF,Frosinone,Serie A,22,2001,3.3,7,4,2,3,2,4,5,80.0,1,3,0,3,1,8,1
2398,Aleksandar Sedlar,rs,DF,,Alavés,La Liga,31,1991,10.5,14,10,10,4,0,10,16,62.5,6,8,4,4,13,27,43
2399,Alidu Seidu,gh,DF,,Rennes,Ligue 1,23,2000,6.6,21,9,17,3,1,14,19,73.7,5,11,3,8,10,31,13
2400,Alidu Seidu,gh,DF,,Clermont Foot,Ligue 1,23,2000,12.6,32,24,17,15,0,24,31,77.4,7,15,7,8,25,57,37
2401,Nicolas Seiwald,at,MF,,RB Leipzig,Bundesliga,22,2001,8.0,33,18,16,15,2,16,25,64.0,9,12,2,10,8,41,15
2402,Nikola Sekulov,it,FW,,Juventus,Serie A,21,2002,0.1,0,0,0,0,0,0,0,,0,0,0,0,0,0,0
2403,Davie Selke,de,FW,,Köln,Bundesliga,28,1995,14.1,4,2,1,3,0,0,2,0.0,2,5,3,2,0,4,20
2404,Matz Sels,be,GK,,Nott'ham Forest,Premier League,31,1992,16.0,0,0,0,0,0,0,0,,0,0,0,0,0,0,11
2405,Matz Sels,be,GK,,Strasbourg,Ligue 1,31,1992,19.0,0,0,0,0,0,0,0,,0,2,0,2,0,0,13
2406,Nélson Semedo,pt,DF,MF,Wolves,Premier League,29,1993,34.3,79,48,52,19,8,38,64,59.4,26,44,8,36,36,115,85
2407,Vivaldo Semedo,pt,FW,,Udinese,Serie A,18,2005,0.1,0,0,0,0,0,0,0,,0,0,0,0,0,0,0
2408,Antoine Semenyo,gh,FW,,Bournemouth,Premier League,23,2000,23.4,24,17,7,9,8,9,27,33.3,18,39,2,37,6,30,21
2409,Marvin Senaya,tg,DF,MF,Strasbourg,Ligue 1,22,2001,23.8,72,53,38,25,9,42,68,61.8,26,40,13,27,41,113,68
2410,Marcos Senesi,ar,DF,,Bournemouth,Premier League,26,1997,24.9,55,32,28,23,4,24,56,42.9,32,50,23,27,35,90,109
2411,Stefano Sensi,it,MF,,Inter,Serie A,27,1995,0.5,1,1,0,1,0,1,3,33.3,2,1,0,1,1,2,0
2412,Suat Serdar,de,MF,,Hellas Verona,Serie A,26,1997,18.4,51,39,24,23,4,22,45,48.9,23,29,7,22,20,71,25
2413,Benjamin Šeško,si,FW,,RB Leipzig,Bundesliga,20,2003,17.0,13,5,2,7,4,2,9,22.2,7,23,2,21,3,16,27
2414,Kevin Sessa,de,MF,FW,Heidenheim,Bundesliga,23,2000,11.2,17,10,9,6,2,7,16,43.8,9,12,1,11,4,21,17
2415,Aaron Seydel,de,FW,,Darmstadt 98,Bundesliga,27,1996,6.9,3,2,0,2,1,0,3,0.0,3,8,2,6,1,4,9
2416,Andres Sfait,ro,DF,MF,Salernitana,Serie A,18,2004,0.3,1,1,1,0,0,1,2,50.0,1,0,0,0,0,1,0
2417,Stephan El Shaarawy,it,FW,DF,Roma,Serie A,30,1992,19.3,21,13,14,4,3,6,15,40.0,9,11,4,7,13,34,15
2418,Luke Shaw,eng,DF,,Manchester Utd,Premier League,28,1995,10.7,11,8,7,3,1,9,15,60.0,6,18,11,7,6,17,39
2419,James Shea,eng,GK,,Luton Town,Premier League,32,1991,0.2,0,0,0,0,0,0,0,,0,0,0,0,0,0,2
2420,Eldor Shomurodov,uz,FW,MF,Cagliari,Serie A,28,1995,10.4,11,4,2,6,3,6,10,60.0,4,5,0,5,4,15,4
2421,Steven Shpendi,al,FW,MF,Empoli,Serie A,20,2003,4.6,0,0,0,0,0,0,4,0.0,4,2,1,1,1,1,0
2422,Sofiane Sidi Ali,fr,MF,,Marseille,Ligue 1,28,1995,0.2,2,0,0,2,0,1,2,50.0,1,1,0,1,2,4,0
2423,Vincent Sierro,ch,MF,,Toulouse,Ligue 1,27,1995,25.1,41,24,15,20,6,27,77,35.1,50,37,13,24,27,68,33
2424,Tim Siersleben,de,DF,,Heidenheim,Bundesliga,23,2000,10.1,27,11,21,6,0,8,20,40.0,12,16,10,6,21,48,29
2425,Kiliann Sildillia,fr,DF,,Freiburg,Bundesliga,21,2002,20.1,43,19,28,8,7,26,42,61.9,16,33,15,18,22,65,64
2426,André Silva,pt,FW,,Real Sociedad,La Liga,27,1995,8.1,2,2,0,0,2,0,4,0.0,4,3,0,3,1,3,3
2427,Bernardo Silva,pt,MF,FW,Manchester City,Premier League,28,1994,28.6,51,23,13,25,13,25,57,43.9,32,32,4,28,17,68,15
2428,Caio Henrique Oliveira Silva,br,DF,,Monaco,Ligue 1,26,1997,6.9,13,7,3,7,3,6,9,66.7,3,8,2,6,6,19,9
2429,Fábio Silva,pt,FW,,Wolves,Premier League,21,2002,2.9,7,4,3,4,0,2,3,66.7,1,1,0,1,2,9,0
2430,Rui Silva,pt,GK,,Betis,La Liga,29,1994,27.5,0,0,0,0,0,0,3,0.0,3,0,0,0,1,1,13
2431,Thiago Silva,br,DF,,Chelsea,Premier League,38,1984,28.1,29,15,22,6,1,20,34,58.8,14,33,24,9,26,55,153
2432,Marco Silvestri,it,GK,,Udinese,Serie A,32,1991,17.0,0,0,0,0,0,0,3,0.0,3,1,0,1,0,0,5
2433,Mohamed Simakan,fr,DF,,RB Leipzig,Bundesliga,23,2000,23.8,48,29,28,19,1,32,44,72.7,12,36,14,22,29,77,69
2434,Giovanni Simeone,ar,FW,,Napoli,Serie A,28,1995,8.9,12,4,1,3,8,3,12,25.0,9,11,0,11,1,13,7
2435,Giuliano Simeone,ar,FW,,Alavés,La Liga,20,2002,7.0,7,5,2,3,2,5,17,29.4,12,10,0,10,5,12,3
2436,Jan-Carlo Simic,rs,DF,,Milan,Serie A,18,2005,1.6,1,1,1,0,0,0,0,,0,5,4,1,0,1,3
2437,Moses Simon,ng,FW,MF,Nantes,Ligue 1,28,1995,19.9,7,5,2,5,0,2,8,25.0,6,9,1,8,3,10,5
2438,Unai Simón,es,GK,,Athletic Club,La Liga,26,1997,35.4,2,1,1,1,0,2,3,66.7,1,0,0,0,1,3,9
2439,Xavi Simons,nl,MF,,RB Leipzig,Bundesliga,20,2003,29.5,30,17,10,11,9,15,31,48.4,16,23,0,23,16,46,4
2440,Wilfried Singo,ci,DF,,Monaco,Ligue 1,22,2000,24.3,34,25,18,14,2,17,26,65.4,9,27,14,13,51,85,81
2441,Luis Sinisterra,co,FW,MF,Bournemouth,Premier League,24,1999,7.8,23,12,9,10,4,9,16,56.3,7,18,0,18,8,31,4
2442,Daley Sinkgraven,nl,DF,,Las Palmas,La Liga,28,1995,4.2,11,5,6,5,0,2,8,25.0,6,5,3,2,6,17,9
2443,Jailson Siqueira,br,DF,MF,Celta Vigo,La Liga,27,1995,10.0,27,18,22,5,0,13,24,54.2,11,13,5,8,12,39,32
2444,Ayanda Sishuba,be,MF,FW,Lens,Ligue 1,18,2005,0.7,3,1,0,2,1,1,2,50.0,1,1,0,1,0,3,0
2445,Ibrahima Sissoko,ml,MF,,Strasbourg,Ligue 1,25,1997,18.2,47,33,13,25,9,23,30,76.7,7,21,8,13,19,66,30
2446,Moussa Sissoko,fr,MF,,Nantes,Ligue 1,33,1989,20.2,27,16,13,8,6,12,25,48.0,13,8,2,6,12,39,31
2447,Antonio Sivera,es,GK,,Alavés,La Liga,26,1996,34.0,0,0,0,0,0,0,1,0.0,1,0,0,0,0,0,17
2448,Tim Skarke,de,FW,DF,Darmstadt 98,Bundesliga,26,1996,26.7,26,16,12,10,4,10,28,35.7,18,25,2,23,6,32,20
2449,Ellyes Skhiri,tn,MF,,Eint Frankfurt,Bundesliga,28,1995,24.1,44,24,18,19,7,19,36,52.8,17,33,4,29,39,83,47
2450,Oliver Skipp,eng,MF,DF,Tottenham,Premier League,22,2000,7.9,18,12,9,6,3,11,18,61.1,7,12,1,11,3,21,9
2451,Leo Skiri Østigård,no,DF,,Napoli,Serie A,23,1999,18.1,24,12,13,10,1,6,11,54.5,5,18,12,6,16,40,65
2452,Łukasz Skorupski,pl,GK,,Bologna,Serie A,32,1991,32.0,2,2,2,0,0,2,3,66.7,1,0,0,0,1,3,11
2453,Robert Skov,dk,DF,FW,Hoffenheim,Bundesliga,27,1996,14.0,24,16,15,8,1,17,36,47.2,19,17,4,13,10,34,23
2454,Milan Škriniar,sk,DF,,Paris S-G,Ligue 1,28,1995,18.1,24,18,17,7,0,14,22,63.6,8,19,10,9,12,36,51
2455,Naatan Skyttä,fi,MF,FW,Toulouse,Ligue 1,21,2002,1.3,4,4,2,1,1,1,1,100.0,0,0,0,0,0,4,0
2456,Chris Smalling,eng,DF,,Roma,Serie A,33,1989,4.3,1,1,1,0,0,1,4,25.0,3,6,5,1,5,6,8
2457,Adam Smith,eng,DF,,Bournemouth,Premier League,32,1991,23.9,37,23,18,11,8,19,39,48.7,20,28,11,17,21,58,62
2458,Emile Smith Rowe,eng,MF,,Arsenal,Premier League,23,2000,3.9,4,1,2,2,0,2,4,50.0,2,3,1,2,3,7,1
2459,Hrvoje Smolčić,hr,DF,,Eint Frankfurt,Bundesliga,22,2000,3.9,7,3,7,0,0,4,5,80.0,1,3,1,2,6,13,23
2460,Cédric Soares,pt,DF,,Arsenal,Premier League,31,1991,0.7,0,0,0,0,0,0,0,,0,0,0,0,0,0,0
2461,Danilo Soares,br,DF,,Bochum,Bundesliga,31,1991,3.9,10,6,5,3,2,5,8,62.5,3,6,0,6,7,17,11
2462,Eduard Sobol,ua,DF,,Strasbourg,Ligue 1,28,1995,0.3,0,0,0,0,0,0,0,,0,0,0,0,0,0,1
2463,Rubén Sobrino,es,MF,FW,Cádiz,La Liga,31,1992,18.3,52,28,18,26,8,22,51,43.1,29,26,2,24,16,68,18
2464,Andrea Sodero,it,MF,,Empoli,Serie A,18,2004,0.1,0,0,0,0,0,0,0,,0,0,0,0,0,0,0
2465,Emran Soglo,eng,MF,DF,Marseille,Ligue 1,18,2005,1.2,2,1,0,2,0,1,3,33.3,2,6,0,6,1,3,3
2466,Alex Sola,es,FW,MF,Alavés,La Liga,24,1999,14.0,27,15,11,9,7,14,26,53.8,12,18,2,16,11,38,16
2467,Alex Sola,es,DF,MF,Real Sociedad,La Liga,24,1999,0.3,0,0,0,0,0,0,0,,0,0,0,0,1,1,2
2468,Dominic Solanke,eng,FW,,Bournemouth,Premier League,25,1997,36.9,23,11,3,13,7,10,29,34.5,19,24,5,19,7,30,43
2469,Ola Solbakken,no,FW,,Roma,Serie A,24,1998,0.3,0,0,0,0,0,0,0,,0,0,0,0,0,0,0
2470,Carlos Soler,es,MF,DF,Paris S-G,Ligue 1,26,1997,12.1,15,10,9,2,4,6,21,28.6,15,10,3,7,5,20,11
2471,Jhon Solis,co,MF,,Girona,La Liga,18,2004,4.3,10,8,4,5,1,4,12,33.3,8,8,3,5,8,18,7
2472,Manor Solomon,il,FW,,Tottenham,Premier League,24,1999,2.2,3,3,1,1,1,1,2,50.0,1,4,0,4,3,6,2
2473,Daniele Sommariva,it,GK,,Genoa,Serie A,26,1997,0.1,0,0,0,0,0,0,0,,0,0,0,0,0,0,0
2474,Yann Sommer,ch,GK,,Inter,Serie A,34,1988,34.0,2,1,2,0,0,2,2,100.0,0,1,0,1,0,2,7
2475,Brandon Soppy,fr,DF,,Torino,Serie A,21,2002,2.0,2,2,1,1,0,2,6,33.3,4,2,0,2,0,2,3
2476,David Soria,es,GK,,Getafe,La Liga,30,1993,37.9,0,0,0,0,0,0,2,0.0,2,0,0,0,0,0,21
2477,Alberto Soro,es,MF,,Granada,La Liga,24,1999,0.1,0,0,0,0,0,0,0,,0,0,0,0,0,0,0
2478,Alessandro Sorrentino,it,GK,,Monza,Serie A,21,2002,6.1,0,0,0,0,0,0,0,,0,0,0,0,0,0,0
2479,Borna Sosa,hr,FW,DF,Stuttgart,Bundesliga,25,1998,0.5,0,0,0,0,0,0,1,0.0,1,0,0,0,0,0,0
2480,Hugo Sotelo,es,MF,,Celta Vigo,La Liga,19,2003,8.0,19,17,3,13,3,8,20,40.0,12,7,1,6,2,21,5
2481,Florian Sotoca,fr,MF,FW,Lens,Ligue 1,32,1990,28.9,33,22,9,21,3,17,38,44.7,21,41,4,37,20,53,34
2482,Riccardo Sottil,it,FW,,Fiorentina,Serie A,24,1999,12.3,10,5,5,1,4,3,8,37.5,5,12,0,12,2,12,2
2483,Tomáš Souček,cz,MF,,West Ham,Premier League,28,1995,31.9,53,35,24,26,3,21,47,44.7,26,55,28,27,37,90,109
2484,Matìas Soulé,ar,FW,MF,Frosinone,Serie A,20,2003,34.7,41,27,12,14,15,19,40,47.5,21,38,4,34,18,59,9
2485,Boubakary Soumaré,fr,MF,,Sevilla,La Liga,24,1999,25.4,39,28,24,14,1,14,26,53.8,12,25,7,18,26,65,20
2486,Issa Soumaré,sn,FW,MF,Le Havre,Ligue 1,22,2000,2.6,2,0,2,0,0,0,4,0.0,4,0,0,0,0,2,2
2487,Vinicius Souza,br,MF,,Sheffield Utd,Premier League,24,1999,29.6,125,76,59,51,15,41,74,55.4,33,57,17,40,32,157,75
2488,Djibril Sow,ch,MF,,Sevilla,La Liga,26,1997,16.2,28,21,15,8,5,9,25,36.0,16,20,3,17,17,45,8
2489,Saidou Sow,gn,DF,,Strasbourg,Ligue 1,21,2002,8.0,20,12,17,3,0,9,13,69.2,4,7,4,3,12,32,36
2490,Çağlar Söyüncü,tr,DF,,Atlético Madrid,La Liga,27,1996,1.3,1,1,1,0,0,0,0,,0,1,0,1,1,2,7
2491,Djed Spence,eng,DF,,Genoa,Serie A,22,2000,9.5,16,10,12,4,0,8,10,80.0,2,20,5,15,8,24,28
2492,Stijn Spierings,nl,MF,,Toulouse,Ligue 1,27,1996,16.8,53,40,26,20,7,29,52,55.8,23,22,5,17,26,79,32
2493,Stijn Spierings,nl,MF,,Lens,Ligue 1,27,1996,1.3,1,0,0,1,0,1,1,100.0,0,2,1,1,2,3,1
2494,Leonardo Spinazzola,it,DF,,Roma,Serie A,30,1993,14.6,15,7,10,5,0,8,18,44.4,10,8,2,6,3,18,15
2495,Marco Sportiello,it,GK,,Milan,Serie A,31,1992,7.0,0,0,0,0,0,0,0,,0,0,0,0,0,0,2
2496,Anton Stach,de,MF,,Hoffenheim,Bundesliga,24,1998,25.8,73,42,40,27,6,33,63,52.4,30,38,12,26,72,145,67
2497,Anton Stach,de,MF,,Mainz 05,Bundesliga,24,1998,1.9,3,0,2,0,1,2,4,50.0,2,5,0,5,2,5,5
2498,Jens Stage,dk,MF,,Werder Bremen,Bundesliga,26,1996,25.9,52,22,21,23,8,18,50,36.0,32,42,23,19,23,75,55
2499,Benjamin Stambouli,fr,MF,,Reims,Ligue 1,32,1990,3.2,9,7,3,5,1,6,11,54.5,5,3,1,2,2,11,8
2500,Josip Stanišić,hr,DF,,Leverkusen,Bundesliga,23,2000,14.0,38,20,19,13,6,22,33,66.7,11,18,3,15,9,47,26
2501,Carl Starfelt,se,DF,,Celta Vigo,La Liga,28,1995,24.6,36,30,30,5,1,19,28,67.9,9,35,28,7,34,70,159
2502,Niklas Stark,de,DF,,Werder Bremen,Bundesliga,28,1995,12.1,26,15,13,11,2,12,18,66.7,6,14,7,7,19,45,61
2503,Jason Steele,eng,GK,,Brighton,Premier League,32,1990,17.0,0,0,0,0,0,0,3,0.0,3,0,0,0,0,0,8
2504,Pascal Stenzel,de,DF,,Stuttgart,Bundesliga,27,1996,11.8,18,8,7,9,2,10,30,33.3,20,22,8,14,15,33,26
2505,Leonidas Stergiou,ch,DF,,Stuttgart,Bundesliga,21,2002,6.6,15,8,7,7,1,9,13,69.2,4,8,1,7,5,20,13
2506,Raheem Sterling,eng,FW,MF,Chelsea,Premier League,28,1994,22.0,21,10,7,8,6,12,26,46.2,14,13,0,13,13,34,9
2507,Trivante Stewart,jm,FW,MF,Salernitana,Serie A,23,2000,1.1,0,0,0,0,0,0,0,,0,1,0,1,0,0,0
2508,Angelo Stiller,de,MF,,Hoffenheim,Bundesliga,22,2001,0.9,0,0,0,0,0,0,1,0.0,1,2,0,2,0,0,3
2509,Angelo Stiller,de,MF,,Stuttgart,Bundesliga,22,2001,29.9,55,33,15,34,6,24,42,57.1,18,41,13,28,28,83,25
2510,Kevin Stöger,at,MF,,Bochum,Bundesliga,29,1993,29.6,49,30,21,21,7,25,63,39.7,38,46,4,42,19,68,18
2511,Filip Stojilković,ch,FW,MF,Darmstadt 98,Bundesliga,23,2000,1.7,1,1,0,0,1,0,0,,0,0,0,0,0,1,1
2512,John Stones,eng,DF,MF,Manchester City,Premier League,29,1994,11.8,2,1,1,0,1,0,3,0.0,3,11,7,4,10,12,21
2513,Thomas Strakosha,al,GK,,Brentford,Premier League,28,1995,1.5,0,0,0,0,0,0,0,,0,0,0,0,0,0,0
2514,Jørgen Strand Larsen,no,FW,,Celta Vigo,La Liga,23,2000,31.8,21,11,1,15,5,8,38,21.1,30,15,1,14,5,26,17
2515,Gabriel Strefezza,br,FW,,Lecce,Serie A,26,1997,12.4,24,17,8,7,9,14,20,70.0,6,17,0,17,7,31,11
2516,Kevin Strootman,nl,MF,,Genoa,Serie A,33,1990,13.4,34,19,13,18,3,15,31,48.4,16,20,6,14,7,41,22
2517,Cristhian Stuani,uy,FW,,Girona,La Liga,36,1986,8.9,14,11,4,6,4,4,7,57.1,3,9,2,7,5,19,13
2518,Álex Suárez,es,DF,,Las Palmas,La Liga,30,1993,28.5,53,36,33,15,5,31,37,83.8,6,33,14,19,18,71,84
2519,Damián Suárez,uy,DF,,Getafe,La Liga,35,1988,14.4,36,21,16,16,4,26,45,57.8,19,13,3,10,10,46,31
2520,Denis Suárez,es,MF,FW,Villarreal,La Liga,29,1994,1.5,0,0,0,0,0,0,2,0.0,2,2,2,0,0,0,4
2521,Gabriel Suazo,cl,DF,,Toulouse,Ligue 1,25,1997,26.2,66,32,40,19,7,38,86,44.2,48,37,4,33,26,92,33
2522,Isaac Success,ng,FW,MF,Udinese,Serie A,27,1996,9.8,6,4,0,5,1,1,3,33.3,2,6,1,5,2,8,11
2523,Niklas Süle,de,DF,,Dortmund,Bundesliga,27,1995,16.8,18,10,14,3,1,11,16,68.8,5,25,14,11,25,43,58
2524,Ibrahim Sulemana,gh,MF,,Cagliari,Serie A,20,2003,14.9,36,14,15,15,6,17,27,63.0,10,24,5,19,7,43,23
2525,Tomáš Suslov,sk,MF,FW,Hellas Verona,Serie A,21,2002,23.2,42,30,11,22,9,15,47,31.9,32,15,0,15,6,48,8
2526,Suso,es,MF,FW,Sevilla,La Liga,29,1993,16.9,24,17,14,8,2,8,28,28.6,20,9,0,9,5,29,4
2527,Mattias Svanberg,se,MF,,Wolfsburg,Bundesliga,24,1999,19.1,37,17,8,19,10,12,38,31.6,26,25,5,20,21,58,28
2528,Max Svensson,es,FW,,Osasuna,La Liga,,,0.0,1,0,0,0,1,0,0,,0,0,0,0,0,1,0
2529,Mile Svilar,rs,GK,,Roma,Serie A,23,1999,15.0,0,0,0,0,0,0,0,,0,0,0,0,0,0,2
2530,Williot Swedberg,se,FW,MF,Celta Vigo,La Liga,19,2004,4.9,9,4,3,6,0,5,8,62.5,3,11,1,10,0,9,4
2531,Karol Świderski,pl,FW,MF,Hellas Verona,Serie A,26,1997,5.6,7,3,1,3,3,2,3,66.7,1,6,4,2,1,8,8
2532,Abakar Sylla,ci,DF,,Strasbourg,Ligue 1,20,2002,19.9,54,23,30,19,5,29,40,72.5,11,40,11,29,26,80,70
2533,Dembo Sylla,gn,DF,,Lorient,Ligue 1,20,2002,0.5,1,1,0,1,0,0,0,,0,0,0,0,1,2,2
2534,Issiaga Sylla,gn,DF,FW,Montpellier,Ligue 1,29,1994,16.2,28,17,20,6,2,16,34,47.1,18,21,7,14,23,51,53
2535,Mamadou Sylla,sn,FW,MF,Alavés,La Liga,29,1994,0.2,0,0,0,0,0,0,0,,0,1,1,0,0,0,1
2536,Attila Szalai,hu,DF,,Hoffenheim,Bundesliga,25,1998,3.2,3,1,3,0,0,1,4,25.0,3,6,2,4,1,4,7
2537,Attila Szalai,hu,DF,,Freiburg,Bundesliga,25,1998,1.1,1,1,1,0,0,1,2,50.0,1,5,2,3,1,2,11
2538,Wojciech Szczęsny,pl,GK,,Juventus,Serie A,33,1990,35.0,0,0,0,0,0,0,0,,0,0,0,0,1,1,11
2539,Dominik Szoboszlai,hu,MF,,Liverpool,Premier League,22,2000,23.4,32,19,12,12,8,16,50,32.0,34,37,2,35,15,47,16
2540,Przemysław Szymiński,pl,MF,,Frosinone,Serie A,29,1994,0.1,0,0,0,0,0,0,0,,0,1,1,0,0,0,0
2541,Alexander Sørloth,no,FW,,Villarreal,La Liga,27,1995,27.7,6,3,1,2,3,2,6,33.3,4,9,4,5,0,6,26
2542,Musa Al-Taamari,jo,FW,,Montpellier,Ligue 1,26,1997,21.4,20,16,10,5,5,9,21,42.9,12,18,2,16,4,24,5
2543,Nicolás Tagliafico,ar,DF,,Lyon,Ligue 1,30,1992,23.6,54,34,23,22,9,22,49,44.9,27,25,8,17,28,82,43
2544,Jonathan Tah,de,DF,,Leverkusen,Bundesliga,27,1996,29.2,19,9,10,7,2,5,16,31.3,11,28,23,5,23,42,97
2545,Montassar Talbi,tn,DF,,Lorient,Ligue 1,25,1998,24.5,38,22,23,13,2,19,32,59.4,13,39,23,16,32,70,114
2546,Yassin Tallal,es,FW,,Getafe,La Liga,18,2005,0.0,0,0,0,0,0,0,0,,0,0,0,0,0,0,0
2547,Adrien Tameze,cm,DF,MF,Torino,Serie A,29,1994,23.8,35,16,13,18,4,18,37,48.6,19,24,11,13,47,82,25
2548,Renato Tapia,pe,MF,DF,Celta Vigo,La Liga,28,1995,14.9,41,29,19,19,3,14,25,56.0,11,31,7,24,21,62,50
2549,Edmond Tapsoba,bf,DF,,Leverkusen,Bundesliga,24,1999,23.2,34,25,17,15,2,17,24,70.8,7,21,10,11,24,58,52
2550,Matt Targett,eng,DF,,Newcastle Utd,Premier League,27,1995,0.9,2,0,1,1,0,1,1,100.0,0,1,0,1,0,2,2
2551,Oussama Targhalline,ma,MF,,Le Havre,Ligue 1,21,2002,11.4,23,11,16,7,0,15,25,60.0,10,9,3,6,20,43,14
2552,James Tarkowski,eng,DF,,Everton,Premier League,30,1992,38.0,61,42,46,14,1,27,48,56.3,21,82,56,26,56,117,191
2553,César Tárrega,es,DF,,Valencia,La Liga,21,2002,0.1,0,0,0,0,0,0,0,,0,0,0,0,0,0,2
2554,Jimi Tauriainen,eng,FW,,Chelsea,Premier League,19,2004,0.0,0,0,0,0,0,0,0,,0,0,0,0,0,0,0
2555,Nuno Tavares,pt,DF,,Nott'ham Forest,Premier League,23,2000,5.1,11,7,9,1,1,8,9,88.9,1,6,0,6,1,12,21
2556,Marcus Tavernier,eng,FW,,Bournemouth,Premier League,24,1999,23.5,53,34,25,22,6,26,48,54.2,22,31,3,28,5,58,23
2557,Elayis Tavsan,nl,MF,FW,Hellas Verona,Serie A,22,2001,0.6,0,0,0,0,0,0,1,0.0,1,0,0,0,0,0,1
2558,Charlie Taylor,eng,DF,,Burnley,Premier League,29,1993,25.9,35,20,19,14,2,17,35,48.6,18,27,11,16,19,54,78
2559,Marciano Tchami,gw,FW,MF,Almería,La Liga,19,2004,0.5,0,0,0,0,0,0,0,,0,0,0,0,0,0,0
2560,Loum Tchaouna,fr,FW,MF,Salernitana,Serie A,19,2003,23.3,20,10,5,13,2,10,20,50.0,10,20,1,19,4,24,16
2561,Jackson Tchatchoua,cm,DF,,Hellas Verona,Serie A,21,2001,19.2,39,26,25,12,2,23,48,47.9,25,17,7,10,23,62,49
2562,Enzo Tchato,cm,DF,,Montpellier,Ligue 1,20,2002,12.5,26,17,18,4,4,11,25,44.0,14,20,7,13,11,37,25
2563,Aurélien Tchouaméni,fr,MF,DF,Real Madrid,La Liga,23,2000,22.1,38,23,19,17,2,9,18,50.0,9,21,13,8,28,66,52
2564,Mathys Tel,fr,FW,MF,Bayern Munich,Bundesliga,18,2005,11.7,12,2,3,4,5,4,6,66.7,2,11,0,11,6,18,6
2565,Nathan Tella,ng,DF,MF,Leverkusen,Bundesliga,24,1999,9.1,13,8,6,5,2,5,10,50.0,5,10,0,10,3,16,8
2566,Nahuel Tenaglia,ar,DF,,Alavés,La Liga,27,1996,12.7,29,19,22,4,3,16,28,57.1,12,14,8,6,12,41,59
2567,Arnau Tenas,es,GK,,Paris S-G,Ligue 1,22,2001,5.9,0,0,0,0,0,0,0,,0,0,0,0,0,0,0
2568,Marc-André ter Stegen,de,GK,,Barcelona,La Liga,31,1992,28.0,0,0,0,0,0,0,0,,0,0,0,0,0,0,3
2569,Filippo Terracciano,it,DF,,Hellas Verona,Serie A,20,2003,14.4,30,19,23,6,1,17,31,54.8,14,24,6,18,20,50,17
2570,Filippo Terracciano,it,DF,FW,Milan,Serie A,20,2003,0.8,2,2,1,1,0,1,3,33.3,2,3,0,3,0,2,1
2571,Pietro Terracciano,it,GK,,Fiorentina,Serie A,33,1990,33.0,1,1,1,0,0,1,3,33.3,2,1,0,1,0,1,8
2572,Ramón Terrats,es,MF,DF,Villarreal,La Liga,22,2000,8.7,17,13,8,8,1,7,15,46.7,8,11,1,10,3,20,9
2573,Martin Terrier,fr,FW,MF,Rennes,Ligue 1,26,1997,17.0,14,9,3,8,3,6,14,42.9,8,21,4,17,9,23,17
2574,Kenny Tete,nl,DF,,Fulham,Premier League,27,1995,9.6,27,17,19,6,2,11,19,57.9,8,10,3,7,16,43,35
2575,Benjamin Tetteh,gh,FW,MF,Metz,Ligue 1,26,1997,3.1,6,6,1,5,0,4,7,57.1,3,0,0,0,0,6,1
2576,Teddy Teuma,mt,MF,,Reims,Ligue 1,29,1993,23.5,54,36,19,21,14,25,62,40.3,37,33,4,29,20,74,6
2577,Florian Thauvin,fr,FW,,Udinese,Serie A,30,1993,19.0,7,4,2,4,1,4,13,30.8,9,9,1,8,3,10,2
2578,Arthur Theate,be,DF,,Rennes,Ligue 1,23,2000,25.5,30,17,19,6,5,24,37,64.9,13,40,23,17,31,61,90
2579,Norman Theuerkauf,de,MF,DF,Heidenheim,Bundesliga,36,1987,14.0,24,16,13,7,4,13,22,59.1,9,16,6,10,14,38,21
2580,Malick Thiaw,de,DF,,Milan,Serie A,21,2001,18.0,34,17,15,17,2,12,25,48.0,13,23,13,10,13,47,55
2581,Jan Thielmann,de,FW,DF,Köln,Bundesliga,21,2002,17.5,28,18,13,9,6,12,24,50.0,12,31,6,25,8,36,28
2582,Denis Thomalla,de,MF,FW,Heidenheim,Bundesliga,30,1992,5.0,9,6,4,4,1,5,11,45.5,6,3,2,1,4,13,13
2583,Luke Thomas,eng,DF,,Sheffield Utd,Premier League,22,2001,10.2,20,9,13,6,1,8,14,57.1,6,23,5,18,10,30,27
2584,Adrien Thomasson,fr,MF,,Lens,Ligue 1,29,1993,13.3,25,14,4,16,5,11,34,32.4,23,14,0,14,9,34,10
2585,Morten Thorsby,no,MF,,Genoa,Serie A,27,1996,12.9,19,11,9,8,2,7,14,50.0,7,21,5,16,4,23,20
2586,Kristian Thorstvedt,no,MF,,Sassuolo,Serie A,24,1999,26.6,40,22,7,28,5,22,44,50.0,22,25,9,16,21,61,36
2587,Khéphren Thuram,fr,MF,,Nice,Ligue 1,22,2001,23.4,42,29,13,23,6,20,40,50.0,20,21,10,11,18,60,37
2588,Marcus Thuram,fr,FW,,Inter,Serie A,25,1997,29.9,23,15,9,9,5,4,13,30.8,9,26,3,23,4,27,19
2589,Cheikh Tidiane Sabaly,sn,FW,MF,Metz,Ligue 1,24,1999,15.3,40,20,23,12,5,16,40,40.0,24,19,2,17,10,50,14
2590,Youri Tielemans,be,MF,FW,Aston Villa,Premier League,26,1997,18.0,41,20,17,18,6,16,40,40.0,24,23,3,20,15,56,9
2591,Kieran Tierney,sct,DF,,Real Sociedad,La Liga,26,1997,13.8,37,24,16,18,3,18,27,66.7,9,22,8,14,10,47,45
2592,Phillip Tietz,de,FW,,Augsburg,Bundesliga,26,1997,26.5,23,14,7,13,3,6,15,40.0,9,17,3,14,6,29,35
2593,Steffen Tigges,de,FW,,Köln,Bundesliga,25,1998,8.1,10,6,4,5,1,3,7,42.9,4,4,2,2,1,11,12
2594,Antonio Tikvić,hr,DF,,Udinese,Serie A,19,2004,0.0,0,0,0,0,0,0,0,,0,0,0,0,0,0,0
2595,Jurriën Timber,nl,DF,,Arsenal,Premier League,22,2001,0.8,2,2,1,1,0,0,0,,0,1,0,1,0,2,1
2596,Jean-Clair Todibo,fr,DF,,Nice,Ligue 1,23,1999,29.5,58,28,35,17,6,34,56,60.7,22,34,15,19,38,96,97
2597,Harry Toffolo,eng,DF,,Nott'ham Forest,Premier League,27,1995,16.2,26,14,20,6,0,15,24,62.5,9,34,13,21,14,40,49
2598,Umut Tohumcu,de,MF,,Hoffenheim,Bundesliga,18,2004,11.2,16,12,9,7,0,6,19,31.6,13,11,1,10,6,22,12
2599,Corentin Tolisso,fr,MF,,Lyon,Ligue 1,28,1994,19.3,33,21,13,11,9,14,33,42.4,19,26,9,17,10,43,18
2600,Jeremy Toljan,de,DF,,Sassuolo,Serie A,28,1994,23.1,13,10,8,4,1,9,15,60.0,6,17,5,12,16,29,49
2601,Rafael Tolói,it,DF,,Atalanta,Serie A,32,1990,10.7,20,9,7,8,5,14,27,51.9,13,9,4,5,13,33,29
2602,Raúl de Tomás,es,FW,,Rayo Vallecano,La Liga,28,1994,14.1,9,5,4,3,2,3,6,50.0,3,3,0,3,1,10,8
2603,Tiago Tomás,pt,FW,MF,Wolfsburg,Bundesliga,21,2002,11.5,5,2,3,0,2,1,6,16.7,5,13,0,13,3,8,9
2604,Takehiro Tomiyasu,jp,DF,,Arsenal,Premier League,24,1998,12.8,20,9,15,4,1,11,18,61.1,7,10,4,6,18,38,33
2605,James Tomkins,eng,DF,,Crystal Palace,Premier League,34,1989,0.1,0,0,0,0,0,0,0,,0,0,0,0,1,1,0
2606,Fikayo Tomori,eng,DF,,Milan,Serie A,25,1997,23.6,42,24,29,10,3,18,29,62.1,11,34,23,11,26,68,75
2607,Sandro Tonali,it,MF,,Newcastle Utd,Premier League,23,2000,4.9,7,7,4,2,1,3,9,33.3,6,3,0,3,2,9,4
2608,Ivan Toney,eng,FW,,Brentford,Premier League,27,1996,16.1,15,5,2,7,6,6,14,42.9,8,5,1,4,10,25,18
2609,Pablo Torre,es,MF,FW,Girona,La Liga,20,2003,7.8,5,2,0,5,0,4,10,40.0,6,10,2,8,4,9,6
2610,Raúl Torrente,es,DF,,Granada,La Liga,21,2001,13.9,29,16,20,9,0,17,22,77.3,5,16,10,6,11,40,68
2611,Ferrán Torres,es,FW,,Barcelona,La Liga,23,2000,13.5,9,6,1,6,2,5,16,31.3,11,7,1,6,5,14,6
2612,Óliver Torres,es,MF,,Sevilla,La Liga,28,1994,18.0,37,22,17,15,5,22,57,38.6,35,40,4,36,6,43,6
2613,Pau Torres,es,DF,,Aston Villa,Premier League,26,1997,27.4,29,18,17,11,1,14,30,46.7,16,28,12,16,14,43,75
2614,Lucas Torró,es,MF,,Osasuna,La Liga,29,1994,19.9,25,15,11,8,6,11,28,39.3,17,10,2,8,33,58,37
2615,Fabio Torsiello,it,FW,DF,Darmstadt 98,Bundesliga,18,2005,1.7,1,0,1,0,0,1,8,12.5,7,1,0,1,1,2,1
2616,Ahmed Touba,dz,DF,,Lecce,Serie A,25,1998,3.1,6,4,3,3,0,3,4,75.0,1,4,3,1,7,13,20
2617,Abdoulaye Touré,gn,MF,,Le Havre,Ligue 1,29,1994,25.4,47,28,22,22,3,30,60,50.0,30,30,8,22,25,72,33
2618,Souleymane Touré,fr,DF,,Lorient,Ligue 1,20,2003,22.8,25,12,16,9,0,8,14,57.1,6,38,20,18,36,61,101
2619,Lucas Tousart,fr,MF,,Union Berlin,Bundesliga,26,1997,17.5,35,20,14,17,4,17,37,45.9,20,32,9,23,25,60,41
2620,Andros Townsend,eng,MF,FW,Luton Town,Premier League,32,1991,13.4,21,13,11,2,8,13,27,48.1,14,12,0,12,5,26,10
2621,James Trafford,eng,GK,,Burnley,Premier League,20,2002,28.0,2,1,2,0,0,2,2,100.0,0,0,0,0,1,3,18
2622,Adama Traoré,es,FW,MF,Fulham,Premier League,27,1996,4.2,4,3,1,2,1,3,6,50.0,3,2,0,2,1,5,2
2623,Bénie Traoré,ci,FW,MF,Sheffield Utd,Premier League,20,2002,4.3,4,2,1,2,1,0,4,0.0,4,4,1,3,1,5,1
2624,Bénie Traoré,ci,FW,MF,Nantes,Ligue 1,20,2002,5.6,8,4,2,5,1,3,7,42.9,4,3,0,3,1,9,1
2625,Bertrand Traoré,bf,DF,FW,Aston Villa,Premier League,27,1995,0.1,1,1,1,0,0,0,0,,0,0,0,0,0,1,1
2626,Bertrand Traoré,bf,MF,,Villarreal,La Liga,27,1995,6.3,5,4,2,1,2,1,4,25.0,3,6,0,6,1,6,2
2627,Boubacar Traoré,ml,MF,,Wolves,Premier League,21,2001,9.1,35,23,16,17,2,9,21,42.9,12,12,2,10,5,40,7
2628,Chaka Traorè,ci,FW,,Milan,Serie A,18,2004,0.2,2,1,2,0,0,1,2,50.0,1,1,1,0,0,2,0
2629,Daouda Traoré,fr,MF,,Nice,Ligue 1,17,2006,0.2,0,0,0,0,0,0,0,,0,0,0,0,0,0,0
2630,Hamari Traoré,ml,DF,,Real Sociedad,La Liga,31,1992,25.5,44,19,24,17,3,25,43,58.1,18,27,8,19,24,68,59
2631,Ismaël Traoré,ci,DF,,Metz,Ligue 1,36,1986,24.7,19,12,13,6,0,8,21,38.1,13,33,20,13,30,49,86
2632,Omar Traoré,de,DF,,Heidenheim,Bundesliga,25,1998,27.5,60,33,33,21,6,32,56,57.1,24,32,7,25,40,100,54
2633,Kevin Trapp,de,GK,,Eint Frankfurt,Bundesliga,33,1990,32.0,0,0,0,0,0,0,0,,0,0,0,0,1,1,9
2634,Mark Travers,ie,GK,,Bournemouth,Premier League,24,1999,4.0,0,0,0,0,0,0,0,,0,0,0,0,0,0,2
2635,Óscar Trejo,ar,FW,MF,Rayo Vallecano,La Liga,35,1988,15.3,27,15,11,9,7,13,21,61.9,8,21,1,20,5,32,9
2636,Mike Trésor,be,FW,MF,Burnley,Premier League,24,1999,4.7,10,6,9,1,0,8,18,44.4,10,5,0,5,1,11,1
2637,Manu Trigueros,es,MF,,Villarreal,La Liga,31,1991,3.4,7,5,6,1,0,4,10,40.0,6,1,1,0,3,10,9
2638,Christopher Trimmel,at,DF,,Union Berlin,Bundesliga,36,1987,18.3,23,15,12,10,1,13,33,39.4,20,16,3,13,13,36,57
2639,Kieran Trippier,eng,DF,,Newcastle Utd,Premier League,32,1990,24.8,57,27,30,16,11,37,77,48.1,40,41,8,33,24,81,57
2640,Leandro Trossard,be,FW,MF,Arsenal,Premier League,28,1994,18.3,27,16,8,9,10,9,25,36.0,16,27,1,26,8,35,6
2641,Adrien Truffert,fr,DF,,Rennes,Ligue 1,21,2001,23.8,39,21,23,10,6,25,40,62.5,15,31,5,26,19,58,49
2642,Auston Trusty,us,DF,,Sheffield Utd,Premier League,24,1998,28.6,47,30,31,13,3,21,43,48.8,22,41,22,19,35,82,153
2643,Kostas Tsimikas,gr,DF,,Liverpool,Premier League,27,1996,7.5,19,13,9,6,4,9,15,60.0,6,9,1,8,6,25,10
2644,Viktor Tsyhankov,ua,MF,FW,Girona,La Liga,25,1997,22.8,29,20,11,13,5,14,26,53.8,12,18,1,17,12,41,24
2645,Stefano Turati,it,GK,,Frosinone,Serie A,21,2001,30.5,0,0,0,0,0,0,0,,0,0,0,0,0,0,6
2646,Matt Turner,us,GK,,Nott'ham Forest,Premier League,29,1994,17.0,0,0,0,0,0,0,0,,0,0,0,0,0,0,8
2647,Beñat Turrientes,es,MF,,Real Sociedad,La Liga,21,2002,18.7,31,17,6,20,5,13,30,43.3,17,19,8,11,6,37,17
2648,Tuta,br,DF,,Eint Frankfurt,Bundesliga,24,1999,28.9,63,33,38,19,6,39,59,66.1,20,29,12,17,36,99,99
2649,Destiny Udogie,it,DF,,Tottenham,Premier League,20,2002,26.6,68,33,41,16,11,27,49,55.1,22,27,8,19,37,105,80
2650,Matthieu Udol,fr,DF,,Metz,Ligue 1,27,1996,30.0,55,37,38,12,5,38,56,67.9,18,62,16,46,50,105,108
2651,Manuel Ugarte Ribeiro,uy,MF,,Paris S-G,Ligue 1,22,2001,21.5,98,57,39,43,16,43,89,48.3,46,27,6,21,40,138,25
2652,Lesley Ugochukwu,fr,MF,,Chelsea,Premier League,19,2004,3.3,14,10,4,8,2,4,10,40.0,6,6,2,4,1,15,5
2653,Lukas Ullrich,de,DF,FW,Gladbach,Bundesliga,19,2004,0.5,1,0,1,0,0,1,4,25.0,3,0,0,0,0,1,1
2654,Sven Ulreich,de,GK,,Bayern Munich,Bundesliga,34,1988,11.0,1,0,1,0,0,1,1,100.0,0,0,0,0,0,1,3
2655,Samuel Umtiti,fr,DF,,Lille,Ligue 1,29,1993,2.1,1,1,0,1,0,1,4,25.0,3,0,0,0,2,3,4
2656,Enes Ünal,tr,FW,MF,Bournemouth,Premier League,26,1997,3.6,6,4,2,3,1,2,5,40.0,3,4,2,2,1,7,6
2657,Enes Ünal,tr,FW,MF,Getafe,La Liga,26,1997,1.6,0,0,0,0,0,0,0,,0,1,0,1,0,0,2
2658,Deniz Undav,de,FW,MF,Stuttgart,Bundesliga,27,1996,23.2,28,13,6,8,14,4,15,26.7,11,17,0,17,6,34,5
2659,Dayot Upamecano,fr,DF,,Bayern Munich,Bundesliga,24,1998,19.6,34,21,21,11,2,15,29,51.7,14,19,7,12,19,53,56
2660,Kacper Urbanski,pl,MF,FW,Bologna,Serie A,18,2004,10.3,16,10,5,10,1,6,13,46.2,7,15,1,14,4,20,14
2661,Mark Uth,de,MF,FW,Köln,Bundesliga,31,1991,4.1,8,4,2,3,3,4,12,33.3,8,6,0,6,1,9,2
2662,Myrto Uzuni,al,FW,,Granada,La Liga,28,1995,27.2,18,14,8,7,3,6,27,22.2,21,19,3,16,4,22,7
2663,Josha Vagnoman,de,DF,,Stuttgart,Bundesliga,22,2000,13.1,28,18,15,11,2,15,30,50.0,15,11,5,6,2,30,16
2664,Óscar Valentín,es,MF,,Rayo Vallecano,La Liga,28,1994,29.9,107,66,39,62,6,46,101,45.5,55,62,10,52,35,142,52
2665,Emanuele Valeri,it,DF,,Frosinone,Serie A,24,1998,13.1,19,16,10,5,4,10,21,47.6,11,14,3,11,9,28,22
2666,Martin Valjent,sk,DF,,Mallorca,La Liga,27,1995,26.1,34,18,19,13,2,18,30,60.0,12,26,11,15,29,63,112
2667,Jesús Vallejo,es,DF,,Granada,La Liga,26,1997,1.2,3,1,1,2,0,2,2,100.0,0,3,2,1,0,3,1
2668,Álvaro Vallés,es,GK,,Las Palmas,La Liga,26,1997,36.3,3,2,3,0,0,3,8,37.5,5,0,0,0,0,3,40
2669,Federico Valverde,uy,MF,,Real Madrid,La Liga,25,1998,32.3,47,34,22,13,12,24,42,57.1,18,39,2,37,43,90,40
2670,Kévin Van Den Kerkhof,dz,FW,MF,Metz,Ligue 1,27,1996,21.3,31,24,11,13,7,13,32,40.6,19,15,2,13,11,42,32
2671,Siebe Van Der Heyden,be,DF,,Mallorca,La Liga,25,1998,3.2,9,2,7,2,0,4,6,66.7,2,1,1,0,7,16,12
2672,Virgil van Dijk,nl,DF,,Liverpool,Premier League,32,1991,35.3,40,23,24,13,3,12,14,85.7,2,47,34,13,39,79,144
2673,Vanderson,br,DF,,Monaco,Ligue 1,22,2001,18.2,60,41,20,30,10,32,70,45.7,38,29,2,27,35,95,37
2674,Raphaël Varane,fr,DF,,Manchester Utd,Premier League,30,1993,15.3,18,11,10,7,1,10,14,71.4,4,23,18,5,15,33,88
2675,Ruben Vargas,ch,MF,FW,Augsburg,Bundesliga,24,1998,21.8,23,10,6,10,7,10,25,40.0,15,19,4,15,7,30,17
2676,Johan Vásquez,mx,DF,,Genoa,Serie A,24,1998,31.7,51,33,38,11,2,32,50,64.0,18,50,26,24,45,96,113
2677,José Luis García Vayá,es,MF,,Valencia,La Liga,24,1998,36.7,78,53,36,36,6,37,71,52.1,34,41,10,31,49,127,71
2678,Borja Vázquez,es,FW,,Cádiz,La Liga,18,2005,0.0,1,0,1,0,0,1,1,100.0,0,0,0,0,0,1,1
2679,Jesus Vazquez,es,DF,MF,Valencia,La Liga,20,2003,8.0,24,12,13,8,3,10,16,62.5,6,17,4,13,3,27,24
2680,Kevin Vázquez,es,DF,,Celta Vigo,La Liga,30,1993,7.8,15,13,7,7,1,12,21,57.1,9,11,3,8,5,20,25
2681,Lucas Vázquez,es,DF,,Real Madrid,La Liga,32,1991,15.8,37,25,22,14,1,18,25,72.0,7,27,5,22,12,49,36
2682,Matías Vecino,uy,MF,,Lazio,Serie A,31,1991,12.8,32,17,12,20,0,20,31,64.5,11,17,5,12,12,44,21
2683,Gabriel Veiga,es,FW,,Celta Vigo,La Liga,21,2002,0.2,0,0,0,0,0,0,0,,0,0,0,0,0,0,0
2684,Alejo Véliz,ar,FW,,Tottenham,Premier League,19,2003,0.6,1,0,1,0,0,0,0,,0,0,0,0,0,1,0
2685,Alejo Véliz,ar,FW,,Sevilla,La Liga,19,2003,0.4,1,0,0,1,0,1,2,50.0,1,0,0,0,0,1,1
2686,Miloš Veljković,rs,DF,,Werder Bremen,Bundesliga,27,1995,21.3,31,15,17,13,1,16,31,51.6,15,31,20,11,17,48,57
2687,Joël Veltman,nl,DF,,Brighton,Premier League,31,1992,17.6,54,41,32,17,5,39,58,67.2,19,17,7,10,18,72,57
2688,Micky van de Ven,nl,DF,,Tottenham,Premier League,22,2001,26.0,49,35,34,12,3,24,33,72.7,9,25,15,10,18,67,78
2689,Lorenzo Venuti,it,DF,,Lecce,Serie A,28,1995,4.0,6,4,5,1,0,6,10,60.0,4,4,3,1,5,11,14
2690,Bart Verbruggen,nl,GK,,Brighton,Premier League,20,2002,21.0,1,1,1,0,0,1,2,50.0,1,0,0,0,0,1,11
2691,Simone Verdi,it,FW,,Torino,Serie A,31,1992,0.0,0,0,0,0,0,0,0,,0,0,0,0,0,0,0
2692,Jordan Veretout,fr,MF,,Marseille,Ligue 1,30,1993,24.3,38,22,19,13,6,18,39,46.2,21,20,4,16,13,51,25
2693,Arthur Vermeeren,be,MF,,Atlético Madrid,La Liga,18,2005,1.8,1,0,0,1,0,0,1,0.0,1,5,0,5,6,7,2
2694,Yorbe Vertessen,be,FW,MF,Union Berlin,Bundesliga,22,2001,6.6,3,2,0,3,0,1,4,25.0,3,8,0,8,1,4,3
2695,Mikel Vesga,es,MF,,Athletic Club,La Liga,30,1993,17.0,40,20,11,23,6,19,49,38.8,30,19,7,12,32,72,35
2696,Guglielmo Vicario,it,GK,,Tottenham,Premier League,26,1996,38.0,0,0,0,0,0,0,1,0.0,1,0,0,0,1,1,31
2697,Carlos Vicente,es,FW,,Alavés,La Liga,24,1999,12.4,16,6,7,7,2,10,25,40.0,15,4,0,4,4,20,9
2698,Nacho Vidal,es,DF,FW,Osasuna,La Liga,28,1995,1.1,5,4,2,2,1,2,5,40.0,3,2,0,2,0,5,6
2699,Nacho Vidal,es,DF,,Mallorca,La Liga,28,1995,4.6,12,5,4,5,3,6,13,46.2,7,5,2,3,3,15,9
2700,Fabio Vieira,pt,MF,FW,Arsenal,Premier League,23,2000,3.3,3,2,2,0,1,3,3,100.0,0,0,0,0,2,5,2
2701,Fran Vieites,es,GK,,Betis,La Liga,24,1999,3.5,1,0,1,0,0,1,1,100.0,0,0,0,0,0,1,2
2702,Jonathan Viera,es,MF,FW,Las Palmas,La Liga,33,1989,6.9,6,3,1,2,3,1,9,11.1,8,0,0,0,0,6,1
2703,Jonathan Viera,es,MF,,Almería,La Liga,33,1989,10.1,19,9,6,9,4,10,19,52.6,9,4,0,4,4,23,1
2704,Emanuel Vignato,it,MF,FW,Salernitana,Serie A,22,2000,3.5,10,7,4,5,1,5,6,83.3,1,1,0,1,1,11,7
2705,Samuele Vignato,it,MF,FW,Monza,Serie A,19,2004,3.8,6,4,2,3,1,2,3,66.7,1,2,0,2,1,7,1
2706,Oscar Vilhelmsson,se,FW,MF,Darmstadt 98,Bundesliga,19,2003,15.3,13,6,3,7,3,7,10,70.0,3,15,5,10,3,16,19
2707,Toni Villa,es,FW,,Girona,La Liga,28,1995,0.1,0,0,0,0,0,0,0,,0,0,0,0,0,0,0
2708,Asier Villalibre,es,FW,,Athletic Club,La Liga,25,1997,5.7,2,1,0,0,2,2,2,100.0,0,2,1,1,0,2,6
2709,Gonzalo Villar,es,MF,,Granada,La Liga,25,1998,20.0,51,33,26,20,5,26,41,63.4,15,32,10,22,6,57,26
2710,Iván Villar,es,GK,,Celta Vigo,La Liga,26,1997,11.3,0,0,0,0,0,0,1,0.0,1,0,0,0,0,0,6
2711,Matías Viña,uy,DF,,Sassuolo,Serie A,25,1997,11.3,34,21,22,7,5,20,36,55.6,16,12,2,10,9,43,34
2712,Rúben Vinagre,pt,DF,FW,Hellas Verona,Serie A,24,1999,3.1,4,2,1,1,2,3,4,75.0,1,6,3,3,1,5,4
2713,Carlos Vinícius,br,FW,,Fulham,Premier League,28,1995,3.5,3,2,0,1,2,0,4,0.0,4,4,0,4,0,3,1
2714,Nicolas Viola,it,MF,FW,Cagliari,Serie A,33,1989,13.4,13,9,2,8,3,7,17,41.2,10,9,0,9,2,15,6
2715,Alan Virginius,fr,FW,,Lille,Ligue 1,20,2003,0.8,1,1,1,0,0,0,1,0.0,1,0,0,0,0,1,0
2716,Alan Virginius,fr,FW,,Clermont Foot,Ligue 1,20,2003,10.4,9,5,4,4,1,4,11,36.4,7,7,0,7,3,12,7
2717,Ricardo Visus,es,DF,,Betis,La Liga,22,2001,1.8,2,2,1,1,0,2,2,100.0,0,2,2,0,2,4,9
2718,Mattia Viti,it,DF,,Sassuolo,Serie A,21,2002,10.9,24,15,14,7,3,10,22,45.5,12,20,10,10,10,34,44
2719,Vitinha,pt,FW,MF,Genoa,Serie A,23,2000,3.2,2,2,1,0,1,1,2,50.0,1,2,0,2,0,2,2
2720,Vitinha,pt,FW,,Marseille,Ligue 1,23,2000,10.3,14,8,3,5,6,3,12,25.0,9,11,2,9,5,19,8
2721,Vitinha,pt,MF,,Paris S-G,Ligue 1,23,2000,23.6,39,24,12,16,11,16,48,33.3,32,29,11,18,23,62,30
2722,Vitinho,br,DF,MF,Burnley,Premier League,24,1999,25.7,64,34,36,22,6,43,86,50.0,43,44,6,38,12,76,47
2723,Daniel Vivian,es,DF,,Athletic Club,La Liga,24,1999,32.0,42,28,29,11,2,28,45,62.2,17,49,25,24,31,73,104
2724,Odisseas Vlachodimos,gr,GK,,Nott'ham Forest,Premier League,29,1994,5.0,0,0,0,0,0,0,1,0.0,1,0,0,0,0,0,1
2725,Dušan Vlahović,rs,FW,,Juventus,Serie A,23,2000,25.6,9,5,0,6,3,4,11,36.4,7,4,2,2,1,10,11
2726,Nikola Vlašić,hr,MF,FW,Torino,Serie A,25,1997,29.0,28,16,6,14,8,4,30,13.3,26,26,7,19,11,39,16
2727,Alessandro Vogliacco,it,DF,,Genoa,Serie A,24,1998,13.0,23,15,14,8,1,12,15,80.0,3,16,10,6,30,53,40
2728,Kevin Vogt,de,DF,,Hoffenheim,Bundesliga,31,1991,14.7,14,10,7,7,0,8,13,61.5,5,16,13,3,9,23,54
2729,Kevin Vogt,de,DF,,Union Berlin,Bundesliga,31,1991,14.7,10,9,6,4,0,6,12,50.0,6,22,15,7,7,17,72
2730,Mërgim Vojvoda,xk,DF,,Torino,Serie A,28,1995,15.3,17,8,7,6,4,11,16,68.8,5,12,2,10,13,30,28
2731,Kevin Volland,de,FW,MF,Union Berlin,Bundesliga,31,1992,14.9,22,9,8,8,6,8,20,40.0,12,8,0,8,6,28,12
2732,Cristian Volpato,it,MF,FW,Sassuolo,Serie A,19,2003,7.2,16,8,9,6,1,9,25,36.0,16,7,0,7,1,17,5
2733,Aster Vranckx,be,MF,,Wolfsburg,Bundesliga,20,2002,12.8,32,15,11,11,10,15,28,53.6,13,17,6,11,14,46,29
2734,Stefan de Vrij,nl,DF,,Inter,Serie A,31,1992,17.6,18,13,13,4,1,8,15,53.3,7,22,10,12,24,42,51
2735,Elye Wahi,fr,FW,,Montpellier,Ligue 1,20,2003,0.2,0,0,0,0,0,0,0,,0,0,0,0,0,0,0
2736,Elye Wahi,fr,FW,,Lens,Ligue 1,20,2003,18.8,6,4,1,3,2,2,10,20.0,8,5,1,4,3,9,3
2737,Walace,br,MF,,Udinese,Serie A,28,1995,36.0,66,43,40,26,0,36,77,46.8,41,43,6,37,43,109,66
2738,Luca Waldschmidt,de,MF,FW,Köln,Bundesliga,27,1996,12.7,19,12,4,12,3,5,16,31.3,11,18,3,15,6,25,8
2739,Kyle Walker,eng,DF,,Manchester City,Premier League,33,1990,30.7,38,24,19,17,2,19,39,48.7,20,19,6,13,27,65,40
2740,Sebastian Walukiewicz,pl,DF,,Empoli,Serie A,23,2000,22.8,39,28,33,6,0,28,41,68.3,13,50,31,19,15,54,121
2741,Aaron Wan-Bissaka,eng,DF,,Manchester Utd,Premier League,25,1997,19.8,42,25,18,20,4,19,26,73.1,7,29,15,14,41,83,68
2742,Joel Ward,eng,DF,,Crystal Palace,Premier League,33,1989,22.0,45,28,26,18,1,30,47,63.8,17,17,10,7,14,59,94
2743,James Ward-Prowse,eng,MF,,West Ham,Premier League,28,1994,33.3,45,29,14,23,8,18,44,40.9,26,31,9,22,38,83,49
2744,Lewis Warrington,eng,FW,,Everton,Premier League,20,2002,0.0,0,0,0,0,0,0,0,,0,0,0,0,0,0,0
2745,Deivid Washington,br,DF,FW,Chelsea,Premier League,18,2005,0.1,1,1,1,0,0,0,1,0.0,1,0,0,0,0,1,0
2746,Kjell-Arik Wätjen,de,MF,FW,Dortmund,Bundesliga,17,2006,1.2,3,2,2,1,0,2,5,40.0,3,1,1,0,0,3,3
2747,Ollie Watkins,eng,FW,,Aston Villa,Premier League,27,1995,35.7,12,7,0,5,7,5,11,45.5,6,26,4,22,4,16,20
2748,Timothy Weah,us,DF,FW,Juventus,Serie A,23,2000,14.0,27,20,16,8,3,15,20,75.0,5,12,1,11,5,32,15
2749,Adam Webster,eng,DF,,Brighton,Premier League,28,1995,12.7,14,12,8,5,1,6,18,33.3,12,16,12,4,16,30,43
2750,Wout Weghorst,nl,FW,,Hoffenheim,Bundesliga,30,1992,22.0,13,6,4,7,2,9,15,60.0,6,25,8,17,6,19,24
2751,Julian Weigl,de,MF,,Gladbach,Bundesliga,27,1995,30.7,66,40,28,32,6,41,67,61.2,26,47,14,33,48,114,61
2752,Nelson Weiper,de,FW,MF,Mainz 05,Bundesliga,18,2005,1.4,2,1,2,0,0,2,3,66.7,1,1,0,1,1,3,0
2753,Mitchell Weiser,de,DF,MF,Werder Bremen,Bundesliga,29,1994,29.3,64,38,29,25,10,31,53,58.5,22,36,6,30,20,84,43
2754,Noah Weißhaupt,de,DF,FW,Freiburg,Bundesliga,21,2001,8.4,9,4,6,0,3,5,11,45.5,6,8,1,7,8,17,12
2755,Shon Weissman,il,FW,DF,Salernitana,Serie A,27,1996,5.5,4,3,2,0,2,0,4,0.0,4,2,1,1,3,7,4
2756,Shon Weissman,il,FW,,Granada,La Liga,27,1996,0.9,1,1,0,0,1,1,4,25.0,3,3,0,3,0,1,1
2757,Danny Welbeck,eng,FW,MF,Brighton,Premier League,32,1990,18.8,35,17,9,17,9,10,17,58.8,7,12,0,12,9,44,17
2758,Timo Werner,de,FW,,Tottenham,Premier League,27,1996,9.0,7,4,3,4,0,5,18,27.8,13,12,0,12,3,10,2
2759,Timo Werner,de,FW,MF,RB Leipzig,Bundesliga,27,1996,2.3,2,1,0,1,1,0,0,,0,1,0,1,1,3,0
2760,Adam Wharton,eng,MF,,Crystal Palace,Premier League,19,2004,14.4,48,32,18,22,8,23,46,50.0,23,17,3,14,20,68,24
2761,Ethan Wheatley,eng,FW,,Manchester Utd,Premier League,17,2006,0.2,1,1,0,1,0,1,1,100.0,0,2,0,2,2,3,0
2762,Ben White,eng,DF,,Arsenal,Premier League,25,1997,33.2,48,28,20,22,6,26,58,44.8,32,48,22,26,32,80,77
2763,Joe White,eng,MF,,Newcastle Utd,Premier League,20,2002,0.1,1,1,1,0,0,0,0,,0,0,0,0,0,1,0
2764,Silvan Widmer,ch,DF,,Mainz 05,Bundesliga,30,1993,13.8,23,10,12,8,3,17,28,60.7,11,18,5,13,16,39,37
2765,Mateusz Wieteska,pl,DF,,Cagliari,Serie A,26,1997,10.7,14,11,9,3,2,3,10,30.0,7,10,5,5,14,28,48
2766,Mateusz Wieteska,pl,DF,,Clermont Foot,Ligue 1,26,1997,1.9,4,1,3,1,0,3,5,60.0,2,4,2,2,5,9,8
2767,Iñaki Williams,gh,FW,,Athletic Club,La Liga,29,1994,31.6,24,17,6,8,10,13,34,38.2,21,42,8,34,14,38,29
2768,Neco Williams,wls,DF,,Nott'ham Forest,Premier League,22,2001,18.2,69,40,42,18,9,35,56,62.5,21,44,13,31,22,91,53
2769,Nico Williams,es,FW,,Athletic Club,La Liga,21,2002,25.1,31,12,9,15,7,13,36,36.1,23,18,2,16,3,34,4
2770,Willian,br,FW,,Fulham,Premier League,34,1988,22.8,18,11,6,7,5,3,21,14.3,18,13,0,13,9,27,12
2771,Joe Willock,eng,MF,,Newcastle Utd,Premier League,23,1999,4.7,13,7,7,6,0,4,11,36.4,7,7,0,7,1,14,1
2772,Callum Wilson,eng,FW,,Newcastle Utd,Premier League,31,1992,11.0,5,3,0,2,3,0,4,0.0,4,6,0,6,2,7,4
2773,Harry Wilson,wls,FW,,Fulham,Premier League,26,1997,18.0,21,14,9,8,4,11,28,39.3,17,27,3,24,10,31,12
2774,Josh Wilson-Esbrand,eng,DF,MF,Reims,Ligue 1,20,2002,5.1,5,4,2,3,0,2,8,25.0,6,5,2,3,6,11,7
2775,Patrick Wimmer,at,FW,MF,Wolfsburg,Bundesliga,22,2001,6.5,14,5,5,5,4,8,18,44.4,10,14,0,14,3,17,7
2776,Jonas Wind,dk,FW,,Wolfsburg,Bundesliga,24,1999,29.5,13,10,4,6,3,7,17,41.2,10,13,4,9,3,16,21
2777,Florian Wirtz,de,MF,,Leverkusen,Bundesliga,20,2003,26.4,27,18,7,14,6,9,29,31.0,20,36,2,34,9,36,3
2778,Yoane Wissa,cd,FW,,Brentford,Premier League,26,1996,27.7,28,16,13,10,5,5,20,25.0,15,24,3,21,9,37,15
2779,Axel Witsel,be,DF,,Atlético Madrid,La Liga,34,1989,30.9,35,21,23,12,0,17,24,70.8,7,40,21,19,16,51,119
2780,Maximilian Wittek,de,DF,FW,Bochum,Bundesliga,27,1995,11.9,23,17,9,11,3,13,21,61.9,8,12,1,11,18,41,23
2781,Maximilian Wöber,at,DF,,Gladbach,Bundesliga,25,1998,23.0,66,31,40,25,1,31,53,58.5,22,47,26,21,38,104,111
2782,Marius Wolf,de,DF,,Dortmund,Bundesliga,28,1995,13.0,20,12,8,11,1,11,23,47.8,12,12,2,10,8,28,20
2783,Nick Woltemade,de,FW,MF,Werder Bremen,Bundesliga,21,2002,13.2,34,23,7,20,7,15,21,71.4,6,12,0,12,5,39,17
2784,Jeong Woo-yeong,kr,MF,FW,Stuttgart,Bundesliga,23,1999,7.0,15,9,6,8,1,6,8,75.0,2,5,0,5,7,22,5
2785,Chris Wood,nz,FW,,Nott'ham Forest,Premier League,31,1991,20.1,7,4,1,4,2,3,9,33.3,6,11,3,8,1,8,26
2786,Cauley Woodrow,eng,FW,MF,Luton Town,Premier League,28,1994,4.7,16,10,8,4,4,9,16,56.3,7,7,1,6,1,17,14
2787,Christopher Wooh,cm,DF,,Rennes,Ligue 1,21,2001,15.4,18,12,12,6,0,8,15,53.3,7,19,9,10,18,36,51
2788,Joe Worrall,eng,DF,,Nott'ham Forest,Premier League,26,1997,4.9,7,5,6,1,0,3,6,50.0,3,5,4,1,3,10,32
2789,Xeber,es,FW,MF,Alavés,La Liga,26,1997,3.4,5,5,3,2,0,3,7,42.9,4,2,1,1,1,6,2
2790,Granit Xhaka,ch,MF,,Leverkusen,Bundesliga,30,1992,31.3,29,21,11,14,4,9,30,30.0,21,29,8,21,19,48,42
2791,Antal Yaakobishvili,hu,DF,,Girona,La Liga,19,2004,0.7,2,1,1,1,0,1,1,100.0,0,0,0,0,3,5,3
2792,Lamine Yamal,es,FW,,Barcelona,La Liga,16,2007,24.5,61,37,32,15,14,18,48,37.5,30,32,0,32,19,80,11
2793,Roman Yaremchuk,ua,FW,,Valencia,La Liga,27,1995,10.3,5,2,1,2,2,3,6,50.0,3,4,0,4,1,6,9
2794,Yehor Yarmoliuk,ua,MF,,Brentford,Premier League,19,2004,7.6,17,11,6,8,3,7,17,41.2,10,17,4,13,6,23,5
2795,Ryan Yates,eng,MF,,Nott'ham Forest,Premier League,25,1997,22.1,66,39,39,21,6,19,34,55.9,15,42,15,27,21,87,44
2796,Yusuf Yazıcı,tr,MF,FW,Lille,Ligue 1,26,1997,14.6,19,11,6,9,4,4,15,26.7,11,10,1,9,5,24,5
2797,Kelvin Yeboah,it,FW,,Montpellier,Ligue 1,23,2000,3.1,4,2,2,2,0,1,3,33.3,2,3,2,1,1,5,3
2798,Bertuğ Yıldırım,tr,FW,,Rennes,Ligue 1,21,2002,5.2,7,5,2,3,2,3,8,37.5,5,8,0,8,0,7,4
2799,Kenan Yıldız,tr,FW,MF,Juventus,Serie A,18,2005,10.6,13,9,5,6,2,4,8,50.0,4,6,0,6,1,14,4
2800,Darlin Yongwa,cm,DF,,Lorient,Ligue 1,22,2000,12.9,30,23,17,11,2,14,25,56.0,11,14,2,12,15,45,36
2801,Leny Yoro,fr,DF,,Lille,Ligue 1,17,2005,29.7,36,25,27,7,2,17,31,54.8,14,20,14,6,36,72,97
2802,Ashley Young,eng,DF,MF,Everton,Premier League,38,1985,25.3,53,38,28,19,6,30,54,55.6,24,24,6,18,22,75,50
2803,Etienne Youte Kinkoue,fr,DF,,Le Havre,Ligue 1,21,2002,21.6,15,9,13,2,0,7,11,63.6,4,21,16,5,44,59,104
2804,Illia Zabarnyi,ua,DF,,Bournemouth,Premier League,20,2002,37.0,59,32,29,29,1,23,50,46.0,27,53,34,19,33,92,143
2805,Mattia Zaccagni,it,FW,MF,Lazio,Serie A,28,1995,21.7,27,16,11,15,1,9,21,42.9,12,26,2,24,21,48,15
2806,Dan-Axel Zagadou,fr,DF,,Stuttgart,Bundesliga,24,1999,16.1,21,14,16,5,0,4,8,50.0,4,23,18,5,20,41,78
2807,Yoram Zague,fr,DF,,Paris S-G,Ligue 1,17,2006,4.1,18,8,11,4,3,11,24,45.8,13,3,0,3,4,22,9
2808,Warren Zaïre-Emery,fr,MF,DF,Paris S-G,Ligue 1,17,2006,21.8,51,28,18,24,9,28,51,54.9,23,32,8,24,15,66,22
2809,Denis Zakaria,ch,MF,DF,Monaco,Ligue 1,26,1996,23.7,38,27,11,20,7,12,30,40.0,18,39,13,26,47,85,41
2810,Arsen Zakharyan,ru,MF,FW,Real Sociedad,La Liga,20,2003,13.6,22,15,8,11,3,9,22,40.9,13,16,0,16,4,26,10
2811,Joseba Zaldúa,es,DF,,Cádiz,La Liga,31,1992,7.8,20,12,17,2,1,13,21,61.9,8,6,4,2,2,22,20
2812,Nicola Zalewski,pl,DF,FW,Roma,Serie A,21,2002,10.8,20,14,10,9,1,8,22,36.4,14,12,4,8,9,29,17
2813,Andre-Frank Zambo Anguissa,cm,MF,,Napoli,Serie A,27,1995,31.0,61,33,21,29,11,34,69,49.3,35,40,5,35,28,89,19
2814,Nicolò Zaniolo,it,FW,MF,Aston Villa,Premier League,24,1999,9.3,19,9,10,7,2,9,17,52.9,8,13,0,13,1,20,11
2815,Alessandro Zanoli,it,DF,,Salernitana,Serie A,22,2000,10.2,16,13,9,7,0,7,12,58.3,5,10,2,8,1,17,17
2816,Alessandro Zanoli,it,DF,FW,Napoli,Serie A,22,2000,0.6,1,1,1,0,0,0,0,,0,0,0,0,1,2,1
2817,Duván Zapata,co,FW,,Torino,Serie A,32,1991,32.0,18,7,9,2,7,3,12,25.0,9,20,6,14,7,25,26
2818,Duván Zapata,co,FW,,Atalanta,Serie A,32,1991,1.2,0,0,0,0,0,0,1,0.0,1,0,0,0,0,0,1
2819,Gabriele Zappa,it,DF,,Cagliari,Serie A,23,1999,28.5,54,31,29,16,9,29,41,70.7,12,29,5,24,20,74,75
2820,Davide Zappacosta,it,DF,,Atalanta,Serie A,31,1992,20.7,30,20,15,10,5,16,34,47.1,18,29,4,25,5,35,19
2821,Bryan Zaragoza,es,MF,FW,Granada,La Liga,22,2001,18.2,18,9,8,6,4,8,23,34.8,15,9,0,9,3,21,3
2822,Bryan Zaragoza,es,FW,MF,Bayern Munich,Bundesliga,22,2001,2.0,4,4,2,1,1,3,3,100.0,0,0,0,0,2,6,0
2823,Anass Zaroury,ma,FW,MF,Burnley,Premier League,22,2000,1.7,1,0,1,0,0,0,4,0.0,4,2,0,2,0,1,1
2824,Oier Zarraga,es,MF,,Udinese,Serie A,24,1999,4.5,3,3,2,1,0,1,5,20.0,4,5,2,3,5,8,16
2825,Mehdi Zeffane,dz,DF,MF,Clermont Foot,Ligue 1,31,1992,13.7,31,20,17,11,3,17,34,50.0,17,14,3,11,16,47,34
2826,Jordan Zemura,zw,DF,,Udinese,Serie A,23,1999,11.5,24,16,13,7,4,11,19,57.9,8,5,1,4,13,37,21
2827,Robin Zentner,de,GK,,Mainz 05,Bundesliga,28,1994,30.0,2,2,2,0,0,2,5,40.0,3,1,0,1,1,3,19
2828,Alessio Zerbin,it,DF,FW,Monza,Serie A,24,1999,7.6,18,10,13,2,3,4,13,30.8,9,16,3,13,3,21,5
2829,Alessio Zerbin,it,FW,DF,Napoli,Serie A,24,1999,1.7,5,2,1,3,1,2,7,28.6,5,1,0,1,0,5,0
2830,Kevin Zeroli,it,MF,,Milan,Serie A,18,2005,0.3,1,1,1,0,0,0,0,,0,1,0,1,0,1,1
2831,Cedric Zesiger,ch,DF,,Wolfsburg,Bundesliga,25,1998,18.2,19,9,13,4,2,10,22,45.5,12,32,21,11,15,34,88
2832,Michael Zetterer,de,GK,,Werder Bremen,Bundesliga,28,1995,27.0,3,1,3,0,0,3,3,100.0,0,0,0,0,0,3,7
2833,Nathan Zeze,fr,DF,,Nantes,Ligue 1,18,2005,11.4,11,6,9,2,0,7,14,50.0,7,12,3,9,12,23,47
2834,Edon Zhegrova,xk,FW,,Lille,Ligue 1,24,1999,25.4,32,18,9,15,8,14,36,38.9,22,17,1,16,8,40,8
2835,Piotr Zieliński,pl,MF,,Napoli,Serie A,29,1994,21.4,23,15,6,13,4,12,24,50.0,12,12,1,11,9,32,15
2836,David Zima,cz,DF,,Torino,Serie A,22,2000,1.0,1,1,1,0,0,0,0,,0,0,0,0,3,4,7
2837,Christoph Zimmermann,de,DF,,Darmstadt 98,Bundesliga,30,1993,13.6,33,21,26,7,0,19,39,48.7,20,21,14,7,21,54,66
2838,Oleksandr Zinchenko,ua,DF,,Arsenal,Premier League,26,1996,19.1,50,30,19,24,7,35,52,67.3,17,18,3,15,20,70,26
2839,Joshua Zirkzee,nl,FW,,Bologna,Serie A,22,2001,30.7,32,20,8,15,9,13,24,54.2,11,25,2,23,3,35,36
2840,Luc Zogbé,ci,DF,,Brest,Ligue 1,18,2005,0.1,0,0,0,0,0,0,1,0.0,1,1,1,0,1,1,0
2841,Simon Zoller,de,FW,MF,Bochum,Bundesliga,32,1991,0.5,0,0,0,0,0,0,0,,0,1,0,1,0,0,0
2842,Nadir Zortea,it,DF,,Frosinone,Serie A,24,1999,14.0,21,14,8,13,0,10,22,45.5,12,13,5,8,4,25,29
2843,Nadir Zortea,it,DF,,Atalanta,Serie A,24,1999,1.7,5,4,3,1,1,1,4,25.0,3,2,0,2,1,6,3
2844,Kurt Zouma,fr,DF,,West Ham,Premier League,28,1994,31.5,23,17,14,9,0,10,16,62.5,6,38,28,10,29,52,160
2845,Igor Zubeldia,es,DF,,Real Sociedad,La Liga,26,1997,28.0,32,25,20,10,2,19,26,73.1,7,28,19,9,32,64,97
2846,Martín Zubimendi,es,MF,,Real Sociedad,La Liga,24,1999,29.5,49,27,18,29,2,23,42,54.8,19,33,9,24,37,86,54
2847,Szymon Żurkowski,pl,MF,,Empoli,Serie A,25,1997,9.6,15,6,5,8,2,5,15,33.3,10,5,1,4,6,21,11
2848,Lovro Zvonarek,hr,FW,MF,Bayern Munich,Bundesliga,18,2005,1.8,0,0,0,0,0,0,5,0.0,5,3,0,3,0,0,2
2849,Martin Ødegaard,no,MF,,Arsenal,Premier League,24,1998,34.3,49,17,18,21,10,17,58,29.3,41,23,1,22,15,64,5
2850,Milan Đurić,ba,FW,,Hellas Verona,Serie A,33,1990,13.4,1,0,0,0,1,0,3,0.0,3,0,0,0,1,2,13
2851,Milan Đurić,ba,FW,,Monza,Serie A,33,1990,14.0,5,5,0,5,0,2,4,50.0,2,6,2,4,0,5,27
2852,Mateusz Łęgowski,pl,MF,,Salernitana,Serie A,20,2003,12.7,23,12,8,12,3,11,26,42.3,15,13,2,11,7,30,16
