Rk,Player,Nation,Pos,Squad,Comp,Age,Born,90s,Tkl,TklW,Def 3rd,Mid 3rd,Att 3rd,Tkl Att,Tkl%,Lost,Blocks,Sh,Pass,Int,Tkl+Int,Clr,Err
1,Ismael Aaneba,fr,DF,Strasbourg,Ligue 1,21,1999,0.1,0,0,0,0,0,0,0,,0,0,0,0,1,1,1
2,Patrick van Aanholt,nl,DF,Crystal Palace,Premier League,29,1990,19.7,35,22,18,17,0,19,43,44.2,24,18,6,12,30,65,40
3,Yunis Abdelhamid,ma,DF,Reims,Ligue 1,32,1987,32.1,59,37,36,23,0,26,42,61.9,16,34,15,19,61,120,132
4,Sabit Abdulai,gh,MF,Getafe,La Liga,21,1999,0.7,2,0,1,1,0,1,3,33.3,2,0,0,0,0,2,0
5,Mehdi Abeid,dz,MF,Nantes,Ligue 1,27,1992,14.7,34,19,16,14,4,15,30,50.0,15,9,2,7,20,54,10
6,Laurent Abergel,fr,MF,Lorient,Ligue 1,27,1993,32.9,145,84,64,69,12,54,162,33.3,108,64,6,58,46,191,12
7,Charles Abi,fr,FW,Saint-Étienne,Ligue 1,20,2000,10.1,8,2,5,0,3,3,12,25.0,9,6,2,4,4,12,5
8,Matthis Abline,fr,FW,Rennes,Ligue 1,17,2003,0.0,0,0,0,0,0,0,0,,0,0,0,0,0,0,0
9,Pape Abou Cissé,sn,DF,Saint-Étienne,Ligue 1,24,1995,14.0,15,13,10,5,0,6,10,60.0,4,7,4,3,27,42,87
10,David Abraham,ar,DF,Eint Frankfurt,Bundesliga,34,1986,13.6,18,12,13,3,2,11,17,64.7,6,13,4,9,17,35,34
11,Tammy Abraham,eng,FW,Chelsea,Premier League,22,1997,11.6,7,5,3,3,1,1,7,14.3,6,6,0,6,5,12,17
12,Amir Abrashi,al,MF,Freiburg,Bundesliga,30,1990,0.7,1,1,1,0,0,0,0,,0,1,1,0,2,3,1
13,Gennaro Acampora,it,MF,Spezia,it Serie A,26,1994,4.9,6,4,1,4,1,2,7,28.6,5,4,1,3,4,10,4
14,Francesco Acerbi,it,DF,Lazio,it Serie A,32,1988,31.3,51,32,34,13,4,18,40,45.0,22,24,15,9,76,127,121
15,Ragnar Ache,de,FW,Eint Frankfurt,Bundesliga,22,1998,1.1,2,0,0,1,1,0,0,,0,1,0,1,1,3,1
16,Marcos Acuña,ar,DF,Sevilla,La Liga,28,1991,25.9,62,42,34,20,8,23,41,56.1,18,23,2,21,23,85,30
17,Che Adams,sct,FW,Southampton,Premier League,24,1996,29.6,25,16,4,15,6,6,17,35.3,11,20,2,18,4,29,19
18,Tyler Adams,us,MF,RB Leipzig,Bundesliga,21,1999,20.6,35,24,12,15,8,17,31,54.8,14,22,5,17,29,64,30
19,Sargis Adamyan,am,FW,Hoffenheim,Bundesliga,27,1993,5.3,9,4,4,3,2,7,14,50.0,7,2,0,2,6,15,1
20,Tosin Adarabioyo,eng,DF,Fulham,Premier League,22,1997,32.8,37,19,30,6,1,19,40,47.5,21,26,20,6,42,79,197
21,Bobby Adekanye,nl,FW,Cádiz,La Liga,21,1999,0.4,0,0,0,0,0,0,1,0.0,1,0,0,0,0,0,1
22,Yacine Adli,fr,MF,Bordeaux,Ligue 1,20,2000,26.9,74,37,30,33,11,35,92,38.0,57,27,2,25,39,113,17
23,Andrea Adorante,it,FW,Parma,it Serie A,20,2000,0.1,0,0,0,0,0,0,0,,0,0,0,0,0,0,0
24,Adrián,es,GK,Liverpool,Premier League,33,1987,3.0,0,0,0,0,0,0,0,,0,0,0,0,0,0,3
25,Martin Agirregabiria,es,DF,Alavés,La Liga,24,1996,17.3,32,18,17,12,3,17,33,51.5,16,9,3,6,27,59,36
26,Lucien Agoume,fr,MF,Spezia,it Serie A,18,2002,8.9,18,10,11,7,0,6,19,31.6,13,10,5,5,15,33,10
27,Felix Agu,de,DF,Werder Bremen,Bundesliga,20,1999,7.8,20,9,10,9,1,10,18,55.6,8,14,3,11,12,32,18
28,Kevin Agudelo,co,FW,Spezia,it Serie A,21,1998,15.1,39,28,9,15,15,12,34,35.3,22,30,0,30,10,49,2
29,Nayef Aguerd,ma,DF,Rennes,Ligue 1,24,1996,35.0,37,30,28,9,0,21,33,63.6,12,34,22,12,47,84,102
30,Sergio Agüero,ar,FW,Manchester City,Premier League,32,1988,6.2,4,1,0,2,2,2,11,18.2,9,2,0,2,2,6,0
31,Ruben Aguilar,fr,DF,Monaco,Ligue 1,27,1993,24.7,63,37,32,21,10,32,52,61.5,20,30,3,27,47,110,43
32,Naouirou Ahamada,fr,MF,Stuttgart,Bundesliga,18,2002,2.8,4,1,3,1,0,1,1,100.0,0,2,0,2,1,5,1
33,Matteo Ahlinvi,bj,MF,Nîmes,Ligue 1,21,1999,10.0,26,20,10,14,2,11,39,28.2,28,6,0,6,2,28,8
34,Jean-Eudes Aholou,ci,MF,Strasbourg,Ligue 1,26,1994,23.8,46,25,18,25,3,19,48,39.6,29,17,5,12,53,99,32
35,Jean-Eudes Aholou,ci,MF,Monaco,Ligue 1,26,1994,0.4,1,0,0,1,0,1,3,33.3,2,0,0,0,1,2,1
36,Joseph Aidoo,gh,DF,Celta Vigo,La Liga,24,1995,14.3,26,17,17,9,0,12,21,57.1,9,7,4,3,25,51,88
37,Ola Aina,ng,DF,Fulham,Premier League,23,1996,29.6,37,20,22,7,8,21,43,48.8,22,22,6,16,45,82,94
38,Rayan Aït-Nouri,dz,DF,Wolves,Premier League,19,2001,15.6,29,16,18,10,1,13,27,48.1,14,14,1,13,15,44,25
39,Rayan Aït-Nouri,dz,DF,Angers,Ligue 1,19,2001,2.1,3,2,1,2,0,3,5,60.0,2,2,1,1,4,7,1
40,Semi Ajayi,ng,DF,West Brom,Premier League,26,1993,30.9,40,14,34,6,0,23,41,56.1,18,51,32,19,42,82,122
41,Ludovic Ajorque,fr,FW,Strasbourg,Ligue 1,26,1994,33.0,30,18,6,18,6,7,31,22.6,24,14,5,9,11,41,54
42,Manuel Akanji,ch,DF,Dortmund,Bundesliga,25,1995,26.1,41,22,23,12,6,19,31,61.3,12,23,10,13,49,90,70
43,Carlos Akapo,gq,DF,Cádiz,La Liga,27,1993,9.6,18,14,14,4,0,10,18,55.6,8,16,3,13,19,37,33
44,Marley Aké,fr,FW,Marseille,Ligue 1,19,2001,1.6,3,3,1,0,2,0,1,0.0,1,2,0,2,0,3,1
45,Nathan Aké,nl,DF,Manchester City,Premier League,25,1995,8.9,10,5,3,6,1,3,4,75.0,1,2,1,1,9,19,23
46,Paul Akouokou,ci,MF,Betis,La Liga,22,1997,4.2,11,8,2,8,1,5,8,62.5,3,3,1,2,6,17,7
47,Jean-Daniel Akpa-Akpro,ci,MF,Lazio,it Serie A,27,1992,11.7,38,25,13,22,3,8,27,29.6,19,24,6,18,18,56,13
48,Kevin Akpoguma,ng,DF,Hoffenheim,Bundesliga,25,1995,13.2,18,12,11,6,1,8,14,57.1,6,28,15,13,13,31,32
49,David Alaba,at,DF,Bayern Munich,Bundesliga,28,1992,29.7,37,21,14,19,4,17,32,53.1,15,29,13,16,43,80,60
50,Sofiane Alakouch,ma,DF,Nîmes,Ligue 1,22,1998,16.7,53,33,30,16,7,29,45,64.4,16,17,2,15,21,74,38
51,Jony Álamo,es,MF,Elche,La Liga,18,2001,0.8,2,1,1,0,1,0,1,0.0,1,0,0,0,1,3,0
52,Lucas Alario,ar,FW,Leverkusen,Bundesliga,27,1992,13.8,8,2,2,5,1,2,4,50.0,2,9,1,8,2,10,10
53,Jordi Alba,es,DF,Barcelona,La Liga,31,1989,33.6,45,30,22,16,7,24,52,46.2,28,21,2,19,49,94,48
54,Luis Alberto,es,MF,Lazio,it Serie A,27,1992,29.1,43,24,15,19,9,15,73,20.5,58,41,2,39,13,56,11
55,Raúl Albiol,es,DF,Villarreal,La Liga,34,1985,34.6,22,15,19,3,0,13,18,72.2,5,32,22,10,22,44,146
56,Marc Albrighton,eng,DF,Leicester City,Premier League,30,1989,19.4,33,19,14,15,4,16,45,35.6,29,29,3,26,17,50,27
57,Paco Alcácer,es,FW,Villarreal,La Liga,26,1993,17.2,6,3,1,2,3,3,7,42.9,4,8,0,8,9,15,6
58,Pedro Alcalá,es,DF,Cádiz,La Liga,31,1989,10.1,8,4,6,2,0,3,5,60.0,2,19,13,6,16,24,50
59,Thiago Alcántara,es,MF,Liverpool,Premier League,29,1991,20.6,61,36,20,30,11,17,49,34.7,32,26,0,26,30,91,14
60,Rubén Alcaraz,es,MF,Valladolid,La Liga,29,1991,24.1,54,29,32,21,1,30,80,37.5,50,35,8,27,31,85,28
61,Omar Alderete,py,DF,Hertha BSC,Bundesliga,23,1996,14.4,16,10,11,5,0,7,16,43.8,9,14,10,4,21,37,61
62,Toby Alderweireld,be,DF,Tottenham,Premier League,31,1989,24.9,35,22,22,11,2,18,30,60.0,12,40,28,12,10,45,121
63,Iván Alejo,es,MF,Cádiz,La Liga,25,1995,9.2,14,10,8,4,2,4,23,17.4,19,14,1,13,3,17,10
64,Carles Aleñá,es,MF,Barcelona,La Liga,22,1998,0.5,1,0,1,0,0,0,0,,0,0,0,0,0,1,0
65,Carles Aleñá,es,MF,Getafe,La Liga,22,1998,15.2,15,10,3,9,3,7,25,28.0,18,14,1,13,2,17,2
66,Rúnar Alex Rúnarsson,is,GK,Arsenal,Premier League,25,1995,0.2,0,0,0,0,0,0,0,,0,0,0,0,0,0,0
67,Trent Alexander-Arnold,eng,DF,Liverpool,Premier League,21,1998,33.7,56,33,31,18,7,36,56,64.3,20,24,3,21,49,105,50
68,Alfon,es,MF,Celta Vigo,La Liga,21,1999,0.4,0,0,0,0,0,0,0,,0,0,0,0,0,0,0
69,Mohamed Ali Cho,fr,FW,Angers,Ligue 1,16,2004,3.9,9,7,2,6,1,4,9,44.4,5,4,0,4,3,12,0
70,Ezgjan Alioski,mk,DF,Leeds United,Premier League,28,1992,27.3,74,31,38,28,8,32,74,43.2,42,17,2,15,23,97,50
71,Rachid Alioui,ma,FW,Angers,Ligue 1,28,1992,0.2,0,0,0,0,0,0,1,0.0,1,0,0,0,0,0,0
72,Alisson,br,GK,Liverpool,Premier League,27,1992,33.0,3,2,3,0,0,3,4,75.0,1,0,0,0,2,5,26
73,Saturnin Allagbé,bj,GK,Dijon,Ligue 1,26,1993,12.0,0,0,0,0,0,0,1,0.0,1,0,0,0,0,0,9
74,Allan,br,MF,Everton,Premier League,29,1991,22.8,80,45,39,37,4,28,95,29.5,67,31,12,19,19,99,25
75,Dele Alli,eng,MF,Tottenham,Premier League,24,1996,6.9,18,11,8,6,4,7,19,36.8,12,9,0,9,7,25,3
76,Miguel Almirón,py,MF,Newcastle Utd,Premier League,26,1994,27.0,49,29,21,25,3,14,56,25.0,42,23,4,19,25,74,20
77,Marcos Alonso,es,DF,Chelsea,Premier League,29,1990,10.7,13,3,6,4,3,7,14,50.0,7,12,1,11,12,25,30
78,Sergio Álvarez,es,MF,Eibar,La Liga,28,1992,17.4,42,25,13,26,3,8,22,36.4,14,22,5,17,22,64,24
79,Yeray Álvarez,es,DF,Athletic Club,La Liga,25,1995,21.6,19,12,11,8,0,9,21,42.9,12,12,5,7,53,72,73
80,Bruno Alves,pt,DF,Parma,it Serie A,38,1981,18.1,13,10,10,3,0,7,9,77.8,2,17,12,5,26,39,81
81,Steven Alzate,co,MF,Brighton,Premier League,21,1998,10.0,17,8,10,4,3,6,15,40.0,9,8,1,7,8,25,10
82,Ibrahim Amadou,fr,MF,Angers,Ligue 1,27,1993,16.7,39,26,18,19,2,15,38,39.5,23,14,4,10,23,62,25
83,Romain Amalfitano,fr,FW,Dijon,Ligue 1,30,1989,1.3,4,2,3,1,0,1,3,33.3,2,2,1,1,1,5,1
84,Emmanuel Amankwaa Akurugu,gh,DF,Getafe,La Liga,18,2001,0.5,0,0,0,0,0,0,1,0.0,1,1,0,1,2,2,1
85,Daniel Amartey,gh,DF,Leicester City,Premier League,25,1994,8.0,11,7,6,4,1,8,12,66.7,4,8,4,4,12,23,26
86,Jordan Amavi,fr,DF,Marseille,Ligue 1,26,1994,9.0,11,9,9,1,1,9,12,75.0,3,12,2,10,27,38,33
87,Thierry Ambrose,gp,FW,Metz,Ligue 1,23,1997,8.4,7,4,1,1,5,2,12,16.7,10,2,0,2,2,9,4
88,Wisdom Amey,it,DF,Bologna,it Serie A,14,2005,0.0,0,0,0,0,0,0,0,,0,0,0,0,0,0,0
89,Nadiem Amiri,de,MF,Leverkusen,Bundesliga,23,1996,21.0,12,7,4,8,0,7,33,21.2,26,18,3,15,12,24,7
90,Ethan Ampadu,wls,DF,Sheffield Utd,Premier League,19,2000,23.2,57,36,31,24,2,20,46,43.5,26,40,19,21,49,106,87
91,Sofyan Amrabat,ma,MF,Fiorentina,it Serie A,23,1996,27.1,39,22,11,24,4,18,48,37.5,30,30,5,25,23,62,12
92,Jon Ander Garrido,es,MF,Cádiz,La Liga,30,1989,8.9,18,10,8,7,3,10,26,38.5,16,12,4,8,14,32,13
93,Joachim Andersen,dk,DF,Fulham,Premier League,24,1996,30.3,33,19,18,11,4,15,28,53.6,13,24,13,11,44,77,151
94,Joachim Andersen,dk,DF,Lyon,Ligue 1,24,1996,2.1,2,1,1,1,0,2,2,100.0,0,1,1,0,2,4,6
95,Djavan Anderson,nl,DF,Lazio,it Serie A,25,1995,0.8,0,0,0,0,0,0,1,0.0,1,1,0,1,1,1,0
96,Elliot Anderson,eng,MF,Newcastle Utd,Premier League,17,2002,0.0,0,0,0,0,0,0,0,,0,0,0,0,0,0,0
97,Felipe Anderson,br,FW,West Ham,Premier League,27,1993,0.0,1,1,0,1,0,0,0,,0,0,0,0,0,1,0
98,Sebastian Andersson,se,FW,Köln,Bundesliga,29,1991,12.5,3,2,0,3,0,1,8,12.5,7,10,3,7,2,5,9
99,Nícolas Andrade,br,GK,Udinese,it Serie A,32,1988,2.0,0,0,0,0,0,0,0,,0,0,0,0,0,0,0
100,Benjamin André,fr,MF,Lille,Ligue 1,29,1990,32.1,114,68,47,61,6,53,122,43.4,69,39,10,29,76,190,49
101,Marcos André,br,FW,Valladolid,La Liga,23,1996,13.1,8,2,2,2,4,0,8,0.0,8,15,2,13,2,10,9
102,Robert Andrich,de,MF,Union Berlin,Bundesliga,25,1994,28.1,51,24,22,27,2,24,53,45.3,29,40,6,34,51,102,31
103,Victorien Angban,ci,MF,Metz,Ligue 1,23,1996,18.6,36,24,17,15,4,17,42,40.5,25,17,4,13,19,55,9
104,Ángel,es,GK,Granada,La Liga,18,2002,1.0,0,0,0,0,0,0,0,,0,0,0,0,0,0,1
105,José Ángel,es,DF,Eibar,La Liga,30,1989,10.0,15,8,9,4,2,8,12,66.7,4,7,0,7,13,28,17
106,Miguel Ángel Rubio,es,DF,Valladolid,La Liga,22,1998,1.5,0,0,0,0,0,0,0,,0,2,2,0,3,3,11
107,Angeliño,es,DF,RB Leipzig,Bundesliga,23,1997,24.0,31,19,10,18,3,13,24,54.2,11,22,1,21,30,61,40
108,Davide Angelo Ghislandi,it,DF,Atalanta,it Serie A,19,2001,0.1,0,0,0,0,0,0,0,,0,0,0,0,0,0,1
109,Philip Ankhrah,gh,MF,Hellas Verona,it Serie A,17,2002,0.1,0,0,0,0,0,0,0,,0,1,0,1,0,0,0
110,Cristian Ansaldi,ar,DF,Torino,it Serie A,33,1986,21.6,48,33,25,14,9,24,38,63.2,14,21,7,14,16,64,38
111,Waldemar Anton,de,DF,Stuttgart,Bundesliga,24,1996,30.1,31,20,17,14,0,12,31,38.7,19,28,18,10,47,78,114
112,Michail Antonio,jm,FW,West Ham,Premier League,30,1990,21.9,7,4,1,5,1,1,7,14.3,6,20,3,17,7,14,7
113,José Antonio Miranda,gq,MF,Getafe,La Liga,22,1998,0.3,0,0,0,0,0,0,1,0.0,1,1,0,1,0,0,0
114,Valentin Antov,bg,DF,Bologna,it Serie A,19,2000,2.6,4,2,3,1,0,3,10,30.0,7,6,5,1,4,8,13
115,Houssem Aouar,dz,MF,Lyon,Ligue 1,22,1998,19.8,17,12,0,13,4,8,25,32.0,17,17,1,16,17,34,4
116,Adil Aouchiche,fr,MF,Saint-Étienne,Ligue 1,18,2002,19.2,38,20,12,17,9,13,49,26.5,36,15,1,14,10,48,6
117,Dennis Appiah,fr,DF,Nantes,Ligue 1,28,1992,17.3,55,34,33,15,7,32,59,54.2,27,23,6,17,25,80,43
118,Aritz Arambarri,es,DF,Real Sociedad,La Liga,22,1998,0.3,1,1,0,1,0,1,2,50.0,1,0,0,0,0,1,0
119,Mauro Arambarri,uy,MF,Getafe,La Liga,24,1995,33.1,64,39,22,35,7,23,80,28.8,57,40,5,35,42,106,28
120,Charles Aránguiz,cl,MF,Leverkusen,Bundesliga,31,1989,18.5,41,23,16,21,4,17,43,39.5,26,32,4,28,33,74,17
121,Luiz Araújo,br,MF,Lille,Ligue 1,24,1996,16.6,38,25,12,18,8,8,28,28.6,20,23,1,22,11,49,3
122,Néstor Araujo,mx,DF,Celta Vigo,La Liga,28,1991,27.0,24,16,14,9,1,7,15,46.7,8,23,18,5,43,67,89
123,Ronald Araújo,uy,DF,Barcelona,La Liga,21,1999,16.8,22,11,12,8,2,9,9,100.0,0,24,15,9,20,42,47
124,Anaitz Arbilla,es,DF,Eibar,La Liga,33,1987,31.2,45,26,31,11,3,27,54,50.0,27,36,11,25,69,114,73
125,Alphonse Areola,fr,GK,Fulham,Premier League,27,1993,36.0,1,0,1,0,0,1,5,20.0,4,0,0,0,1,2,13
126,Santiago Arias,co,DF,Leverkusen,Bundesliga,28,1992,1.0,2,1,0,1,1,1,1,100.0,0,0,0,0,1,3,4
127,Karim Aribi,dz,FW,Nîmes,Ligue 1,26,1994,3.3,2,2,0,1,1,0,5,0.0,5,1,0,1,0,2,3
128,Unai Arietaleanizbeaskoa,es,FW,Eibar,La Liga,21,1999,0.5,1,0,0,0,1,0,0,,0,0,0,0,0,1,0
129,Nicolò Armini,it,DF,Lazio,it Serie A,19,2001,0.1,0,0,0,0,0,0,0,,0,0,0,0,0,0,0
130,Stuart Armstrong,sct,MF,Southampton,Premier League,28,1992,30.7,60,41,19,32,9,27,75,36.0,48,26,1,25,24,84,19
131,Maximilian Arnold,de,MF,Wolfsburg,Bundesliga,26,1994,28.7,47,32,20,26,1,18,49,36.7,31,24,3,21,49,96,57
132,Tolu Arokodare,ng,FW,Köln,Bundesliga,19,2000,1.2,1,1,0,0,1,0,0,,0,1,0,1,1,2,0
133,Sergio Arribas,es,MF,Real Madrid,La Liga,18,2001,1.5,3,1,2,1,0,1,3,33.3,2,2,0,2,4,7,2
134,Kepa Arrizabalaga,es,GK,Chelsea,Premier League,25,1994,6.5,0,0,0,0,0,0,1,0.0,1,0,0,0,0,0,0
135,Tolgay Arslan,de,MF,Udinese,it Serie A,29,1990,20.2,52,32,24,24,4,25,54,46.3,29,22,2,20,22,74,15
136,Kwadwo Asamoah,gh,DF,Cagliari,it Serie A,31,1988,2.5,4,3,2,2,0,2,3,66.7,1,5,1,4,4,8,2
137,Santiago Ascacíbar,ar,MF,Hertha BSC,Bundesliga,23,1997,8.5,30,15,15,14,1,15,28,53.6,13,23,2,21,13,43,14
138,Sergio Asenjo,es,GK,Villarreal,La Liga,31,1989,36.0,0,0,0,0,0,0,1,0.0,1,0,0,0,0,0,13
139,Marco Asensio,es,FW,Real Madrid,La Liga,24,1996,20.8,12,6,7,4,1,3,24,12.5,21,15,0,15,11,23,10
140,Kristoffer Askildsen,no,MF,Sampdoria,it Serie A,19,2001,1.1,0,0,0,0,0,0,0,,0,2,0,2,3,3,3
141,Iago Aspas,es,FW,Celta Vigo,La Liga,32,1987,31.8,11,3,2,7,2,2,23,8.7,21,25,2,23,16,27,21
142,Roger Assalé,ci,FW,Dijon,Ligue 1,26,1993,9.2,10,8,3,5,2,4,12,33.3,8,7,3,4,2,12,2
143,Youcef Atal,dz,DF,Nice,Ligue 1,24,1996,10.6,25,12,11,14,0,13,26,50.0,13,10,2,8,26,51,12
144,Miguel Atienza,es,MF,Eibar,La Liga,21,1999,9.3,20,9,5,15,0,8,23,34.8,15,14,1,13,9,29,12
145,Pierre-Emerick Aubameyang,ga,FW,Arsenal,Premier League,31,1989,25.9,12,8,7,4,1,3,20,15.0,17,18,0,18,7,19,17
146,Emil Audero,it,GK,Sampdoria,it Serie A,23,1997,37.0,1,1,1,0,0,1,2,50.0,1,0,0,0,1,2,16
147,Tommaso Augello,it,DF,Sampdoria,it Serie A,25,1994,35.7,42,30,27,10,5,23,39,59.0,16,22,2,20,32,74,76
148,Jean-Kévin Augustin,fr,FW,Nantes,Ligue 1,23,1997,0.4,2,0,0,2,0,2,2,100.0,0,0,0,0,0,2,0
149,Ludwig Augustinsson,se,DF,Werder Bremen,Bundesliga,26,1994,21.7,37,20,19,14,4,17,29,58.6,12,21,7,14,20,57,62
150,Serge Aurier,ci,DF,Tottenham,Premier League,27,1992,17.8,55,33,33,17,5,15,40,37.5,25,28,5,23,19,74,44
151,Charlie Austin,eng,FW,West Brom,Premier League,31,1989,1.5,4,2,1,2,1,1,3,33.3,2,0,0,0,3,7,4
152,Ezequiel Ávila,ar,FW,Osasuna,La Liga,26,1994,2.2,6,2,3,1,2,2,4,50.0,2,1,0,1,1,7,0
153,Taiwo Awoniyi,ng,FW,Union Berlin,Bundesliga,22,1997,15.1,5,3,2,3,0,1,14,7.1,13,9,0,9,3,8,4
154,Mehmet Aydin,de,DF,Schalke 04,Bundesliga,18,2002,5.6,15,7,9,6,0,4,10,40.0,6,6,1,5,6,21,16
155,Jordan Ayew,gh,FW,Crystal Palace,Premier League,28,1991,23.3,38,26,8,16,14,16,44,36.4,28,28,2,26,16,54,12
156,Kaan Ayhan,tr,DF,Sassuolo,it Serie A,25,1994,8.8,15,9,8,5,2,8,13,61.5,5,9,5,4,16,31,33
157,Luke Ayling,eng,DF,Leeds United,Premier League,28,1991,37.8,108,61,69,30,9,49,87,56.3,38,53,36,17,36,144,96
158,Ramon Azeez,ng,MF,Granada,La Liga,27,1992,1.1,1,1,0,1,0,0,0,,0,0,0,0,1,2,1
159,César Azpilicueta,es,DF,Chelsea,Premier League,30,1989,24.3,53,28,22,24,7,19,37,51.4,18,30,5,25,28,81,62
160,Ludovic Baal,gf,DF,Brest,Ligue 1,34,1986,3.3,6,5,4,1,1,2,5,40.0,3,4,1,3,5,11,5
161,Carlos Bacca,co,FW,Villarreal,La Liga,33,1986,8.7,9,5,5,3,1,3,5,60.0,2,5,0,5,3,12,2
162,Loïc Bade,fr,DF,Lens,Ligue 1,20,2000,29.0,57,34,47,10,0,30,55,54.5,25,43,17,26,74,131,135
163,Milan Badelj,hr,MF,Genoa,it Serie A,31,1989,26.8,56,27,27,22,7,26,84,31.0,58,51,10,41,87,143,45
164,Édgar Badía,es,GK,Elche,La Liga,28,1992,30.0,1,0,1,0,0,1,3,33.3,2,0,0,0,0,1,17
165,Benoît Badiashile,fr,DF,Monaco,Ligue 1,19,2001,31.9,24,17,15,9,0,13,28,46.4,15,21,12,9,58,82,102
166,Alex Baena,es,MF,Villarreal,La Liga,19,2001,1.5,4,3,1,2,1,1,3,33.3,2,1,1,0,1,5,1
167,Miguel Baeza,es,MF,Celta Vigo,La Liga,20,2000,6.0,7,6,5,2,0,5,13,38.5,8,3,0,3,3,10,2
168,Stéphane Bahoken,cm,FW,Angers,Ligue 1,28,1992,18.0,9,6,1,7,1,4,12,33.3,8,9,0,9,9,18,9
169,Leon Bailey,jm,FW,Leverkusen,Bundesliga,22,1997,23.8,14,8,3,7,4,4,15,26.7,11,13,0,13,9,23,3
170,Eric Bailly,ci,DF,Manchester Utd,Premier League,26,1994,10.2,5,5,3,1,1,0,1,0.0,1,13,11,2,13,18,36
171,Stefan Bajic,fr,GK,Saint-Étienne,Ligue 1,18,2001,1.0,0,0,0,0,0,0,0,,0,0,0,0,0,0,1
172,Tiemoué Bakayoko,fr,MF,Napoli,it Serie A,25,1994,21.8,69,41,21,41,7,23,40,57.5,17,24,2,22,36,105,13
173,Mitchel Bakker,nl,DF,Paris S-G,Ligue 1,20,2000,18.8,38,30,15,14,9,17,26,65.4,9,22,2,20,22,60,20
174,Ridle Baku,de,FW,Wolfsburg,Bundesliga,22,1998,29.8,50,31,20,20,10,22,53,41.5,31,54,4,50,40,90,33
175,Ridle Baku,de,DF,Mainz 05,Bundesliga,22,1998,2.0,4,2,3,1,0,2,6,33.3,4,3,1,2,3,7,6
176,Dilane Bakwa,fr,FW,Bordeaux,Ligue 1,17,2002,0.6,2,2,1,1,0,0,1,0.0,1,2,0,2,1,3,0
177,Fabián Balbuena,py,DF,West Ham,Premier League,28,1991,13.3,24,12,23,1,0,14,23,60.9,9,23,6,17,25,49,63
178,Keita Baldé,sn,FW,Sampdoria,it Serie A,25,1995,13.3,9,6,2,6,1,4,10,40.0,6,10,1,9,0,9,3
179,George Baldock,gr,DF,Sheffield Utd,Premier League,27,1993,31.0,47,34,28,14,5,21,50,42.0,29,26,7,19,25,72,70
180,Gareth Bale,wls,FW,Tottenham,Premier League,31,1989,10.2,17,10,4,9,4,7,14,50.0,7,13,2,11,8,25,16
181,Mikel Balenziaga,es,DF,Athletic Club,La Liga,32,1988,18.8,26,15,11,12,3,9,18,50.0,9,22,7,15,7,33,46
182,Leonardo Balerdi,ar,DF,Marseille,Ligue 1,21,1999,18.2,29,18,19,7,3,14,31,45.2,17,17,9,8,28,57,65
183,Fodé Ballo-Touré,sn,DF,Monaco,Ligue 1,23,1997,7.4,21,17,9,11,1,6,13,46.2,7,7,0,7,6,27,11
184,Botond Balogh,hu,DF,Parma,it Serie A,18,2002,1.8,9,7,9,0,0,2,5,40.0,3,4,3,1,2,11,8
185,Abdoulaye Bamba,ci,DF,Angers,Ligue 1,30,1990,15.0,27,17,19,7,1,19,28,67.9,9,7,1,6,19,46,34
186,Jonathan Bamba,ci,MF,Lille,Ligue 1,24,1996,33.2,45,23,15,19,11,24,84,28.6,60,24,2,22,24,69,15
187,Robson Bambu,br,DF,Nice,Ligue 1,22,1997,11.6,16,11,14,2,0,11,14,78.6,3,8,7,1,10,26,57
188,Patrick Bamford,eng,FW,Leeds United,Premier League,26,1993,33.9,21,9,2,11,8,8,27,29.6,19,14,4,10,10,31,37
189,Mattia Bani,it,DF,Genoa,it Serie A,26,1993,10.2,10,5,5,5,0,5,12,41.7,7,16,11,5,27,37,44
190,Mattia Bani,it,DF,Parma,it Serie A,26,1993,12.7,20,11,15,4,1,4,8,50.0,4,10,6,4,33,53,50
191,Simon Banza,cd,FW,Lens,Ligue 1,23,1996,15.2,13,6,0,4,9,1,14,7.1,13,16,1,15,7,20,15
192,Antonín Barák,cz,MF,Hellas Verona,it Serie A,25,1994,30.7,30,19,8,16,6,14,47,29.8,33,26,7,19,12,42,38
193,Federico Barba,it,DF,Benevento,it Serie A,26,1993,29.5,31,16,22,8,1,21,35,60.0,14,39,18,21,48,79,94
194,Danilo Barbosa,br,DF,Nice,Ligue 1,24,1996,2.8,6,3,5,1,0,4,6,66.7,2,2,1,1,2,8,11
195,Barcia,es,DF,Granada,La Liga,19,2000,1.0,1,1,1,0,0,0,0,,0,1,1,0,3,4,9
196,Melvin Bard,fr,DF,Lyon,Ligue 1,19,2000,4.8,12,8,7,4,1,6,11,54.5,5,10,2,8,6,18,14
197,Enis Bardhi,mk,MF,Levante,La Liga,25,1995,18.7,28,12,8,16,4,10,36,27.8,26,8,2,6,21,49,14
198,Phil Bardsley,sct,DF,Burnley,Premier League,35,1985,3.0,6,5,4,2,0,3,6,50.0,3,3,1,2,6,12,12
199,Nicolò Barella,it,MF,Inter,it Serie A,23,1997,32.2,58,31,23,29,6,23,72,31.9,49,29,4,25,26,84,14
200,Philipp Bargfrede,de,MF,Werder Bremen,Bundesliga,31,1989,0.3,0,0,0,0,0,0,0,,0,0,0,0,0,0,3
201,Kike Barja,es,MF,Osasuna,La Liga,23,1997,15.9,10,5,6,1,3,5,24,20.8,19,10,1,9,16,26,8
202,Ross Barkley,eng,MF,Aston Villa,Premier League,26,1993,17.0,6,2,2,4,0,3,15,20.0,12,9,1,8,5,11,6
203,Ross Barkley,eng,FW,Chelsea,Premier League,26,1993,0.5,0,0,0,0,0,0,0,,0,0,0,0,0,0,0
204,Aymen Barkok,ma,MF,Eint Frankfurt,Bundesliga,22,1998,10.9,29,15,11,9,9,10,31,32.3,21,15,1,14,10,39,9
205,Ashley Barnes,eng,FW,Burnley,Premier League,30,1989,14.8,12,6,2,6,4,3,13,23.1,10,14,2,12,5,17,11
206,Harvey Barnes,eng,FW,Leicester City,Premier League,22,1997,21.6,19,9,11,3,5,5,22,22.7,17,16,3,13,8,27,11
207,Marc Baró,es,DF,Cádiz,La Liga,20,1999,1.0,2,1,2,0,0,0,2,0.0,2,1,0,1,2,4,2
208,Antonio Barragán,es,DF,Elche,La Liga,33,1987,24.8,28,14,21,5,2,12,21,57.1,9,22,8,14,33,61,67
209,Antonio Barreca,it,DF,Fiorentina,it Serie A,25,1995,0.9,1,0,0,1,0,1,1,100.0,0,0,0,0,0,1,1
210,Leandro Barreiro Martins,lu,MF,Mainz 05,Bundesliga,20,2000,25.6,58,32,19,26,13,20,50,40.0,30,34,9,25,57,115,55
211,Ander Barrenetxea,es,MF,Real Sociedad,La Liga,18,2001,14.5,29,19,5,18,6,9,24,37.5,15,20,0,20,6,35,8
212,Jacob Barrett Laursen,dk,DF,Arminia,Bundesliga,25,1994,12.3,23,12,13,8,2,10,16,62.5,6,14,4,10,24,47,37
213,Musa Barrow,gm,FW,Bologna,it Serie A,21,1998,32.5,26,10,8,10,8,10,25,40.0,15,37,2,35,11,37,15
214,Kyle Bartley,eng,DF,West Brom,Premier League,29,1991,28.7,27,16,14,10,3,11,23,47.8,12,50,35,15,38,65,159
215,Paolo Bartolomei,it,MF,Spezia,it Serie A,30,1989,3.6,6,2,3,1,2,4,7,57.1,3,1,0,1,1,7,2
216,Marc Bartra,es,DF,Betis,La Liga,29,1991,18.8,27,16,18,8,1,12,22,54.5,10,19,5,14,40,67,74
217,Daniele Baselli,it,MF,Torino,it Serie A,28,1992,4.4,12,7,3,6,3,6,10,60.0,4,2,0,2,9,21,5
218,Chris Basham,eng,DF,Sheffield Utd,Premier League,32,1988,28.6,69,42,41,23,5,41,67,61.2,26,36,15,21,49,118,105
219,Toma Bašić,hr,MF,Bordeaux,Ligue 1,23,1996,28.9,33,22,15,16,2,16,58,27.6,42,21,5,16,32,65,42
220,Álvaro Bastida,es,MF,Cádiz,La Liga,16,2004,0.4,0,0,0,0,0,0,0,,0,0,0,0,0,0,0
221,Alessandro Bastoni,it,DF,Inter,it Serie A,21,1999,32.5,36,22,13,21,2,17,27,63.0,10,34,16,18,40,76,75
222,Simone Bastoni,it,DF,Spezia,it Serie A,23,1996,16.9,50,29,26,22,2,27,52,51.9,25,19,1,18,16,66,31
223,Bastos,ao,DF,Lazio,it Serie A,29,1991,0.7,3,1,2,0,1,3,5,60.0,2,1,0,1,0,3,3
224,Michy Batshuayi,be,FW,Crystal Palace,Premier League,26,1993,8.1,5,3,1,2,2,1,9,11.1,8,5,1,4,4,9,5
225,Rodrigo Battaglia,ar,MF,Alavés,La Liga,29,1991,27.7,38,16,21,14,3,16,50,32.0,34,30,14,16,29,67,40
226,Cristian Battocchio,it,MF,Brest,Ligue 1,28,1992,3.9,5,2,1,4,0,2,9,22.2,7,0,0,0,4,9,5
227,Oliver Baumann,de,GK,Hoffenheim,Bundesliga,30,1990,31.0,0,0,0,0,0,0,1,0.0,1,0,0,0,2,2,14
228,Julian Baumgartlinger,at,MF,Leverkusen,Bundesliga,32,1988,11.9,43,20,14,26,3,16,31,51.6,15,12,0,12,12,55,10
229,Christoph Baumgartner,at,MF,Hoffenheim,Bundesliga,20,1999,26.3,44,31,13,24,7,14,51,27.5,37,40,8,32,24,68,24
230,Jon Bautista,es,FW,Real Sociedad,La Liga,25,1995,4.1,5,3,0,2,3,0,3,0.0,3,3,1,2,2,7,4
231,Paul Baysse,fr,DF,Bordeaux,Ligue 1,32,1988,29.0,35,18,21,13,1,16,21,76.2,5,33,24,9,52,87,123
232,Noah Joel Sarenren Bazee,ng,FW,Augsburg,Bundesliga,23,1996,0.4,0,0,0,0,0,0,1,0.0,1,0,0,0,1,1,0
233,Ihlas Bebou,tg,FW,Hoffenheim,Bundesliga,26,1994,24.4,24,9,5,10,9,8,14,57.1,6,18,4,14,17,41,16
234,Rodrigo Becão,br,DF,Udinese,it Serie A,24,1996,30.9,59,33,36,20,3,27,49,55.1,22,48,27,21,68,127,94
235,Sheraldo Becker,sr,FW,Union Berlin,Bundesliga,25,1995,12.3,5,4,2,2,1,3,5,60.0,2,4,0,4,6,11,7
236,Timo Becker,de,DF,Schalke 04,Bundesliga,23,1997,18.2,34,23,28,6,0,16,25,64.0,9,18,4,14,22,56,58
237,Jan Bednarek,pl,DF,Southampton,Premier League,24,1996,34.4,37,19,25,11,1,25,49,51.0,24,44,27,17,84,121,132
238,Donny van de Beek,nl,MF,Manchester Utd,Premier League,23,1997,5.8,15,10,2,11,2,7,15,46.7,8,10,1,9,6,21,7
239,Valon Behrami,ch,MF,Genoa,it Serie A,35,1985,9.9,21,9,9,10,2,9,26,34.6,17,13,5,8,9,30,13
240,Brian Behrendt,de,DF,Arminia,Bundesliga,28,1991,0.9,0,0,0,0,0,0,1,0.0,1,0,0,0,0,0,1
241,Maximilian Beier,de,FW,Hoffenheim,Bundesliga,17,2002,0.1,0,0,0,0,0,0,1,0.0,1,0,0,0,0,0,0
242,Ishak Belfodil,dz,FW,Hoffenheim,Bundesliga,28,1992,6.6,3,2,0,0,3,0,2,0.0,2,1,0,1,1,4,3
243,Erwan Belhadji,fr,MF,Dijon,Ligue 1,19,2001,0.3,3,0,3,0,0,3,5,60.0,2,1,0,1,0,3,0
244,Haris Belkebla,dz,MF,Brest,Ligue 1,26,1994,30.3,69,39,32,28,9,31,66,47.0,35,26,5,21,57,126,34
245,Stefan Bell,de,DF,Mainz 05,Bundesliga,28,1991,14.1,24,18,15,9,0,14,23,60.9,9,19,11,8,27,51,76
246,Karim Bellarabi,de,FW,Leverkusen,Bundesliga,30,1990,8.9,12,10,3,4,5,4,17,23.5,13,12,0,12,12,24,4
247,Jean-Ricner Bellegarde,fr,MF,Strasbourg,Ligue 1,22,1998,23.2,56,39,22,25,9,14,23,60.9,9,20,2,18,19,75,16
248,Héctor Bellerín,es,DF,Arsenal,Premier League,25,1995,23.2,29,19,14,12,3,12,41,29.3,29,26,8,18,33,62,33
249,Jude Bellingham,eng,MF,Dortmund,Bundesliga,17,2003,18.9,49,31,11,29,9,19,46,41.3,27,37,5,32,24,73,13
250,Andrea Belotti,it,FW,Torino,it Serie A,26,1993,32.1,30,18,4,16,10,11,35,31.4,24,27,4,23,12,42,21
251,Fran Beltrán,es,MF,Celta Vigo,La Liga,21,1999,15.5,30,22,15,12,3,8,24,33.3,16,14,1,13,16,46,24
252,Sami Ben Amar,ma,MF,Nîmes,Ligue 1,22,1998,0.1,0,0,0,0,0,0,0,,0,1,0,1,0,0,0
253,Hatem Ben Arfa,fr,MF,Bordeaux,Ligue 1,33,1987,18.9,11,7,1,7,3,2,9,22.2,7,3,0,3,2,13,0
254,Salim Ben Seghir,fr,DF,Nice,Ligue 1,17,2003,0.1,0,0,0,0,0,0,0,,0,0,0,0,0,0,0
255,Wissam Ben Yedder,fr,FW,Monaco,Ligue 1,29,1990,29.0,18,9,2,10,6,3,13,23.1,10,16,0,16,13,31,3
256,Ahmad Benali,ly,MF,Crotone,it Serie A,28,1992,13.5,19,11,10,9,0,11,38,28.9,27,15,2,13,6,25,15
257,Samy Benchamma,fr,DF,Montpellier,Ligue 1,20,2000,0.5,1,1,1,0,0,0,0,,0,0,0,0,0,1,1
258,Lars Bender,de,DF,Leverkusen,Bundesliga,31,1989,10.4,19,13,12,6,1,9,21,42.9,12,19,5,14,16,35,19
259,Sven Bender,de,DF,Leverkusen,Bundesliga,31,1989,13.0,17,9,8,8,1,7,20,35.0,13,20,9,11,21,38,41
260,Darío Benedetto,ar,FW,Marseille,Ligue 1,30,1990,17.5,6,4,1,4,1,5,13,38.5,8,9,2,7,3,9,17
261,László Bénes,sk,MF,Augsburg,Bundesliga,22,1997,7.3,8,6,4,4,0,2,8,25.0,6,6,2,4,7,15,1
262,László Bénes,sk,MF,Gladbach,Bundesliga,22,1997,1.7,6,2,5,1,0,2,4,50.0,2,0,0,0,2,8,1
263,Walter Benítez,ar,GK,Nice,Ligue 1,27,1993,38.0,1,1,1,0,0,1,3,33.3,2,1,0,1,1,2,7
264,Loris Benito,ch,DF,Bordeaux,Ligue 1,28,1992,29.5,42,26,27,12,3,22,48,45.8,26,33,10,23,42,84,70
265,Sergio Benito,es,FW,Valladolid,La Liga,21,1999,0.0,0,0,0,0,0,0,0,,0,0,0,0,0,0,0
266,Bilal Benkhedim,fr,FW,Saint-Étienne,Ligue 1,19,2001,0.8,0,0,0,0,0,0,1,0.0,1,1,0,1,0,0,0
267,Djamel Benlamri,dz,DF,Lyon,Ligue 1,30,1989,1.7,5,3,5,0,0,3,6,50.0,3,3,2,1,6,11,11
268,Ismaël Bennacer,dz,MF,Milan,it Serie A,22,1997,14.7,39,18,17,21,1,15,32,46.9,17,10,1,9,20,59,12
269,Saïd Benrahma,dz,FW,West Ham,Premier League,24,1995,15.5,24,15,8,11,5,8,28,28.6,20,10,0,10,8,32,8
270,Yassine Benrahou,fr,MF,Nîmes,Ligue 1,21,1999,13.8,16,9,8,6,2,7,25,28.0,18,9,0,9,4,20,5
271,Ramy Bensebaini,dz,DF,Gladbach,Bundesliga,25,1995,20.1,43,24,27,13,3,26,42,61.9,16,39,7,32,47,90,66
272,Josh Benson,eng,MF,Burnley,Premier League,20,1999,2.9,5,1,3,0,2,1,6,16.7,5,3,0,3,3,8,2
273,Nabil Bentaleb,dz,MF,Schalke 04,Bundesliga,25,1994,6.1,14,8,7,6,1,4,15,26.7,11,5,2,3,6,20,8
274,Rodrigo Bentancur,uy,MF,Juventus,it Serie A,23,1997,25.8,63,33,21,37,5,20,59,33.9,39,35,12,23,47,110,46
275,Christian Benteke,be,FW,Crystal Palace,Premier League,29,1990,20.2,15,7,1,7,7,2,9,22.2,7,17,6,11,4,19,39
276,Karim Benzema,fr,FW,Real Madrid,La Liga,32,1987,32.2,8,6,4,2,2,5,15,33.3,10,9,2,7,8,16,24
277,Yassine Benzia,dz,MF,Dijon,Ligue 1,25,1994,4.5,10,5,5,3,2,2,10,20.0,8,3,0,3,6,16,2
278,Alessandro Berardi,it,GK,Hellas Verona,it Serie A,29,1991,0.3,0,0,0,0,0,0,0,,0,0,0,0,0,0,0
279,Domenico Berardi,it,FW,Sassuolo,it Serie A,25,1994,27.5,42,22,17,11,14,21,62,33.9,41,23,1,22,26,68,34
280,Gaetano Berardi,ch,DF,Leeds United,Premier League,31,1988,1.3,2,2,1,0,1,0,0,,0,2,1,1,1,3,2
281,Yuri Berchiche,es,DF,Athletic Club,La Liga,30,1990,18.7,24,19,14,5,5,10,24,41.7,14,14,0,14,11,35,29
282,Álex Berenguer,es,MF,Torino,it Serie A,25,1995,1.5,2,0,0,0,2,2,5,40.0,3,2,0,2,0,2,1
283,Álex Berenguer,es,MF,Athletic Club,La Liga,25,1995,25.3,47,31,21,20,6,9,51,17.6,42,48,3,45,18,65,27
284,Bartosz Bereszyński,pl,DF,Sampdoria,it Serie A,28,1992,29.0,66,44,37,22,7,41,73,56.2,32,40,20,20,42,108,88
285,Jóhann Berg Guðmundsson,is,MF,Burnley,Premier League,29,1990,15.1,19,11,6,9,4,11,23,47.8,12,11,2,9,17,36,19
286,Sander Berge,no,MF,Sheffield Utd,Premier League,22,1998,12.4,16,7,8,5,3,7,15,46.7,8,11,2,9,4,20,18
287,Steven Bergwijn,nl,FW,Tottenham,Premier League,22,1997,13.4,15,7,8,3,4,7,20,35.0,13,7,1,6,5,20,9
288,Valon Berisha,xk,MF,Reims,Ligue 1,27,1993,18.3,40,23,19,17,4,11,47,23.4,36,14,2,12,25,65,21
289,Bernard,br,MF,Everton,Premier League,27,1992,5.1,8,3,3,3,2,7,15,46.7,8,5,0,5,8,16,6
290,Federico Bernardeschi,it,MF,Juventus,it Serie A,26,1994,10.8,9,4,3,5,1,4,20,20.0,16,6,2,4,14,23,7
291,Bernardo,br,DF,Brighton,Premier League,25,1995,2.3,10,8,8,1,1,4,6,66.7,2,2,0,2,1,11,1
292,Paul Bernardoni,fr,GK,Angers,Ligue 1,23,1997,38.0,1,1,1,0,0,1,2,50.0,1,0,0,0,2,3,23
293,Juan Bernat,es,DF,Paris S-G,Ligue 1,27,1993,2.2,5,3,0,4,1,3,5,60.0,2,4,0,4,1,6,6
294,Dimitry Bertaud,cd,GK,Montpellier,Ligue 1,22,1998,8.3,0,0,0,0,0,0,0,,0,0,0,0,1,1,2
295,Marco Bertini,it,MF,Lazio,it Serie A,17,2002,0.1,1,0,1,0,0,0,0,,0,0,0,0,0,1,0
296,Ryan Bertrand,eng,DF,Southampton,Premier League,30,1989,28.9,60,32,26,27,7,30,48,62.5,18,19,1,18,30,90,41
297,Daniel Bessa,it,MF,Hellas Verona,it Serie A,27,1993,6.8,15,8,3,11,1,6,14,42.9,8,5,1,4,2,17,0
298,Loïc Bessile,tg,DF,Bordeaux,Ligue 1,21,1999,1.0,0,0,0,0,0,0,0,,0,2,1,1,1,1,3
299,Jordan Beyer,de,DF,Gladbach,Bundesliga,20,2000,2.1,2,1,2,0,0,1,2,50.0,1,5,4,1,5,7,5
300,Giulian Biancone,fr,DF,Monaco,Ligue 1,20,2000,1.0,3,3,1,1,1,2,3,66.7,1,1,0,1,1,4,4
301,Bartosz Białek,pl,FW,Wolfsburg,Bundesliga,18,2001,3.0,6,5,1,4,1,4,4,100.0,0,5,1,4,3,9,4
302,Ermin Bičakčić,ba,DF,Hoffenheim,Bundesliga,30,1990,1.4,1,1,0,1,0,1,1,100.0,0,1,1,0,3,4,9
303,Pedro Bigas,es,DF,Eibar,La Liga,29,1990,17.0,11,9,7,4,0,7,14,50.0,7,12,6,6,23,34,54
304,El Bilal Touré,ml,FW,Reims,Ligue 1,18,2001,13.8,22,12,3,16,3,8,18,44.4,10,8,3,5,6,28,10
305,Cristiano Biraghi,it,DF,Fiorentina,it Serie A,27,1992,31.1,42,23,19,15,8,27,45,60.0,18,23,9,14,27,69,56
306,Davide Biraschi,it,DF,Genoa,it Serie A,26,1994,10.2,17,9,12,5,0,5,10,50.0,5,12,6,6,21,38,26
307,Yves Bissouma,ml,MF,Brighton,Premier League,23,1996,34.6,104,68,50,48,6,33,67,49.3,34,42,6,36,64,168,67
308,Leonardo Bittencourt,de,MF,Werder Bremen,Bundesliga,26,1993,16.8,58,32,24,28,6,16,51,31.4,35,29,2,27,13,71,10
309,Alejandro Blanco,es,MF,Valencia,La Liga,21,1998,6.4,8,4,4,4,0,3,18,16.7,15,5,0,5,8,16,9
310,Antonio Blanco,es,MF,Real Madrid,La Liga,20,2000,2.4,7,2,4,2,1,3,7,42.9,4,6,2,4,3,10,5
311,Rubén Blanco,es,GK,Celta Vigo,La Liga,25,1995,18.2,0,0,0,0,0,0,0,,0,0,0,0,0,0,7
312,Ludovic Blas,fr,MF,Nantes,Ligue 1,22,1997,31.0,58,30,18,37,3,23,54,42.6,31,33,4,29,21,79,19
313,Alejandro Blesa,es,MF,Levante,La Liga,18,2002,0.1,0,0,0,0,0,0,0,,0,0,0,0,0,0,0
314,Jérôme Boateng,de,DF,Bayern Munich,Bundesliga,31,1988,26.3,26,16,17,8,1,14,32,43.8,18,24,17,7,40,66,63
315,Antonin Bobichon,fr,MF,Angers,Ligue 1,24,1995,10.1,23,14,10,8,5,9,15,60.0,6,4,1,3,2,25,1
316,Yann Bodiger,fr,MF,Cádiz,La Liga,25,1995,2.8,2,2,1,1,0,1,6,16.7,5,7,3,4,8,10,4
317,Jean-Paul Boëtius,nl,MF,Mainz 05,Bundesliga,26,1994,22.9,42,28,13,15,14,17,47,36.2,30,37,3,34,33,75,14
318,Sacha Boey,fr,DF,Dijon,Ligue 1,19,2000,20.7,54,40,30,23,1,27,55,49.1,28,25,5,20,41,95,62
319,Sacha Boey,fr,DF,Rennes,Ligue 1,19,2000,1.4,3,3,2,1,0,3,4,75.0,1,0,0,0,2,5,2
320,Jeremie Boga,ci,FW,Sassuolo,it Serie A,23,1997,19.8,11,9,5,0,6,3,11,27.3,8,10,0,10,8,19,7
321,Melayro Bogarde,nl,DF,Hoffenheim,Bundesliga,18,2002,3.1,7,3,3,3,1,5,9,55.6,4,0,0,0,5,12,1
322,Jayden Bogle,eng,DF,Sheffield Utd,Premier League,20,2000,12.3,33,23,21,10,2,20,39,51.3,19,14,4,10,14,47,22
323,Quentin Boisgard,fr,MF,Lorient,Ligue 1,23,1997,14.6,24,17,3,15,6,11,24,45.8,13,17,2,15,15,39,1
324,Willy Boly,ci,DF,Wolves,Premier League,29,1991,20.9,33,20,26,7,0,13,24,54.2,11,18,12,6,32,65,84
325,Giacomo Bonaventura,it,MF,Fiorentina,it Serie A,30,1989,25.1,34,19,16,13,5,16,53,30.2,37,26,2,24,39,73,12
326,Federico Bonazzoli,it,FW,Torino,it Serie A,23,1997,6.3,6,4,0,4,2,2,13,15.4,11,3,0,3,2,8,3
327,Federico Bonazzoli,it,FW,Sampdoria,it Serie A,23,1997,1.5,0,0,0,0,0,0,0,,0,1,0,1,0,0,0
328,Kevin Bonifazi,it,DF,Udinese,it Serie A,24,1996,27.4,32,21,24,6,2,8,23,34.8,15,33,20,13,50,82,85
329,Leonardo Bonucci,it,DF,Juventus,it Serie A,33,1987,22.5,19,14,10,8,1,6,14,42.9,8,24,13,11,33,52,67
330,Elias Bördner,de,GK,Eint Frankfurt,Bundesliga,18,2002,1.0,1,0,1,0,0,1,1,100.0,0,0,0,0,2,3,1
331,Dennis Borkowski,de,MF,RB Leipzig,Bundesliga,18,2002,0.1,0,0,0,0,0,0,0,,0,1,0,1,0,0,0
332,Sebastiaan Bornauw,be,DF,Köln,Bundesliga,21,1999,23.1,29,20,25,4,0,14,25,56.0,11,33,26,7,40,69,104
333,Sven Botman,nl,DF,Lille,Ligue 1,20,2000,36.8,31,21,18,12,1,14,26,53.8,12,31,21,10,57,88,126
334,Denis Bouanga,ga,MF,Saint-Étienne,Ligue 1,25,1994,30.2,52,28,22,24,6,16,58,27.6,42,32,3,29,20,72,36
335,Hicham Boudaoui,dz,MF,Nice,Ligue 1,20,1999,19.3,52,35,20,24,8,26,68,38.2,42,14,4,10,23,75,26
336,Ryad Boudebouz,dz,MF,Saint-Étienne,Ligue 1,30,1990,7.2,9,4,1,7,1,4,8,50.0,4,3,0,3,5,14,5
337,Sofiane Boufal,ma,FW,Angers,Ligue 1,26,1993,8.1,17,11,8,6,3,8,28,28.6,20,8,0,8,3,20,1
338,Nassim Boujellab,ma,MF,Schalke 04,Bundesliga,21,1999,6.7,13,9,2,10,1,2,12,16.7,10,10,3,7,7,20,9
339,Farid Boulaya,dz,MF,Metz,Ligue 1,27,1993,31.3,24,16,4,17,3,13,51,25.5,38,19,3,16,12,36,7
340,Yassine Bounou,ma,GK,Sevilla,La Liga,29,1991,33.0,1,1,1,0,0,0,2,0.0,2,0,0,0,0,1,12
341,Ismaël Boura,km,DF,Lens,Ligue 1,19,2000,9.2,11,7,8,2,1,3,9,33.3,6,7,2,5,21,32,12
342,Mehdi Bourabia,ma,MF,Sassuolo,it Serie A,28,1991,5.9,6,5,1,4,1,2,7,28.6,5,14,6,8,12,18,8
343,Benjamin Bourigeaud,fr,MF,Rennes,Ligue 1,26,1994,28.4,40,23,17,16,7,21,71,29.6,50,37,1,36,19,59,25
344,Edoardo Bove,it,MF,Roma,it Serie A,18,2002,0.1,0,0,0,0,0,0,1,0.0,1,0,0,0,0,0,0
345,Jarrod Bowen,eng,FW,West Ham,Premier League,23,1996,28.5,26,15,12,7,7,10,29,34.5,19,19,1,18,22,48,10
346,Dedryck Boyata,be,DF,Hertha BSC,Bundesliga,29,1990,17.2,14,7,10,3,1,7,15,46.7,8,23,20,3,26,40,68
347,John Boye,gh,DF,Metz,Ligue 1,33,1987,33.8,58,34,43,13,2,31,54,57.4,23,36,20,16,80,138,146
348,Lucas Boyé,ar,FW,Elche,La Liga,24,1996,29.9,47,31,13,27,7,10,49,20.4,39,37,2,35,19,66,21
349,Can Bozdogan,de,MF,Schalke 04,Bundesliga,19,2001,7.2,13,5,6,6,1,4,15,26.7,11,10,2,8,7,20,5
350,Umut Bozok,tr,MF,Lorient,Ligue 1,23,1996,0.7,0,0,0,0,0,0,2,0.0,2,0,0,0,0,0,0
351,Jayden Braaf,nl,FW,Udinese,it Serie A,17,2002,1.3,0,0,0,0,0,0,1,0.0,1,0,0,0,0,0,0
352,Domagoj Bradarić,hr,DF,Lille,Ligue 1,20,1999,14.0,28,18,11,13,4,12,27,44.4,15,14,4,10,26,54,21
353,Robbie Brady,ie,MF,Burnley,Premier League,28,1992,11.7,22,15,12,6,4,12,35,34.3,23,16,0,16,9,31,29
354,Martin Braithwaite,dk,FW,Barcelona,La Liga,29,1991,13.1,8,4,2,3,3,1,6,16.7,5,2,0,2,6,14,7
355,Julian Brandt,de,FW,Dortmund,Bundesliga,24,1996,16.6,27,14,13,9,5,12,43,27.9,31,25,1,24,17,44,7
356,Darko Brašanac,rs,MF,Osasuna,La Liga,28,1992,10.1,10,6,6,4,0,5,16,31.3,11,8,1,7,7,17,10
357,Lilian Brassier,fr,DF,Brest,Ligue 1,20,1999,10.7,19,10,12,4,3,7,11,63.6,4,13,6,7,23,42,38
358,Álvaro Bravo,es,MF,Granada,La Liga,22,1998,0.2,1,1,1,0,0,1,2,50.0,1,0,0,0,1,2,0
359,Claudio Bravo,cl,GK,Betis,La Liga,37,1983,20.0,0,0,0,0,0,0,1,0.0,1,0,0,0,0,0,11
360,Fabian Bredlow,de,GK,Stuttgart,Bundesliga,25,1995,1.0,0,0,0,0,0,0,0,,0,0,0,0,0,0,0
361,Josip Brekalo,hr,FW,Wolfsburg,Bundesliga,22,1998,20.2,22,10,10,7,5,8,29,27.6,21,18,0,18,17,39,3
362,Gleison Bremer,br,DF,Torino,it Serie A,23,1997,32.6,51,34,36,14,1,21,36,58.3,15,54,21,33,70,121,142
363,Joshua Brenet,cw,DF,Hoffenheim,Bundesliga,26,1994,0.0,0,0,0,0,0,0,0,,0,0,0,0,0,0,0
364,Rhian Brewster,eng,FW,Sheffield Utd,Premier League,20,2000,12.5,8,5,1,4,3,1,13,7.7,12,15,2,13,5,13,5
365,Anthony Briançon,fr,DF,Nîmes,Ligue 1,25,1994,13.6,12,7,9,3,0,9,19,47.4,10,19,12,7,33,45,57
366,Jimmy Briand,fr,FW,Bordeaux,Ligue 1,34,1985,6.3,7,3,3,2,2,1,1,100.0,0,2,0,2,1,8,3
367,Yan Brice Eteki,cm,MF,Granada,La Liga,22,1997,14.7,23,15,10,12,1,8,19,42.1,11,13,3,10,13,36,16
368,Nathan Broadhead,wls,FW,Everton,Premier League,22,1998,0.0,1,1,0,1,0,0,0,,0,0,0,0,0,1,0
369,Dylan Bronn,tn,DF,Metz,Ligue 1,25,1995,37.9,57,37,38,19,0,24,44,54.5,20,31,14,17,44,101,112
370,John Brooks,us,DF,Wolfsburg,Bundesliga,27,1993,30.8,47,29,33,14,0,30,54,55.6,24,35,10,25,55,102,134
371,Daniel Brosinski,de,DF,Mainz 05,Bundesliga,32,1988,15.9,19,14,10,7,2,12,31,38.7,19,18,1,17,14,33,33
372,Josh Brownhill,eng,MF,Burnley,Premier League,24,1995,31.3,45,27,9,29,7,15,44,34.1,29,33,11,22,69,114,39
373,Marcelo Brozović,hr,MF,Inter,it Serie A,27,1992,28.7,54,29,23,24,7,20,61,32.8,41,43,17,26,40,94,38
374,Gastón Brugman,uy,MF,Parma,it Serie A,27,1992,18.0,35,19,18,15,2,11,44,25.0,33,33,4,29,45,80,34
375,Juan Brunet,ar,MF,Granada,La Liga,22,1998,0.3,0,0,0,0,0,0,0,,0,0,0,0,0,0,1
376,Juan Brunetta,ar,FW,Parma,it Serie A,23,1997,5.3,2,2,0,2,0,1,6,16.7,5,5,0,5,1,3,2
377,Cédric Brunner,ch,DF,Arminia,Bundesliga,26,1994,29.5,42,22,24,15,3,27,40,67.5,13,30,10,20,42,84,96
378,Jacob Bruun Larsen,dk,MF,Hoffenheim,Bundesliga,21,1998,1.0,0,0,0,0,0,0,0,,0,0,0,0,0,0,0
379,Joe Bryan,eng,DF,Fulham,Premier League,26,1993,7.4,15,8,7,5,3,7,12,58.3,5,8,2,6,14,29,16
380,Kean Bryan,eng,DF,Sheffield Utd,Premier League,23,1996,11.2,20,10,9,11,0,9,19,47.4,10,16,10,6,13,33,39
381,Lucas Buadés,fr,MF,Nîmes,Ligue 1,22,1997,0.2,1,0,0,1,0,0,0,,0,0,0,0,0,1,0
382,Ante Budimir,hr,FW,Osasuna,La Liga,29,1991,18.1,20,12,2,11,7,4,15,26.7,11,17,4,13,2,22,17
383,Gianluigi Buffon,it,GK,Juventus,it Serie A,42,1978,8.0,0,0,0,0,0,0,0,,0,0,0,0,0,0,3
384,Marius Bülter,de,FW,Union Berlin,Bundesliga,27,1993,10.9,15,8,6,6,3,5,17,29.4,12,17,2,15,12,27,11
385,Alessandro Buongiorno,it,DF,Torino,it Serie A,21,1999,9.5,12,5,8,4,0,7,12,58.3,5,15,9,6,11,23,44
386,Esteban Burgos,ar,DF,Eibar,La Liga,28,1992,12.3,7,6,4,3,0,1,5,20.0,4,8,7,1,23,30,54
387,Burgui,es,MF,Alavés,La Liga,26,1993,0.2,3,1,2,1,0,1,1,100.0,0,0,0,0,0,3,0
388,Jonathan Burkardt,de,FW,Mainz 05,Bundesliga,20,2000,15.3,27,13,15,10,2,11,19,57.9,8,20,3,17,8,35,15
389,Nishan Burkart,ch,MF,Freiburg,Bundesliga,20,2000,0.2,0,0,0,0,0,0,1,0.0,1,0,0,0,0,0,0
390,Oliver Burke,sct,FW,Sheffield Utd,Premier League,23,1997,14.1,16,8,6,9,1,5,24,20.8,19,24,0,24,2,18,6
391,Roman Bürki,ch,GK,Dortmund,Bundesliga,29,1990,18.5,0,0,0,0,0,0,0,,0,0,0,0,0,0,5
392,Dan Burn,eng,DF,Brighton,Premier League,28,1992,22.9,50,26,33,14,3,27,53,50.9,26,30,7,23,31,81,75
393,Patrick Burner,mq,DF,Nice,Ligue 1,24,1996,0.0,0,0,0,0,0,0,0,,0,0,0,0,0,0,0
394,Patrick Burner,mq,DF,Nîmes,Ligue 1,24,1996,14.6,25,11,14,10,1,13,26,50.0,13,10,3,7,24,49,41
395,Maxime Busi,be,DF,Parma,it Serie A,20,1999,13.3,23,13,19,3,1,11,28,39.3,17,14,1,13,16,39,32
396,Sergio Busquets,es,MF,Barcelona,La Liga,32,1988,28.0,63,35,21,29,13,27,76,35.5,49,27,4,23,53,116,18
397,Jack Butland,eng,GK,Crystal Palace,Premier League,27,1993,1.0,0,0,0,0,0,0,0,,0,0,0,0,0,0,0
398,David Button,eng,GK,West Brom,Premier League,31,1989,1.0,0,0,0,0,0,0,0,,0,0,0,0,0,0,0
399,Oskar Buur,dk,DF,Wolves,Premier League,22,1998,0.2,0,0,0,0,0,0,2,0.0,2,0,0,0,0,0,0
400,Marcin Bułka,pl,GK,Paris S-G,Ligue 1,20,1999,1.0,0,0,0,0,0,0,0,,0,0,0,0,0,0,0
401,Erick Cabaco,uy,DF,Getafe,La Liga,25,1995,14.7,24,14,11,12,1,12,22,54.5,10,8,6,2,13,37,51
402,Willy Caballero,ar,GK,Chelsea,Premier League,38,1981,1.0,0,0,0,0,0,0,0,,0,0,0,0,0,0,0
403,Jimmy Cabot,fr,FW,Angers,Ligue 1,26,1994,10.5,26,13,8,14,4,11,36,30.6,25,8,0,8,12,38,6
404,Martín Cáceres,uy,DF,Fiorentina,it Serie A,33,1987,24.9,28,12,16,11,1,15,35,42.9,20,20,14,6,14,42,52
405,Anthony Caci,fr,DF,Strasbourg,Ligue 1,23,1997,31.1,80,46,47,27,6,35,69,50.7,34,30,4,26,55,135,65
406,Mathieu Cafaro,fr,MF,Reims,Ligue 1,23,1997,23.0,40,17,15,19,6,13,43,30.2,30,11,0,11,17,57,12
407,Gary Cahill,eng,DF,Crystal Palace,Premier League,34,1985,20.0,13,9,10,3,0,7,11,63.6,4,27,22,5,13,26,88
408,Yannick Cahuzac,fr,MF,Lens,Ligue 1,35,1985,25.0,26,12,12,10,4,9,27,33.3,18,18,5,13,33,59,72
409,Felipe Caicedo,ec,FW,Lazio,it Serie A,31,1988,10.3,10,7,4,4,2,1,8,12.5,7,7,0,7,4,14,2
410,Marc-Aurèle Caillard,fr,GK,Metz,Ligue 1,26,1994,4.0,0,0,0,0,0,0,0,,0,0,0,0,0,0,2
411,Tom Cairney,sct,MF,Fulham,Premier League,29,1991,8.4,9,3,1,4,4,1,4,25.0,3,6,0,6,0,9,3
412,Cala,es,DF,Cádiz,La Liga,30,1989,25.2,21,12,15,6,0,11,21,52.4,10,18,8,10,35,56,91
413,Arturo Calabresi,it,DF,Bologna,it Serie A,24,1996,0.2,0,0,0,0,0,0,0,,0,0,0,0,0,0,2
414,Arturo Calabresi,it,DF,Cagliari,it Serie A,24,1996,0.2,0,0,0,0,0,0,1,0.0,1,0,0,0,0,0,0
415,Davide Calabria,it,DF,Milan,it Serie A,23,1996,29.4,101,64,61,32,8,54,90,60.0,36,42,9,33,37,138,82
416,Riccardo Calafiori,it,DF,Roma,it Serie A,18,2002,0.7,1,0,1,0,0,1,4,25.0,3,1,0,1,0,1,0
417,Mattia Caldara,it,DF,Atalanta,it Serie A,26,1994,1.2,1,0,0,1,0,1,1,100.0,0,3,2,1,4,5,3
418,Luca Caldirola,it,DF,Benevento,it Serie A,29,1991,17.5,21,13,13,6,2,10,22,45.5,12,20,15,5,20,41,56
419,Duje Ćaleta-Car,hr,DF,Marseille,Ligue 1,23,1996,31.3,29,17,19,9,1,17,30,56.7,13,29,22,7,44,73,130
420,Hakan Çalhanoğlu,tr,MF,Milan,it Serie A,26,1994,29.0,26,7,3,17,6,7,28,25.0,21,21,6,15,15,41,24
421,Kerim Calhanoglu,de,DF,Schalke 04,Bundesliga,17,2002,3.3,3,3,1,1,1,0,3,0.0,3,4,0,4,7,10,6
422,Fabrizio Caligara,it,MF,Cagliari,it Serie A,20,2000,2.0,6,4,2,2,2,6,9,66.7,3,9,2,7,3,9,3
423,Daniel Caligiuri,it,MF,Augsburg,Bundesliga,32,1988,29.6,71,46,29,31,11,29,92,31.5,63,45,6,39,38,109,41
424,José Callejón,es,FW,Fiorentina,it Serie A,33,1987,7.4,10,7,0,6,4,5,9,55.6,4,4,1,3,4,14,5
425,Jonathan Calleri,ar,FW,Osasuna,La Liga,26,1993,17.2,15,6,2,4,9,3,17,17.6,14,18,2,16,1,16,10
426,Dominic Calvert-Lewin,eng,FW,Everton,Premier League,23,1997,31.9,17,8,1,8,8,6,12,50.0,6,22,6,16,6,23,33
427,Dani Calvo,es,DF,Elche,La Liga,26,1994,19.8,20,13,13,7,0,7,10,70.0,3,18,12,6,11,31,71
428,Drissa Camara,ci,MF,Parma,it Serie A,18,2002,0.2,0,0,0,0,0,0,0,,0,0,0,0,0,0,0
429,Mahdi Camara,fr,MF,Saint-Étienne,Ligue 1,22,1998,36.6,99,67,43,46,10,33,60,55.0,27,50,12,38,78,177,51
430,Eduardo Camavinga,fr,MF,Rennes,Ligue 1,17,2002,26.7,98,58,39,48,11,38,77,49.4,39,36,2,34,23,121,15
431,José Campaña,es,MF,Levante,La Liga,27,1993,8.3,14,6,3,6,5,5,14,35.7,9,2,0,2,13,27,4
432,Emre Can,de,DF,Dortmund,Bundesliga,26,1994,23.7,43,34,20,20,3,20,37,54.1,17,35,10,25,48,91,52
433,Sergio Canales,es,MF,Betis,La Liga,29,1991,27.8,16,9,9,6,1,3,21,14.3,18,18,0,18,13,29,5
434,João Cancelo,pt,DF,Manchester City,Premier League,26,1994,25.5,68,41,42,19,7,43,83,51.8,40,23,2,21,41,109,33
435,Antonio Candreva,it,MF,Sampdoria,it Serie A,33,1987,27.8,28,19,17,9,2,21,53,39.6,32,24,3,21,9,37,27
436,Álex Cantero,es,FW,Levante,La Liga,20,2000,2.6,2,1,0,2,0,1,2,50.0,1,1,0,1,0,2,3
437,Ander Capa,es,DF,Athletic Club,La Liga,28,1992,23.7,37,18,22,13,2,18,37,48.6,19,21,8,13,25,62,57
438,Pierrick Capelle,fr,MF,Angers,Ligue 1,33,1987,22.8,53,28,24,17,12,31,79,39.2,48,25,1,24,47,100,32
439,Étienne Capoue,fr,MF,Villarreal,La Liga,32,1988,13.2,20,10,14,6,0,8,18,44.4,10,7,1,6,20,40,23
440,Elio Capradossi,ug,DF,Spezia,it Serie A,24,1996,1.0,2,1,2,0,0,2,2,100.0,0,0,0,0,1,3,5
441,Gianluca Caprari,it,MF,Benevento,it Serie A,27,1993,20.7,16,11,5,5,6,6,31,19.4,25,19,1,18,18,34,8
442,Francesco Caputo,it,FW,Sassuolo,it Serie A,32,1987,18.9,0,0,0,0,0,0,2,0.0,2,4,0,4,1,1,3
443,Maxence Caqueret,fr,MF,Lyon,Ligue 1,20,2000,19.6,72,45,17,39,16,35,106,33.0,71,35,3,32,23,95,5
444,Andrea Carboni,it,DF,Cagliari,it Serie A,19,2001,12.1,34,23,23,11,0,15,28,53.6,13,15,4,11,14,48,52
445,Isaac Carcelen,es,DF,Cádiz,La Liga,27,1993,28.7,68,43,36,25,7,33,60,55.0,27,37,12,25,49,117,89
446,Cárdenas,es,GK,Levante,La Liga,23,1997,8.0,0,0,0,0,0,0,1,0.0,1,0,0,0,3,3,5
447,Irvin Cardona,fr,FW,Brest,Ligue 1,22,1997,22.5,10,5,3,6,1,4,22,18.2,18,17,3,14,9,19,23
448,Marc Cardona,es,FW,Osasuna,La Liga,25,1995,0.6,1,0,1,0,0,1,1,100.0,0,0,0,0,0,1,0
449,Diego Carlos,br,DF,Sevilla,La Liga,27,1993,31.0,22,13,17,4,1,8,16,50.0,8,35,27,8,31,53,114
450,Juan Carlos,es,MF,Huesca,La Liga,29,1991,3.2,5,3,4,1,0,2,15,13.3,13,7,0,7,1,6,1
451,Lionel Carole,fr,DF,Strasbourg,Ligue 1,29,1991,14.9,37,25,18,14,5,16,29,55.2,13,3,1,2,38,75,28
452,Yannick Carrasco,be,DF,Atlético Madrid,La Liga,26,1993,24.2,27,15,14,6,7,15,34,44.1,19,24,0,24,17,44,16
453,Sergio Carreira,es,DF,Celta Vigo,La Liga,19,2000,2.9,3,0,2,1,0,1,1,100.0,0,2,0,2,1,4,7
454,Guido Carrillo,ar,FW,Elche,La Liga,29,1991,11.1,9,8,1,7,1,2,8,25.0,6,2,1,1,4,13,14
455,Andy Carroll,eng,FW,Newcastle Utd,Premier League,31,1989,4.4,3,1,1,1,1,1,8,12.5,7,1,0,1,0,3,14
456,Scott Carson,eng,GK,Manchester City,Premier League,34,1985,1.0,0,0,0,0,0,0,0,,0,0,0,0,0,0,0
457,Dani Carvajal,es,DF,Real Madrid,La Liga,28,1992,10.6,27,20,12,10,5,11,20,55.0,9,19,1,18,13,40,27
458,Fabio Carvalho,pt,MF,Fulham,Premier League,17,2002,2.8,9,6,4,4,1,5,9,55.6,4,2,0,2,1,10,1
459,William Carvalho,pt,MF,Betis,La Liga,28,1992,13.6,19,12,7,11,1,5,21,23.8,16,11,3,8,11,30,14
460,Casemiro,br,MF,Real Madrid,La Liga,28,1992,32.2,84,49,50,30,4,33,73,45.2,40,50,17,33,70,154,62
461,Matty Cash,pl,DF,Aston Villa,Premier League,22,1997,26.4,71,40,43,22,6,41,74,55.4,33,50,11,39,60,131,95
462,Kiko Casilla,es,GK,Leeds United,Premier League,33,1986,3.0,0,0,0,0,0,0,0,,0,0,0,0,0,0,0
463,Giuseppe Caso,it,DF,Genoa,it Serie A,21,1998,0.6,0,0,0,0,0,0,0,,0,0,0,0,0,0,0
464,Moreto Cassamã,gw,MF,Reims,Ligue 1,22,1998,22.6,49,36,24,23,2,27,49,55.1,22,19,6,13,36,85,33
465,Francesco Cassata,it,DF,Genoa,it Serie A,23,1997,2.5,7,6,7,0,0,4,7,57.1,3,0,0,0,3,10,1
466,Timothy Castagne,be,DF,Leicester City,Premier League,24,1995,26.1,52,32,29,18,5,24,44,54.5,20,29,5,24,29,81,62
467,Koen Casteels,be,GK,Wolfsburg,Bundesliga,28,1992,32.0,0,0,0,0,0,0,1,0.0,1,1,0,1,2,2,9
468,Jean-Charles Castelletto,cm,DF,Nantes,Ligue 1,25,1995,21.6,32,18,20,11,1,18,31,58.1,13,25,19,6,42,74,79
469,Samu Castillejo,es,FW,Milan,it Serie A,25,1995,13.1,24,12,9,14,1,14,40,35.0,26,21,0,21,6,30,9
470,Gonzalo Castro,de,MF,Stuttgart,Bundesliga,33,1987,19.2,21,7,6,9,6,8,23,34.8,15,16,3,13,8,29,12
471,Jonny Castro,es,MF,Wolves,Premier League,26,1994,5.5,11,5,6,4,1,6,13,46.2,7,9,3,6,9,20,7
472,Gaetano Castrovilli,it,MF,Fiorentina,it Serie A,23,1997,25.9,33,19,15,11,7,11,42,26.2,31,25,2,23,34,67,14
473,Danilo Cataldi,it,MF,Lazio,it Serie A,25,1994,6.3,7,2,1,5,1,4,18,22.2,14,3,1,2,9,16,7
474,Ivan Cavaleiro,pt,FW,Fulham,Premier League,26,1993,27.5,23,14,9,11,3,12,34,35.3,22,25,1,24,19,42,14
475,Edinson Cavani,uy,FW,Manchester Utd,Premier League,33,1987,15.3,12,8,1,8,3,2,13,15.4,11,2,0,2,6,18,11
476,Dani Ceballos,es,MF,Arsenal,Premier League,23,1996,17.9,37,22,20,11,6,21,51,41.2,30,23,6,17,35,72,14
477,Federico Ceccherini,it,DF,Hellas Verona,it Serie A,28,1992,19.3,16,12,10,6,0,2,7,28.6,5,15,8,7,40,56,60
478,Federico Ceccherini,it,DF,Fiorentina,it Serie A,28,1992,3.0,4,1,1,3,0,1,1,100.0,0,6,5,1,7,11,15
479,Zeki Çelik,tr,DF,Lille,Ligue 1,23,1997,26.5,72,33,30,30,12,44,81,54.3,37,32,6,26,38,110,52
480,Bersant Celina,xk,MF,Dijon,Ligue 1,23,1996,25.5,20,12,8,8,4,7,38,18.4,31,20,2,18,8,28,10
481,Fabien Centonze,fr,DF,Metz,Ligue 1,24,1996,35.8,104,68,64,30,10,43,73,58.9,30,62,17,45,112,216,119
482,Luca Ceppitelli,it,DF,Cagliari,it Serie A,30,1989,16.3,25,19,13,10,2,14,26,53.8,12,23,12,11,25,50,58
483,Alberto Cerri,it,FW,Cagliari,it Serie A,24,1996,4.1,3,2,0,2,1,0,5,0.0,5,4,2,2,2,5,6
484,Sava Cestic,rs,DF,Köln,Bundesliga,19,2001,10.0,20,9,12,6,2,8,17,47.1,9,13,4,9,18,38,40
485,Julian Chabot,de,DF,Spezia,it Serie A,22,1998,18.4,48,34,28,16,4,23,37,62.2,14,25,13,12,37,85,43
486,Nassim Chadli,fr,FW,Nîmes,Ligue 1,19,2001,0.3,2,1,2,0,0,0,1,0.0,1,1,0,1,0,2,0
487,Fouad Chafik,ma,DF,Dijon,Ligue 1,33,1986,18.0,39,24,29,8,2,16,35,45.7,19,19,10,9,21,60,41
488,Mehdi Chahiri,ma,FW,Strasbourg,Ligue 1,24,1996,8.9,18,8,7,5,6,8,20,40.0,12,9,0,9,6,24,5
489,Sofian Chakla,ma,DF,Villarreal,La Liga,26,1993,0.1,0,0,0,0,0,0,0,,0,0,0,0,0,0,0
490,Sofian Chakla,ma,DF,Getafe,La Liga,26,1993,10.0,12,8,10,1,1,5,7,71.4,2,3,2,1,14,26,48
491,Aníbal Chalá,ec,DF,Dijon,Ligue 1,24,1996,8.3,10,7,6,3,1,6,12,50.0,6,5,3,2,14,24,15
492,Trevoh Chalobah,eng,DF,Lorient,Ligue 1,21,1999,24.9,45,26,32,13,0,24,50,48.0,26,20,7,13,69,114,56
493,Calum Chambers,eng,DF,Arsenal,Premier League,25,1995,8.4,7,3,3,2,2,3,8,37.5,5,6,2,4,10,17,37
494,Timothy Chandler,us,DF,Eint Frankfurt,Bundesliga,30,1990,4.8,4,0,2,1,1,1,4,25.0,3,5,2,3,3,7,5
495,Kwon Chang-hoon,kr,MF,Freiburg,Bundesliga,26,1994,2.4,3,1,1,0,2,1,3,33.3,2,3,1,2,7,10,2
496,Gaëtan Charbonnier,fr,MF,Brest,Ligue 1,31,1988,17.4,24,15,6,11,7,12,32,37.5,20,15,1,14,9,33,19
497,Brendan Chardonnet,fr,DF,Brest,Ligue 1,25,1994,30.2,51,29,31,19,1,27,41,65.9,14,54,41,13,64,115,151
498,Xavier Chavalerin,fr,MF,Reims,Ligue 1,29,1991,28.3,92,50,47,38,7,26,74,35.1,48,43,9,34,43,135,29
499,Pape Cheikh Diop,sn,MF,Dijon,Ligue 1,22,1997,12.1,24,14,15,6,3,13,33,39.4,20,14,2,12,6,30,6
500,Chema,es,DF,Getafe,La Liga,28,1992,6.2,11,5,6,5,0,5,7,71.4,2,1,0,1,10,21,23
501,Rayan Cherki,fr,FW,Lyon,Ligue 1,16,2003,7.8,5,3,0,3,2,1,11,9.1,10,3,0,3,4,9,0
502,Denis Cheryshev,ru,MF,Valencia,La Liga,29,1990,12.2,19,15,6,7,6,6,26,23.1,20,15,1,14,12,31,15
503,Giorgio Chiellini,it,DF,Juventus,it Serie A,35,1984,15.4,12,9,9,3,0,5,11,45.5,6,18,13,5,27,39,56
504,Federico Chiesa,it,DF,Fiorentina,it Serie A,22,1997,2.7,6,2,2,2,2,3,8,37.5,5,3,1,2,1,7,3
505,Federico Chiesa,it,MF,Juventus,it Serie A,22,1997,24.6,47,26,21,14,12,19,50,38.0,31,23,1,22,12,59,16
506,Ben Chilwell,eng,DF,Chelsea,Premier League,23,1996,25.4,42,22,16,22,4,15,33,45.5,18,28,3,25,24,66,58
507,Vlad Chiricheș,ro,DF,Sassuolo,it Serie A,30,1989,20.4,38,23,34,3,1,21,35,60.0,14,31,21,10,50,88,59
508,Pedro Chirivella,es,MF,Nantes,Ligue 1,23,1997,25.3,26,8,7,13,6,14,49,28.6,35,23,4,19,41,67,19
509,Tahith Chong,nl,MF,Werder Bremen,Bundesliga,20,1999,4.3,11,6,1,9,1,4,8,50.0,4,4,0,4,5,16,1
510,Joris Chotard,fr,MF,Montpellier,Ligue 1,18,2001,12.9,12,8,5,6,1,6,31,19.4,25,12,3,9,11,23,15
511,Hamza Choudhury,eng,MF,Leicester City,Premier League,22,1997,3.5,8,7,3,5,0,4,10,40.0,6,4,1,3,4,12,9
512,Mounir Chouiar,fr,FW,Dijon,Ligue 1,21,1999,14.3,22,12,10,9,3,6,18,33.3,12,10,0,10,11,33,8
513,Andreas Christensen,dk,DF,Chelsea,Premier League,24,1996,15.2,11,6,8,3,0,0,8,0.0,8,19,14,5,20,31,51
514,Carney Chukwuemeka,eng,MF,Aston Villa,Premier League,16,2003,0.2,2,2,1,0,1,1,3,33.3,2,0,0,0,0,2,0
515,Samuel Chukwueze,ng,MF,Villarreal,La Liga,21,1999,15.2,12,7,4,4,4,3,17,17.6,14,8,0,8,10,22,3
516,Darko Churlinov,mk,DF,Stuttgart,Bundesliga,20,2000,2.4,2,2,2,0,0,1,3,33.3,2,5,1,4,0,2,2
517,Víctor Chust,es,DF,Real Madrid,La Liga,20,2000,1.1,1,1,0,1,0,0,2,0.0,2,2,2,0,1,2,5
518,Sébastien Cibois,fr,GK,Brest,Ligue 1,22,1998,3.0,0,0,0,0,0,0,0,,0,0,0,0,0,0,0
519,Cifu,es,DF,Elche,La Liga,29,1990,5.0,10,7,7,3,0,7,13,53.8,6,5,1,4,8,18,10
520,Alberto Cifuentes,es,GK,Cádiz,La Liga,41,1979,2.0,0,0,0,0,0,0,0,,0,0,0,0,0,0,0
521,Luca Cigarini,it,MF,Crotone,it Serie A,34,1986,10.3,26,14,11,12,3,12,28,42.9,16,10,1,9,12,38,9
522,Jasper Cillessen,nl,GK,Valencia,La Liga,31,1989,10.0,0,0,0,0,0,0,0,,0,0,0,0,0,0,0
523,Antonio Cioffi,it,FW,Napoli,it Serie A,17,2002,0.1,0,0,0,0,0,0,0,,0,1,0,1,1,1,0
524,Tim Civeja,al,MF,Augsburg,Bundesliga,18,2002,0.4,0,0,0,0,0,0,1,0.0,1,0,0,0,3,3,0
525,Ciaran Clark,ie,DF,Newcastle Utd,Premier League,30,1989,21.0,24,14,15,6,3,6,13,46.2,7,27,20,7,29,53,104
526,Alexis Claude-Maurice,fr,MF,Nice,Ligue 1,22,1998,21.2,40,19,17,14,9,14,48,29.2,34,16,2,14,14,54,3
527,Jonathan Clauss,fr,DF,Lens,Ligue 1,27,1992,28.0,43,20,12,20,11,17,38,44.7,21,24,1,23,45,88,46
528,Carlos Clerc,es,DF,Levante,La Liga,28,1992,30.9,56,29,33,16,7,22,39,56.4,17,26,4,22,37,93,55
529,Nathaniel Clyne,eng,DF,Crystal Palace,Premier League,29,1991,12.7,17,10,8,8,1,9,16,56.3,7,7,2,5,18,35,25
530,Conor Coady,eng,DF,Wolves,Premier League,27,1993,36.7,35,23,25,10,0,19,35,54.3,16,40,32,8,27,62,134
531,Marcus Coco,fr,MF,Nantes,Ligue 1,24,1996,16.4,36,21,17,15,4,16,36,44.4,20,16,3,13,20,56,17
532,Coke,es,DF,Levante,La Liga,33,1987,9.3,24,10,14,7,3,14,27,51.9,13,13,1,12,14,38,27
533,Séamus Coleman,ie,DF,Everton,Premier League,31,1988,17.9,39,26,21,14,4,21,30,70.0,9,22,6,16,13,52,37
534,Ebrima Colley,gm,MF,Hellas Verona,it Serie A,20,2000,8.2,11,4,2,6,3,3,11,27.3,8,6,0,6,6,17,1
535,Omar Colley,gm,DF,Sampdoria,it Serie A,27,1992,28.8,28,16,19,8,1,13,23,56.5,10,43,29,14,68,96,133
536,Simone Colombi,it,GK,Parma,it Serie A,29,1991,2.0,0,0,0,0,0,0,0,,0,0,0,0,0,0,2
537,Lorenzo Colombo,it,FW,Milan,it Serie A,18,2002,1.0,2,1,1,1,0,0,3,0.0,3,0,0,0,0,2,3
538,Racine Coly,sn,MF,Nice,Ligue 1,24,1995,0.2,0,0,0,0,0,0,0,,0,0,0,0,0,0,0
539,Kingsley Coman,fr,FW,Bayern Munich,Bundesliga,24,1996,19.5,14,8,6,7,1,2,21,9.5,19,22,0,22,4,18,3
540,Daniel Congré,fr,DF,Montpellier,Ligue 1,35,1985,36.6,59,35,45,12,2,36,70,51.4,34,50,33,17,69,128,144
541,Aaron Connolly,ie,FW,Brighton,Premier League,20,2000,8.8,6,3,1,3,2,0,2,0.0,2,4,0,4,0,6,2
542,Andrea Consigli,it,GK,Sassuolo,it Serie A,33,1987,37.0,2,2,2,0,0,2,2,100.0,0,0,0,0,0,2,14
543,Andrea Conti,it,DF,Milan,it Serie A,26,1994,0.3,1,1,1,0,0,0,1,0.0,1,0,0,0,1,2,0
544,Andrea Conti,it,DF,Parma,it Serie A,26,1994,9.0,21,10,16,4,1,13,26,50.0,13,13,4,9,16,37,23
545,Liam Cooper,sct,DF,Leeds United,Premier League,28,1991,24.3,68,45,39,27,2,37,59,62.7,22,39,32,7,61,129,70
546,Francis Coquelin,fr,MF,Villarreal,La Liga,29,1991,8.2,19,14,4,12,3,8,19,42.1,11,8,2,6,21,40,11
547,Theo Corbeanu,ca,FW,Wolves,Premier League,18,2002,0.1,2,1,0,2,0,1,1,100.0,0,0,0,0,1,3,0
548,Sébastien Corchia,fr,DF,Nantes,Ligue 1,29,1990,23.0,55,30,29,17,9,33,60,55.0,27,28,10,18,38,93,40
549,Alex Cordaz,it,GK,Crotone,it Serie A,37,1983,36.0,0,0,0,0,0,0,0,,0,0,0,0,1,1,7
550,Iñigo Córdoba,es,FW,Athletic Club,La Liga,23,1997,1.1,0,0,0,0,0,0,3,0.0,3,4,0,4,2,2,1
551,Iñigo Córdoba,es,MF,Alavés,La Liga,23,1997,2.4,6,4,1,3,2,2,10,20.0,8,7,0,7,3,9,2
552,Jhon Córdoba,co,FW,Hertha BSC,Bundesliga,27,1993,17.1,9,4,1,5,3,2,4,50.0,2,13,2,11,6,15,4
553,Sergio Córdova,ve,FW,Arminia,Bundesliga,22,1997,12.1,16,8,0,10,6,2,15,13.3,13,14,3,11,9,25,9
554,Jack Cork,eng,MF,Burnley,Premier League,31,1989,15.0,26,10,5,17,4,11,31,35.5,20,15,4,11,16,42,20
555,Andreas Cornelius,dk,FW,Parma,it Serie A,27,1993,21.1,11,4,1,5,5,2,12,16.7,10,9,2,7,1,12,25
556,Maxwel Cornet,ci,DF,Lyon,Ligue 1,23,1996,27.2,70,41,39,24,7,33,58,56.9,25,23,5,18,43,113,47
557,Ángel Correa,ar,FW,Atlético Madrid,La Liga,25,1995,26.6,38,21,10,23,5,15,45,33.3,30,18,1,17,22,60,16
558,Joaquín Correa,ar,FW,Lazio,it Serie A,25,1994,21.5,21,12,6,11,4,7,25,28.0,18,14,0,14,7,28,12
559,Rober Correa,es,DF,Eibar,La Liga,27,1992,12.6,16,9,8,6,2,8,12,66.7,4,9,1,8,20,36,31
560,Félix Correia,pt,MF,Juventus,it Serie A,19,2001,0.1,0,0,0,0,0,0,0,,0,0,0,0,0,0,1
561,Thierry Correia,pt,DF,Valencia,La Liga,21,1999,23.7,47,27,32,10,5,21,43,48.8,22,24,6,18,42,89,63
562,Danny da Costa,de,DF,Mainz 05,Bundesliga,27,1993,13.4,22,16,6,9,7,13,27,48.1,14,17,2,15,17,39,27
563,Danny da Costa,de,DF,Eint Frankfurt,Bundesliga,27,1993,1.2,0,0,0,0,0,0,1,0.0,1,3,1,2,0,0,4
564,David Costa,pt,MF,Lens,Ligue 1,19,2001,1.7,4,4,1,2,1,2,3,66.7,1,2,0,2,0,4,4
565,Diego Costa,es,FW,Atlético Madrid,La Liga,31,1988,2.3,1,0,1,0,0,1,3,33.3,2,0,0,0,0,1,2
566,Douglas Costa,br,MF,Juventus,it Serie A,29,1990,0.5,1,0,1,0,0,1,3,33.3,2,0,0,0,0,1,0
567,Douglas Costa,br,FW,Bayern Munich,Bundesliga,29,1990,3.6,2,1,1,1,0,1,3,33.3,2,7,0,7,2,4,1
568,Hélder Costa,ao,MF,Leeds United,Premier League,26,1994,12.8,25,11,12,5,8,11,32,34.4,21,11,0,11,3,28,5
569,Jaume Costa,es,DF,Villarreal,La Liga,32,1988,3.9,10,6,4,6,0,7,9,77.8,2,7,1,6,6,16,8
570,Angelo da Costa Júnior,br,GK,Bologna,it Serie A,36,1983,6.0,0,0,0,0,0,0,0,,0,0,0,0,0,0,2
571,Charles Costes,fr,MF,Dijon,Ligue 1,17,2002,0.0,0,0,0,0,0,0,0,,0,0,0,0,0,0,0
572,Benoît Costil,fr,GK,Bordeaux,Ligue 1,33,1987,38.0,1,1,1,0,0,1,3,33.3,2,1,0,1,1,2,17
573,Vladimír Coufal,cz,DF,West Ham,Premier League,27,1992,33.9,73,36,50,15,8,52,89,58.4,37,41,7,34,41,114,102
574,Kalifa Coulibaly,ml,FW,Nantes,Ligue 1,28,1991,10.9,3,1,0,1,2,2,8,25.0,6,3,1,2,2,5,12
575,Lassana Coulibaly,ml,MF,Angers,Ligue 1,24,1996,18.7,78,41,33,34,11,39,75,52.0,36,29,4,25,33,111,17
576,Mamadou Coulibaly,sn,MF,Udinese,it Serie A,21,1999,2.0,10,8,5,5,0,0,0,,0,2,0,2,1,11,0
577,Senou Coulibaly,ml,DF,Dijon,Ligue 1,25,1994,21.5,33,21,23,10,0,12,24,50.0,12,18,12,6,30,63,89
578,Tanguy Coulibaly,fr,DF,Stuttgart,Bundesliga,19,2001,16.7,26,15,10,7,9,11,23,47.8,12,20,0,20,10,36,11
579,Thibaut Courtois,be,GK,Real Madrid,La Liga,28,1992,38.0,0,0,0,0,0,0,1,0.0,1,1,0,1,1,1,17
580,Philippe Coutinho,br,MF,Barcelona,La Liga,28,1992,7.3,8,6,2,5,1,3,9,33.3,6,7,0,7,2,10,1
581,Nicolas Cozza,fr,DF,Montpellier,Ligue 1,21,1999,15.2,39,30,27,11,1,20,40,50.0,20,20,11,9,26,65,62
582,Alessio Cragno,it,GK,Cagliari,it Serie A,26,1994,34.0,0,0,0,0,0,0,1,0.0,1,0,0,0,1,1,10
583,Gian Crespi,it,GK,Crotone,it Serie A,19,2001,1.0,0,0,0,0,0,0,0,,0,0,0,0,0,0,0
584,Aaron Cresswell,eng,DF,West Ham,Premier League,30,1989,35.2,32,13,15,15,2,18,32,56.3,14,29,14,15,32,64,79
585,Domenico Criscito,it,DF,Genoa,it Serie A,33,1986,19.2,43,22,29,11,3,22,39,56.4,17,27,14,13,44,87,51
586,Bryan Cristante,it,DF,Roma,it Serie A,25,1995,23.9,27,20,10,14,3,10,28,35.7,18,21,7,14,40,67,61
587,Giovanni Crociata,it,DF,Crotone,it Serie A,22,1997,0.3,1,0,0,1,0,0,1,0.0,1,1,0,1,0,1,0
588,Juan Cruz Armada,es,DF,Osasuna,La Liga,28,1992,21.8,36,22,17,16,3,19,35,54.3,16,19,5,14,15,51,50
589,Juan Cuadrado,co,DF,Juventus,it Serie A,32,1988,24.2,43,25,22,15,6,29,60,48.3,31,16,2,14,43,86,22
590,Andrés Cubas,py,MF,Nîmes,Ligue 1,24,1996,24.9,80,47,30,44,6,33,74,44.6,41,37,10,27,50,130,29
591,Sergio Cubero Ezcurra,es,MF,Eibar,La Liga,20,1999,0.0,0,0,0,0,0,0,0,,0,0,0,0,0,0,0
592,Cucho,co,FW,Getafe,La Liga,21,1999,16.3,19,10,1,14,4,2,23,8.7,21,18,1,17,6,25,8
593,Marc Cucurella,es,MF,Getafe,La Liga,22,1998,36.0,64,51,19,40,5,25,66,37.9,41,45,4,41,40,104,27
594,Mickaël Cuisance,fr,MF,Marseille,Ligue 1,20,1999,11.4,24,11,2,15,7,10,33,30.3,23,13,1,12,3,27,4
595,Mickaël Cuisance,fr,FW,Bayern Munich,Bundesliga,20,1999,0.2,0,0,0,0,0,0,0,,0,1,0,1,0,0,0
596,Matheus Cunha,br,FW,Hertha BSC,Bundesliga,21,1999,23.9,36,16,10,19,7,13,49,26.5,36,29,2,27,31,67,9
597,Giuseppe Cuomo,it,DF,Crotone,it Serie A,22,1998,8.9,26,19,17,9,0,9,14,64.3,5,10,2,8,18,44,19
598,Patrick Cutrone,it,FW,Wolves,Premier League,22,1998,0.3,0,0,0,0,0,0,0,,0,0,0,0,0,0,0
599,Patrick Cutrone,it,FW,Fiorentina,it Serie A,22,1998,2.2,4,3,1,2,1,1,2,50.0,1,1,0,1,1,5,0
600,Patrick Cutrone,it,FW,Valencia,La Liga,22,1998,1.2,0,0,0,0,0,0,1,0.0,1,0,0,0,1,1,0
601,Wylan Cyprien,fr,MF,Parma,it Serie A,25,1995,4.6,9,4,5,3,1,2,4,50.0,2,13,8,5,5,14,6
602,Rafael Czichos,de,DF,Köln,Bundesliga,30,1990,25.1,48,24,33,13,2,23,42,54.8,19,25,9,16,53,101,109
603,Lennart-Marten Czyborra,de,DF,Genoa,it Serie A,21,1999,13.0,19,10,7,7,5,11,19,57.9,8,6,1,5,17,36,27
604,Danilo D'Ambrosio,it,DF,Inter,it Serie A,31,1988,7.8,15,9,6,7,2,6,15,40.0,9,9,7,2,4,19,15
605,Damien Da Silva,fr,DF,Rennes,Ligue 1,32,1988,29.6,22,13,13,8,1,12,18,66.7,6,17,13,4,44,66,99
606,Moanes Dabbur,il,FW,Hoffenheim,Bundesliga,28,1992,11.1,6,3,3,1,2,1,13,7.7,12,6,0,6,9,15,7
607,Bryan Dabo,bf,MF,Benevento,it Serie A,28,1992,12.4,11,8,5,3,3,5,16,31.3,11,7,1,6,13,24,16
608,Colin Dagba,fr,DF,Paris S-G,Ligue 1,21,1998,15.1,23,11,4,17,2,14,19,73.7,5,18,5,13,16,39,18
609,Finn Dahmen,de,GK,Mainz 05,Bundesliga,22,1998,3.0,0,0,0,0,0,0,1,0.0,1,0,0,0,0,0,1
610,Mahmoud Dahoud,de,MF,Dortmund,Bundesliga,24,1996,14.0,30,18,9,20,1,14,38,36.8,24,23,5,18,18,48,11
611,Leon Dajaku,de,FW,Union Berlin,Bundesliga,19,2001,0.4,0,0,0,0,0,0,0,,0,0,0,0,0,0,0
612,Stuart Dallas,nir,MF,Leeds United,Premier League,29,1991,37.9,74,45,46,22,6,30,88,34.1,58,41,3,38,44,118,52
613,Diogo Dalot,pt,DF,Milan,it Serie A,21,1999,12.1,32,17,23,6,3,17,34,50.0,17,18,5,13,25,57,42
614,Mikkel Damsgaard,dk,MF,Sampdoria,it Serie A,20,2000,19.7,42,21,14,20,8,22,70,31.4,48,40,4,36,24,66,17
615,Flavius Daniliuc,at,DF,Nice,Ligue 1,19,2001,16.4,23,15,15,5,3,10,21,47.6,11,17,6,11,14,37,32
616,Danilo,br,DF,Juventus,it Serie A,29,1991,32.4,62,31,37,16,9,35,66,53.0,31,32,12,20,66,128,68
617,Scott Dann,eng,DF,Crystal Palace,Premier League,33,1987,15.0,6,4,5,1,0,4,11,36.4,7,16,14,2,18,24,59
618,Tiago Dantas,pt,MF,Bayern Munich,Bundesliga,19,2000,0.8,1,1,0,0,1,0,0,,0,0,0,0,0,1,0
619,Dante,br,DF,Nice,Ligue 1,36,1983,8.6,10,5,6,4,0,3,7,42.9,4,6,4,2,10,20,20
620,Andrea Danzi,it,DF,Hellas Verona,it Serie A,21,1999,1.2,0,0,0,0,0,0,1,0.0,1,0,0,0,3,3,1
621,Ebrima Darboe,gm,MF,Roma,it Serie A,19,2001,3.6,5,2,3,1,1,3,10,30.0,7,3,0,3,8,13,0
622,Márton Dárdai,hu,DF,Hertha BSC,Bundesliga,18,2002,9.1,17,10,10,6,1,9,16,56.3,7,7,3,4,16,33,31
623,Vladimír Darida,cz,MF,Hertha BSC,Bundesliga,29,1990,21.1,34,19,11,19,4,9,31,29.0,22,34,2,32,27,61,18
624,Karl Darlow,wls,GK,Newcastle Utd,Premier League,29,1990,25.0,0,0,0,0,0,0,0,,0,0,0,0,0,0,17
625,Matteo Darmian,it,DF,Parma,it Serie A,30,1989,2.3,6,5,3,3,0,4,7,57.1,3,2,0,2,6,12,7
626,Matteo Darmian,it,DF,Inter,it Serie A,30,1989,12.9,30,16,12,7,11,16,28,57.1,12,9,2,7,17,47,35
627,Jonathan David,ca,FW,Lille,Ligue 1,20,2000,26.2,17,10,5,5,7,9,24,37.5,15,19,1,18,3,20,9
628,Alphonso Davies,ca,DF,Bayern Munich,Bundesliga,19,2000,19.6,39,27,16,17,6,28,40,70.0,12,21,1,20,28,67,33
629,Ben Davies,wls,DF,Tottenham,Premier League,27,1993,15.0,27,17,10,11,6,13,30,43.3,17,10,5,5,18,45,49
630,Tom Davies,eng,MF,Everton,Premier League,22,1998,15.8,31,18,17,12,2,16,39,41.0,23,15,9,6,34,65,21
631,Keinan Davis,eng,FW,Aston Villa,Premier League,22,1998,3.1,2,1,1,0,1,0,1,0.0,1,1,0,1,0,2,2
632,Leif Davis,eng,DF,Leeds United,Premier League,20,2000,0.4,0,0,0,0,0,0,3,0.0,3,1,0,1,1,1,0
633,Paweł Dawidowicz,pl,DF,Hellas Verona,it Serie A,25,1995,20.7,42,28,30,10,2,14,24,58.3,10,28,19,9,27,69,62
634,Craig Dawson,eng,DF,West Ham,Premier League,30,1990,21.4,11,8,7,4,0,5,12,41.7,7,26,22,4,32,43,88
635,Kevin De Bruyne,be,MF,Manchester City,Premier League,29,1991,22.2,34,21,6,18,10,13,48,27.1,35,26,1,25,9,43,10
636,Sebastien De Maio,fr,DF,Udinese,it Serie A,33,1987,9.5,15,10,6,9,0,4,5,80.0,1,16,9,7,18,33,41
637,Rodrigo De Paul,ar,MF,Udinese,it Serie A,26,1994,35.6,41,24,17,22,2,15,60,25.0,45,32,1,31,17,58,20
638,Mattia De Sciglio,it,DF,Juventus,it Serie A,27,1992,0.3,0,0,0,0,0,0,0,,0,0,0,0,0,0,1
639,Mattia De Sciglio,it,DF,Lyon,Ligue 1,27,1992,16.3,29,17,15,11,3,18,27,66.7,9,13,4,9,27,56,44
640,Lorenzo De Silvestri,it,DF,Bologna,it Serie A,32,1988,23.8,34,24,18,13,3,16,37,43.2,21,37,10,27,30,64,62
641,Thibault De Smet,be,DF,Reims,Ligue 1,22,1998,5.5,11,6,8,3,0,6,15,40.0,9,8,1,7,6,17,16
642,Lucas Deaux,fr,MF,Nîmes,Ligue 1,31,1988,19.5,47,32,20,22,5,16,49,32.7,33,20,3,17,20,67,30
643,Mathieu Debuchy,fr,DF,Saint-Étienne,Ligue 1,35,1985,23.4,58,33,37,17,4,40,62,64.5,22,27,9,18,45,103,61
644,Grégoire Defrel,mq,MF,Sassuolo,it Serie A,29,1991,14.8,13,8,5,5,3,5,13,38.5,8,9,0,9,7,20,5
645,Alessandro Deiola,it,MF,Spezia,it Serie A,24,1995,4.0,6,3,2,3,1,5,13,38.5,8,3,1,2,3,9,1
646,Alessandro Deiola,it,MF,Cagliari,it Serie A,24,1995,6.8,13,5,5,4,4,8,23,34.8,15,7,2,5,11,24,11
647,Romain Del Castillo,fr,MF,Rennes,Ligue 1,24,1996,7.2,30,11,5,14,11,5,25,20.0,20,6,0,6,3,33,4
648,Lorenzo Del Pinto,it,MF,Benevento,it Serie A,30,1990,0.1,0,0,0,0,0,0,2,0.0,2,0,0,0,0,0,0
649,Thomas Delaine,fr,DF,Metz,Ligue 1,28,1992,19.8,32,18,19,11,2,20,35,57.1,15,22,5,17,24,56,30
650,Thomas Delaney,dk,MF,Dortmund,Bundesliga,28,1991,14.3,40,30,15,20,5,11,31,35.5,20,28,10,18,22,62,15
651,Liam Delap,eng,FW,Manchester City,Premier League,17,2003,0.4,0,0,0,0,0,0,0,,0,0,0,0,0,0,0
652,Jonathan Delaplace,fr,DF,Lorient,Ligue 1,34,1986,10.1,8,5,5,1,2,7,13,53.8,6,12,5,7,17,25,19
653,Sacha Delaye,fr,MF,Montpellier,Ligue 1,18,2002,0.1,0,0,0,0,0,0,1,0.0,1,0,0,0,1,1,1
654,Cristian Dell'Orco,it,DF,Spezia,it Serie A,26,1994,2.9,1,0,1,0,0,1,3,33.3,2,8,5,3,7,8,9
655,Andy Delort,dz,FW,Montpellier,Ligue 1,28,1991,27.6,12,7,1,9,2,8,18,44.4,10,11,1,10,4,16,34
656,Fabian Delph,eng,MF,Everton,Premier League,30,1989,3.0,5,2,3,2,0,1,3,33.3,2,2,0,2,4,9,8
657,Moussa Dembélé,fr,FW,Atlético Madrid,La Liga,24,1996,1.1,0,0,0,0,0,0,1,0.0,1,0,0,0,1,1,0
658,Moussa Dembélé,fr,FW,Lyon,Ligue 1,24,1996,7.5,2,2,0,1,1,0,4,0.0,4,4,2,2,5,7,9
659,Ousmane Dembélé,fr,FW,Barcelona,La Liga,23,1997,19.7,14,9,4,9,1,6,17,35.3,11,10,0,10,9,23,3
660,Merih Demiral,tr,DF,Juventus,it Serie A,22,1998,10.4,12,9,8,4,0,5,13,38.5,8,16,9,7,21,33,40
661,Kerem Demirbay,de,MF,Leverkusen,Bundesliga,27,1993,19.4,46,31,15,26,5,19,38,50.0,19,21,4,17,8,54,6
662,Ermedin Demirović,ba,FW,Freiburg,Bundesliga,22,1998,16.6,15,9,4,6,5,2,16,12.5,14,29,5,24,0,15,27
663,Diego Demme,de,MF,Napoli,it Serie A,28,1991,17.7,56,32,26,22,8,23,63,36.5,40,14,1,13,11,67,15
664,Jason Denayer,be,DF,Lyon,Ligue 1,25,1995,29.0,25,16,16,9,0,6,13,46.2,7,36,25,11,27,52,91
665,Leander Dendoncker,be,MF,Wolves,Premier League,25,1995,27.8,54,29,29,22,3,31,60,51.7,29,38,15,23,27,81,52
666,Kévin Denkey,tg,FW,Nîmes,Ligue 1,19,2000,5.8,4,2,0,3,1,0,3,0.0,3,2,0,2,1,5,2
667,Emmanuel Dennis,ng,FW,Köln,Bundesliga,22,1997,5.3,13,7,6,5,2,1,6,16.7,5,6,0,6,0,13,0
668,Stefano Denswil,sr,DF,Bologna,it Serie A,27,1993,1.3,2,1,1,1,0,0,1,0.0,1,1,0,1,1,3,1
669,Fabio Depaoli,it,DF,Benevento,it Serie A,23,1997,12.4,25,13,15,6,4,15,32,46.9,17,16,4,12,12,37,38
670,Fabio Depaoli,it,MF,Sampdoria,it Serie A,23,1997,0.9,1,0,0,1,0,0,2,0.0,2,0,0,0,1,2,1
671,Fabio Depaoli,it,DF,Atalanta,it Serie A,23,1997,2.1,3,2,0,1,2,1,2,50.0,1,4,0,4,3,6,2
672,Clément Depres,fr,FW,Nîmes,Ligue 1,25,1994,0.2,0,0,0,0,0,0,0,,0,0,0,0,0,0,0
673,Mike van der Hoorn,nl,DF,Arminia,Bundesliga,27,1992,15.1,8,4,3,5,0,1,3,33.3,2,12,8,4,27,35,73
674,Kastriot Dermaku,al,DF,Parma,it Serie A,28,1992,1.1,1,1,1,0,0,0,0,,0,2,1,1,2,3,8
675,Kiril Despodov,bg,FW,Cagliari,it Serie A,23,1996,0.1,1,1,0,1,0,1,1,100.0,0,0,0,0,0,1,0
676,Sergiño Dest,us,DF,Barcelona,La Liga,19,2000,21.2,31,16,23,6,2,18,32,56.3,14,25,4,21,10,41,24
677,Mattia Destro,it,FW,Genoa,it Serie A,29,1991,17.8,6,3,0,3,3,2,9,22.2,7,11,0,11,4,10,8
678,Gerard Deulofeu,es,FW,Udinese,it Serie A,26,1994,6.6,2,2,1,1,0,2,12,16.7,10,2,0,2,3,5,0
679,Deyverson,br,FW,Alavés,La Liga,29,1991,9.7,6,4,3,1,2,2,13,15.4,11,9,0,9,9,15,13
680,Jacopo Dezi,it,FW,Parma,it Serie A,28,1992,0.9,4,3,0,2,2,3,6,50.0,3,2,0,2,0,4,0
681,Samuel Di Carmine,it,FW,Hellas Verona,it Serie A,31,1988,5.6,1,2,0,1,0,0,3,0.0,3,1,0,1,0,1,5
682,Samuel Di Carmine,it,FW,Crotone,it Serie A,31,1988,5.3,2,2,1,0,1,1,3,33.3,2,2,0,2,0,2,5
683,Giovanni Di Lorenzo,it,DF,Napoli,it Serie A,26,1993,36.0,79,50,54,21,4,43,75,57.3,32,37,13,24,35,114,64
684,Ángel Di María,ar,FW,Paris S-G,Ligue 1,32,1988,20.6,26,17,6,8,12,11,45,24.4,34,14,1,13,6,32,7
685,Alessandro Di Pardo,it,FW,Juventus,it Serie A,21,1999,0.2,0,0,0,0,0,0,0,,0,1,1,0,0,0,0
686,Giuseppe Di Serio,it,FW,Benevento,it Serie A,19,2001,3.2,2,2,1,1,0,0,4,0.0,4,5,0,5,0,2,4
687,Boulaye Dia,sn,FW,Reims,Ligue 1,23,1996,32.6,23,12,3,11,9,4,22,18.2,18,19,5,14,12,35,37
688,Abdoulay Diaby,ml,DF,Getafe,La Liga,29,1991,0.2,2,0,0,2,0,0,0,,0,2,0,2,0,2,0
689,Moussa Diaby,fr,FW,Leverkusen,Bundesliga,21,1999,26.5,10,6,4,5,1,6,20,30.0,14,11,0,11,12,22,5
690,Mbaye Diagne,sn,FW,West Brom,Premier League,28,1991,13.2,4,3,3,0,1,1,4,25.0,3,2,1,1,1,5,16
691,Mouctar Diakhaby,gn,DF,Valencia,La Liga,23,1996,23.1,16,8,10,6,0,8,12,66.7,4,28,21,7,27,43,102
692,Abdou Diallo,sn,DF,Paris S-G,Ligue 1,24,1996,16.6,16,11,9,5,2,8,13,61.5,5,15,8,7,25,41,36
693,Amad Diallo,ci,FW,Manchester Utd,Premier League,18,2002,1.8,3,3,1,2,0,0,0,,0,2,1,1,0,3,1
694,Amad Diallo,ci,MF,Atalanta,it Serie A,18,2002,0.2,0,0,0,0,0,0,0,,0,0,0,0,0,0,0
695,Habib Diallo,sn,FW,Strasbourg,Ligue 1,25,1995,25.8,11,6,3,6,2,7,18,38.9,11,12,2,10,13,24,12
696,Habib Diallo,sn,FW,Metz,Ligue 1,25,1995,1.6,1,1,0,1,0,1,1,100.0,0,0,0,0,0,1,5
697,Ibrahima Diallo,fr,MF,Southampton,Premier League,21,1999,11.3,29,16,11,17,1,9,16,56.3,7,10,1,9,10,39,12
698,Ibrahima Diallo,fr,MF,Brest,Ligue 1,21,1999,4.9,14,9,2,9,3,4,8,50.0,4,4,0,4,3,17,3
699,Amadou Diambo,gh,FW,Benevento,it Serie A,19,2001,0.0,0,0,0,0,0,0,0,,0,0,0,0,0,0,0
700,Grady Diangana,cd,MF,West Brom,Premier League,22,1998,13.7,35,19,19,9,7,19,43,44.2,24,16,2,14,16,51,9
701,Stéphane Diarra,fr,MF,Lorient,Ligue 1,21,1998,2.2,0,0,0,0,0,0,7,0.0,7,6,1,5,4,4,1
702,Rúben Dias,pt,DF,Manchester City,Premier League,23,1997,31.6,24,13,13,8,3,4,16,25.0,12,31,23,8,35,59,92
703,Krépin Diatta,sn,MF,Monaco,Ligue 1,21,1999,4.3,4,3,1,1,2,1,3,33.3,2,5,1,4,4,8,1
704,Amadou Diawara,gn,MF,Roma,it Serie A,23,1997,7.3,10,8,4,6,0,2,8,25.0,6,11,2,9,12,22,4
705,Brahim Díaz,ma,MF,Milan,it Serie A,20,1999,13.6,18,10,7,7,4,10,23,43.5,13,10,0,10,2,20,2
706,Víctor Díaz,es,DF,Granada,La Liga,32,1988,9.2,21,10,13,6,2,10,19,52.6,9,14,8,6,16,37,39
707,Daniel Didavi,de,MF,Stuttgart,Bundesliga,30,1990,10.8,16,6,2,9,5,7,12,58.3,5,10,0,10,3,19,8
708,Bamba Dieng,sn,FW,Marseille,Ligue 1,20,2000,1.4,5,3,3,2,0,2,4,50.0,2,2,0,2,0,5,0
709,Eric Dier,eng,DF,Tottenham,Premier League,26,1994,28.0,23,14,13,10,0,11,18,61.1,7,37,31,6,23,46,123
710,Daan Dierckx,be,DF,Parma,it Serie A,17,2003,5.2,5,4,5,0,0,3,5,60.0,2,10,6,4,13,18,21
711,Lucas Digne,fr,DF,Everton,Premier League,27,1993,29.8,63,38,40,16,7,29,54,53.7,25,42,4,38,31,94,87
712,Mitchell Dijks,nl,DF,Bologna,it Serie A,27,1993,16.5,21,14,15,5,1,12,21,57.1,9,17,2,15,17,38,35
713,Javairô Dilrosun,nl,FW,Hertha BSC,Bundesliga,22,1998,5.9,5,3,2,2,1,1,6,16.7,5,5,0,5,4,9,3
714,Federico Dimarco,it,DF,Hellas Verona,it Serie A,22,1997,29.0,32,19,23,7,2,13,28,46.4,15,18,9,9,47,79,50
715,Junior Dina Ebimbe,fr,FW,Dijon,Ligue 1,19,2000,23.8,38,25,14,19,5,15,45,33.3,30,17,1,16,14,52,9
716,Tristan Dingomé,cm,MF,Reims,Ligue 1,29,1991,0.2,0,0,0,0,0,0,1,0.0,1,0,0,0,0,0,0
717,Eren Dinkçi,de,MF,Werder Bremen,Bundesliga,18,2001,1.2,1,1,1,0,0,0,1,0.0,1,4,0,4,2,3,1
718,Sinaly Diomande,ci,DF,Lyon,Ligue 1,19,2001,12.6,10,7,8,1,1,5,14,35.7,9,19,15,4,33,43,53
719,Lois Diony,fr,FW,Angers,Ligue 1,27,1992,19.4,15,10,3,9,3,4,18,22.2,14,6,3,3,5,20,16
720,Issa Diop,fr,DF,West Ham,Premier League,23,1997,15.3,20,14,12,8,0,7,18,38.9,11,32,22,10,22,42,59
721,Papakouli Diop,sn,MF,Eibar,La Liga,34,1986,25.8,43,29,15,22,6,12,41,29.3,29,23,5,18,39,82,34
722,Sofiane Diop,fr,MF,Monaco,Ligue 1,20,2000,22.5,49,34,17,25,7,18,53,34.0,35,25,1,24,31,80,15
723,Andy Diouf,fr,FW,Rennes,Ligue 1,17,2003,0.1,0,0,0,0,0,0,0,,0,0,0,0,0,0,0
724,Yehvann Diouf,fr,GK,Reims,Ligue 1,20,1999,1.5,0,0,0,0,0,0,0,,0,0,0,0,0,0,0
725,Assane Dioussé,sn,DF,Saint-Étienne,Ligue 1,22,1997,0.0,0,0,0,0,0,0,0,,0,0,0,0,0,0,0
726,Jonas Dirkner,de,MF,Hertha BSC,Bundesliga,18,2002,0.2,0,0,0,0,0,0,0,,0,0,0,0,0,0,0
727,Axel Disasi,fr,DF,Monaco,Ligue 1,22,1998,22.3,29,20,17,12,0,20,35,57.1,15,18,11,7,26,55,66
728,Tiago Djaló,pt,DF,Lille,Ligue 1,20,2000,9.7,22,13,14,5,3,15,23,65.2,8,10,4,6,9,31,23
729,Djené,tg,DF,Getafe,La Liga,28,1991,32.7,61,39,31,26,4,26,34,76.5,8,24,11,13,42,103,96
730,Moussa Djenepo,ml,MF,Southampton,Premier League,22,1998,13.8,52,27,27,17,8,28,63,44.4,35,24,2,22,10,62,14
731,Koffi Djidji,ci,DF,Crotone,it Serie A,27,1992,16.9,39,28,30,8,1,10,20,50.0,10,35,20,15,28,67,73
732,Alexander Djiku,gh,DF,Strasbourg,Ligue 1,25,1994,28.4,60,41,45,13,2,32,52,61.5,20,28,10,18,91,151,104
733,Berat Djimsiti,al,DF,Atalanta,it Serie A,27,1993,29.2,41,29,27,12,2,17,34,50.0,17,34,20,14,62,103,89
734,Marko Dmitrović,rs,GK,Eibar,La Liga,28,1992,34.7,4,3,4,0,0,2,4,50.0,2,0,0,0,0,4,16
735,Ritsu Doan,jp,MF,Arminia,Bundesliga,22,1998,30.8,53,31,22,19,12,19,52,36.5,33,42,1,41,31,84,11
736,Mihai Dobre,ro,FW,Dijon,Ligue 1,21,1998,5.9,12,5,6,2,4,7,14,50.0,7,5,0,5,10,22,3
737,Matt Doherty,ie,DF,Tottenham,Premier League,28,1992,13.8,29,15,15,10,4,13,33,39.4,20,20,5,15,23,52,46
738,Jeremy Doku,be,MF,Rennes,Ligue 1,18,2002,25.7,44,25,9,24,11,11,26,42.3,15,18,1,17,11,55,1
739,Kasper Dolberg,dk,FW,Nice,Ligue 1,22,1997,21.4,6,2,1,3,2,2,11,18.2,9,11,2,9,6,12,19
740,Keagan Dolly,za,MF,Montpellier,Ligue 1,27,1993,5.0,7,2,6,0,1,4,8,50.0,4,3,0,3,5,12,2
741,Jaume Doménech,es,GK,Valencia,La Liga,29,1990,28.0,1,1,1,0,0,1,2,50.0,1,1,0,1,0,1,16
742,Carlos Dominguez,es,DF,Celta Vigo,La Liga,19,2001,4.0,5,4,4,1,0,3,6,50.0,3,5,3,2,6,11,24
743,Nicolás Domínguez,ar,MF,Bologna,it Serie A,22,1998,13.9,48,28,26,17,5,15,37,40.5,22,26,7,19,24,72,20
744,John Donald,es,DF,Elche,La Liga,19,2000,0.6,0,0,0,0,0,0,0,,0,0,0,0,0,0,1
745,Ji Dong-won,kr,FW,Mainz 05,Bundesliga,29,1991,0.7,1,1,1,0,0,0,0,,0,1,0,1,2,3,0
746,Anastasios Donis,gr,MF,Reims,Ligue 1,23,1996,1.1,4,1,2,0,2,1,1,100.0,0,0,0,0,0,4,0
747,Gianluigi Donnarumma,it,GK,Milan,it Serie A,21,1999,37.0,0,0,0,0,0,0,1,0.0,1,1,0,1,1,1,23
748,Bas Dost,nl,FW,Eint Frankfurt,Bundesliga,31,1989,9.1,3,2,1,1,1,2,5,40.0,3,5,1,4,2,5,8
749,Abdoulaye Doucouré,ml,MF,Everton,Premier League,27,1993,27.1,52,32,25,19,8,14,43,32.6,29,24,7,17,39,91,31
750,Cheick Doucouré,ml,MF,Lens,Ligue 1,20,2000,29.2,87,47,40,42,5,32,65,49.2,33,20,4,16,52,139,26
751,Fodé Doucouré,ml,DF,Reims,Ligue 1,19,2001,3.7,11,8,7,4,0,4,9,44.4,5,2,0,2,4,15,11
752,Mahamadou Doucouré,ml,FW,Nîmes,Ligue 1,20,2000,0.5,1,1,1,0,0,1,1,100.0,0,0,0,0,0,1,0
753,Cheick Doukouré,ci,MF,Levante,La Liga,27,1992,1.1,5,4,2,1,2,3,4,75.0,1,2,0,2,3,8,0
754,Idrissa Doumbia,ci,MF,Huesca,La Liga,22,1998,8.7,15,8,6,7,2,5,13,38.5,8,6,3,3,7,22,9
755,Moussa Doumbia,ml,MF,Reims,Ligue 1,25,1994,10.0,10,6,4,4,2,4,22,18.2,18,5,1,4,10,20,4
756,Souleyman Doumbia,ci,DF,Angers,Ligue 1,23,1996,24.7,48,33,25,19,4,22,36,61.1,14,18,4,14,42,90,50
757,Aleksandar Dragović,at,DF,Leverkusen,Bundesliga,29,1991,12.6,11,7,5,5,1,9,13,69.2,4,17,5,12,13,24,33
758,Bartłomiej Drągowski,pl,GK,Fiorentina,it Serie A,22,1997,35.0,1,0,1,0,0,1,1,100.0,0,0,0,0,1,2,13
759,Denis Drăguș,ro,FW,Crotone,it Serie A,21,1999,2.0,3,1,0,0,3,0,4,0.0,4,4,0,4,1,4,0
760,Radu Drăgușin,ro,DF,Juventus,it Serie A,18,2002,0.0,0,0,0,0,0,0,0,,0,0,0,0,0,0,0
761,Mouhamadou Drammeh,fr,MF,Reims,Ligue 1,21,1999,1.9,0,0,0,0,0,0,2,0.0,2,0,0,0,2,2,7
762,Julian Draxler,de,MF,Paris S-G,Ligue 1,26,1993,11.8,13,6,5,6,2,5,20,25.0,15,4,0,4,14,27,0
763,Dominick Drexler,de,MF,Köln,Bundesliga,30,1990,13.7,36,26,15,18,3,12,30,40.0,18,5,1,4,14,50,15
764,Matthieu Dreyer,fr,GK,Lorient,Ligue 1,31,1989,15.0,0,0,0,0,0,0,0,,0,0,0,0,0,0,4
765,Domingos Duarte,pt,DF,Granada,La Liga,25,1995,26.3,32,20,18,12,2,14,21,66.7,7,29,20,9,29,61,86
766,Léo Duarte,br,DF,Milan,it Serie A,24,1996,0.2,1,1,0,1,0,0,0,,0,0,0,0,1,2,0
767,Óscar Duarte,cr,DF,Levante,La Liga,31,1989,22.9,22,13,17,5,0,10,18,55.6,8,23,15,8,36,58,97
768,Rubén Duarte,es,DF,Alavés,La Liga,24,1995,28.3,55,30,28,21,6,23,52,44.2,29,44,6,38,66,121,72
769,Leo Dubois,fr,DF,Lyon,Ligue 1,25,1994,32.3,38,26,19,16,3,18,36,50.0,18,27,9,18,31,69,69
770,Martin Dúbravka,sk,GK,Newcastle Utd,Premier League,31,1989,13.0,0,0,0,0,0,0,0,,0,0,0,0,0,0,3
771,Ondrej Duda,sk,FW,Köln,Bundesliga,25,1994,28.2,36,14,13,18,5,8,39,20.5,31,28,2,26,19,55,20
772,Unai Dufur,es,DF,Eibar,La Liga,21,1999,0.7,2,2,2,0,0,2,4,50.0,2,0,0,0,1,3,0
773,Haris Duljević,ba,MF,Nîmes,Ligue 1,26,1993,8.6,15,9,4,7,4,6,22,27.3,16,3,0,3,8,23,1
774,Paul Dummett,wls,DF,Newcastle Utd,Premier League,28,1991,13.9,16,7,11,5,0,13,21,61.9,8,12,7,5,16,32,74
775,Alfred Duncan,gh,MF,Fiorentina,it Serie A,27,1993,1.8,3,0,1,1,1,0,2,0.0,2,2,0,2,2,5,0
776,Alfred Duncan,gh,MF,Cagliari,it Serie A,27,1993,11.9,18,10,8,9,1,4,21,19.0,17,8,0,8,16,34,8
777,Lewis Dunk,eng,DF,Brighton,Premier League,28,1991,32.6,30,15,20,8,2,16,23,69.6,7,29,20,9,32,62,106
778,Jimmy Dunne,ie,DF,Burnley,Premier League,22,1997,3.0,3,3,2,1,0,1,2,50.0,1,3,2,1,6,9,16
779,Erik Durm,de,DF,Eint Frankfurt,Bundesliga,28,1992,16.4,17,13,7,9,1,8,21,38.1,13,19,5,14,29,46,26
780,Hugo Duro,es,FW,Real Madrid,La Liga,20,1999,0.6,0,0,0,0,0,0,0,,0,1,0,1,0,0,0
781,Jean-Kevin Duverne,ht,DF,Brest,Ligue 1,23,1997,22.5,38,21,24,14,0,15,32,46.9,17,24,16,8,30,68,70
782,Paulo Dybala,ar,FW,Juventus,it Serie A,26,1993,12.6,14,8,3,4,7,2,14,14.3,12,15,0,15,1,15,1
783,Edin Džeko,ba,FW,Roma,it Serie A,34,1986,20.3,8,6,2,3,3,3,9,33.3,6,9,4,5,1,9,11
784,Steeve-Mike Ebongue,fr,MF,Genoa,it Serie A,19,2001,0.6,2,1,1,0,1,0,3,0.0,3,1,0,1,0,2,0
785,Enzo Ebosse,cm,DF,Angers,Ligue 1,21,1999,2.9,5,3,5,0,0,3,4,75.0,1,1,1,0,2,7,13
786,Bruno Ecuele Manga,ga,DF,Dijon,Ligue 1,32,1988,38.0,52,38,46,6,0,29,40,72.5,11,50,33,17,57,109,165
787,Simone Edera,it,DF,Torino,it Serie A,23,1997,0.6,3,1,2,1,0,3,4,75.0,1,0,0,0,1,4,1
788,Ederson,br,GK,Manchester City,Premier League,26,1993,36.0,3,1,3,0,0,3,4,75.0,1,0,0,0,0,3,11
789,Kyle Edwards,eng,MF,West Brom,Premier League,22,1998,1.3,3,2,1,1,1,0,0,,0,2,0,2,1,4,0
790,John Egan,ie,DF,Sheffield Utd,Premier League,27,1992,29.2,41,21,29,12,0,22,39,56.4,17,43,31,12,41,82,131
791,Johannes Eggestein,de,FW,Werder Bremen,Bundesliga,22,1998,0.4,0,0,0,0,0,0,1,0.0,1,0,0,0,1,1,2
792,Maximilian Eggestein,de,MF,Werder Bremen,Bundesliga,23,1996,32.7,57,42,22,29,6,21,46,45.7,25,30,5,25,43,100,36
793,Lilian Egloff,de,MF,Stuttgart,Bundesliga,17,2002,0.2,0,0,0,0,0,0,0,,0,0,0,0,0,0,0
794,Kingsley Ehizibue,nl,DF,Köln,Bundesliga,25,1995,12.6,32,19,22,9,1,10,17,58.8,7,19,5,14,18,50,42
795,Albin Ekdal,se,MF,Sampdoria,it Serie A,31,1989,25.5,56,29,21,32,3,23,65,35.4,42,31,12,19,49,105,35
796,Hugo Ekitike,fr,FW,Reims,Ligue 1,18,2002,1.0,1,1,0,0,1,0,1,0.0,1,0,0,0,0,1,0
797,Anthony Elanga,se,FW,Manchester Utd,Premier League,18,2002,1.7,4,2,3,1,0,4,5,80.0,1,1,1,0,1,5,1
798,Niclas Eliasson,se,MF,Nîmes,Ligue 1,24,1995,20.0,28,14,9,12,7,11,24,45.8,13,20,1,19,23,51,16
799,Elif Elmas,mk,MF,Napoli,it Serie A,20,1999,8.2,15,4,3,6,6,7,12,58.3,5,11,1,10,2,17,10
800,Ahmed Elmohamady,eg,DF,Aston Villa,Premier League,32,1987,9.3,17,13,12,4,1,9,14,64.3,5,6,3,3,17,34,26
801,Mohamed Elneny,eg,MF,Arsenal,Premier League,28,1992,17.2,14,6,7,7,0,7,28,25.0,21,11,4,7,24,38,20
802,Aritz Elustondo,es,DF,Real Sociedad,La Liga,26,1994,20.9,30,16,21,7,2,18,22,81.8,4,12,5,7,15,45,63
803,Nico Elvedi,ch,DF,Gladbach,Bundesliga,23,1996,28.2,49,35,36,12,1,25,37,67.6,12,38,22,16,65,114,123
804,Rodrigo Ely,br,DF,Alavés,La Liga,26,1993,5.2,5,2,3,2,0,3,4,75.0,1,2,1,1,7,12,23
805,Breel Embolo,ch,FW,Gladbach,Bundesliga,23,1997,16.0,15,10,1,13,1,0,6,0.0,6,16,1,15,8,23,8
806,Emerson,br,DF,Betis,La Liga,21,1999,33.2,91,52,62,25,4,43,78,55.1,35,33,6,27,61,152,102
807,Renaud Emond,be,FW,Nantes,Ligue 1,28,1991,3.9,0,0,0,0,0,0,1,0.0,1,2,0,2,0,0,1
808,Alan Empereur,br,DF,Hellas Verona,it Serie A,26,1994,2.4,0,0,0,0,0,0,0,,0,1,1,0,6,6,7
809,Youssef En-Nesyri,ma,FW,Sevilla,La Liga,23,1997,25.7,17,11,2,9,6,4,21,19.0,17,15,0,15,8,25,23
810,Keita Endo,jp,MF,Union Berlin,Bundesliga,22,1997,5.1,8,3,1,5,2,3,9,33.3,6,5,2,3,6,14,4
811,Wataru Endo,jp,MF,Stuttgart,Bundesliga,27,1993,32.8,65,44,25,34,6,29,71,40.8,42,53,14,39,51,116,59
812,Sergi Enrich,es,FW,Eibar,La Liga,30,1990,15.6,21,15,6,7,8,9,22,40.9,13,11,0,11,6,27,5
813,Christian Eriksen,dk,MF,Inter,it Serie A,28,1992,15.4,12,6,6,4,2,7,20,35.0,13,16,1,15,9,21,13
814,Martin Erlic,hr,DF,Spezia,it Serie A,22,1998,20.0,23,14,16,6,1,11,20,55.0,9,22,16,6,41,64,71
815,Patrick Erras,de,FW,Werder Bremen,Bundesliga,25,1995,0.3,0,0,0,0,0,0,1,0.0,1,0,0,0,0,0,0
816,Gonzalo Escalante,ar,MF,Lazio,it Serie A,27,1993,8.1,26,13,11,14,1,8,28,28.6,20,10,3,7,19,45,13
817,Aarón Escandell,es,GK,Granada,La Liga,24,1995,5.0,1,1,1,0,0,1,1,100.0,0,0,0,0,0,1,6
818,Dani Escriche,es,FW,Huesca,La Liga,22,1998,9.5,9,7,5,2,2,3,10,30.0,7,11,0,11,8,17,5
819,Sergio Escudero,es,DF,Sevilla,La Liga,30,1989,6.3,12,8,6,5,1,6,12,50.0,6,5,2,3,9,21,7
820,Alfonso Espino,uy,DF,Cádiz,La Liga,28,1992,28.9,92,48,63,28,1,43,85,50.6,42,30,5,25,41,133,74
821,Vicente Esquerdo,es,MF,Valencia,La Liga,21,1999,2.6,7,4,5,2,0,4,6,66.7,2,4,2,2,8,15,1
822,Nahuel Estévez,ar,MF,Spezia,it Serie A,24,1995,19.6,13,5,4,6,3,5,32,15.6,27,23,5,18,20,33,22
823,Pervis Estupiñán,ec,DF,Villarreal,La Liga,22,1998,13.0,37,17,23,12,2,14,23,60.9,9,10,2,8,35,72,14
824,Yoann Etienne,fr,DF,Lorient,Ligue 1,23,1997,1.0,2,0,1,1,0,1,1,100.0,0,1,0,1,1,3,2
825,Xabier Etxeita,es,DF,Getafe,La Liga,32,1987,9.8,8,4,5,3,0,7,14,50.0,7,6,3,3,13,21,38
826,Jonny Evans,nir,DF,Leicester City,Premier League,32,1988,27.5,25,12,22,2,1,14,20,70.0,6,8,3,5,46,71,98
827,Edu Expósito,es,MF,Eibar,La Liga,23,1996,27.3,51,30,16,31,4,20,66,30.3,46,25,4,21,22,73,17
828,Valentin Eysseric,fr,MF,Fiorentina,it Serie A,28,1992,8.1,14,8,6,7,1,5,11,45.5,6,11,0,11,7,21,8
829,Eberechi Eze,eng,MF,Crystal Palace,Premier League,22,1998,28.4,27,14,11,13,3,16,35,45.7,19,19,3,16,24,51,9
830,Jokin Ezkieta,es,GK,Athletic Club,La Liga,23,1996,1.0,0,0,0,0,0,0,0,,0,0,0,0,0,0,0
831,Łukasz Fabiański,pl,GK,West Ham,Premier League,35,1985,35.0,1,0,1,0,0,1,1,100.0,0,1,0,1,1,2,12
832,Fabinho,br,DF,Liverpool,Premier League,26,1993,28.5,58,31,21,29,8,27,54,50.0,27,28,10,18,44,102,66
833,Fábio,br,DF,Nantes,Ligue 1,30,1990,16.7,62,37,37,23,2,35,61,57.4,26,29,8,21,37,99,49
834,Cesc Fàbregas,es,MF,Monaco,Ligue 1,33,1987,9.7,20,12,6,9,5,9,22,40.9,13,11,1,10,13,33,3
835,Bandiougou Fadiga,fr,FW,Paris S-G,Ligue 1,19,2001,0.7,1,0,1,0,0,0,0,,0,0,0,0,0,1,0
836,Bandiougou Fadiga,fr,MF,Brest,Ligue 1,19,2001,0.5,0,0,0,0,0,0,2,0.0,2,0,0,0,0,0,0
837,Wout Faes,be,DF,Reims,Ligue 1,22,1998,32.2,35,22,26,9,0,20,39,51.3,19,40,31,9,68,103,144
838,Nicolò Fagioli,it,MF,Juventus,it Serie A,19,2001,0.2,0,0,0,0,0,0,0,,0,0,0,0,0,0,1
839,Ralf Fährmann,de,GK,Schalke 04,Bundesliga,31,1988,20.8,2,1,2,0,0,1,2,50.0,1,0,0,0,1,3,9
840,Romain Faivre,fr,MF,Brest,Ligue 1,22,1998,32.1,54,27,26,23,5,21,54,38.9,33,30,0,30,30,84,18
841,Fali,es,DF,Cádiz,La Liga,26,1993,29.3,42,25,24,15,3,16,37,43.2,21,28,15,13,32,74,119
842,Iago Falque,es,MF,Benevento,it Serie A,30,1990,4.0,4,2,2,2,0,1,6,16.7,5,4,1,3,0,4,1
843,Andri Fannar Baldursson,is,MF,Bologna,it Serie A,18,2002,2.4,6,6,1,2,3,1,3,33.3,2,3,1,2,3,9,7
844,Paolo Faragò,it,DF,Bologna,it Serie A,27,1993,0.3,1,1,1,0,0,1,2,50.0,1,1,0,1,0,1,0
845,Paolo Faragò,it,DF,Cagliari,it Serie A,27,1993,4.1,13,9,10,3,0,9,20,45.0,11,3,2,1,6,19,15
846,Davide Faraoni,it,DF,Hellas Verona,it Serie A,28,1991,32.1,62,33,36,19,7,28,51,54.9,23,48,17,31,49,111,83
847,Mohamed Fares,dz,DF,Lazio,it Serie A,24,1996,12.7,20,15,9,7,4,11,19,57.9,8,14,1,13,16,36,21
848,Diego Farias,br,FW,Spezia,it Serie A,30,1990,16.8,9,5,4,1,4,4,21,19.0,17,12,0,12,13,22,3
849,Wuilker Faríñez,ve,GK,Lens,Ligue 1,22,1998,1.2,0,0,0,0,0,0,0,,0,0,0,0,0,0,1
850,Noah Fatar,fr,FW,Angers,Ligue 1,18,2002,0.2,1,0,0,0,1,0,0,,0,0,0,0,0,1,0
851,Ansu Fati,es,FW,Barcelona,La Liga,17,2002,4.8,9,4,2,4,3,2,10,20.0,8,4,0,4,3,12,1
852,Julien Faussurier,fr,DF,Brest,Ligue 1,33,1987,10.6,16,11,6,8,2,11,25,44.0,14,12,4,8,9,25,10
853,Andrea Favilli,it,FW,Hellas Verona,it Serie A,23,1997,3.8,3,1,0,1,2,2,3,66.7,1,2,0,2,0,3,2
854,Federico Fazio,ar,DF,Roma,it Serie A,33,1987,4.5,3,2,3,0,0,3,4,75.0,1,3,3,0,7,10,18
855,Nabil Fekir,fr,MF,Betis,La Liga,27,1993,29.1,45,23,9,22,14,7,43,16.3,36,31,2,29,8,53,2
856,Felipe,br,DF,Atlético Madrid,La Liga,31,1989,22.9,29,17,19,10,0,18,23,78.3,5,30,15,15,36,65,128
857,Luiz Felipe,it,DF,Lazio,it Serie A,23,1997,10.1,32,20,19,11,2,16,24,66.7,8,20,9,11,21,53,29
858,João Félix,pt,FW,Atlético Madrid,La Liga,20,1999,17.5,8,4,1,6,1,4,17,23.5,13,3,0,3,5,13,2
859,Ohis Felix Uduokhai,de,DF,Augsburg,Bundesliga,22,1997,29.0,33,24,19,10,4,18,27,66.7,9,48,25,23,54,87,164
860,Zinedine Ferhat,dz,FW,Nîmes,Ligue 1,27,1993,32.9,36,21,18,9,9,18,39,46.2,21,22,0,22,32,68,38
861,Bruno Fernandes,pt,MF,Manchester Utd,Premier League,25,1994,34.4,57,30,16,29,12,26,100,26.0,74,38,0,38,26,83,29
862,Edimilson Fernandes,ch,MF,Mainz 05,Bundesliga,24,1996,9.3,8,4,4,4,0,4,7,57.1,3,12,4,8,29,37,25
863,Aitor Fernández,es,GK,Levante,La Liga,29,1991,29.0,0,0,0,0,0,0,0,,0,0,0,0,2,2,17
864,Álex Fernández,es,MF,Cádiz,La Liga,27,1992,21.6,19,9,8,8,3,8,30,26.7,22,14,1,13,22,41,15
865,Álvaro Fernández,es,GK,Huesca,La Liga,22,1998,22.0,1,1,0,1,0,1,3,33.3,2,0,0,0,2,3,7
866,Andrés Fernández,es,GK,Huesca,La Liga,33,1986,16.0,0,0,0,0,0,0,0,,0,0,0,0,0,0,3
867,Augusto Fernández,ar,MF,Cádiz,La Liga,34,1986,4.1,11,3,5,6,0,2,13,15.4,11,5,1,4,9,20,5
868,Carlos Fernández,es,FW,Sevilla,La Liga,24,1996,1.6,1,0,1,0,0,0,2,0.0,2,3,1,2,1,2,0
869,Carlos Fernández,es,FW,Real Sociedad,La Liga,24,1996,4.3,3,2,0,2,1,1,8,12.5,7,6,1,5,0,3,6
870,Federico Fernández,ar,DF,Newcastle Utd,Premier League,31,1989,23.1,29,22,23,5,1,17,21,81.0,4,41,31,10,17,46,147
871,Joaquín Fernández,es,DF,Valladolid,La Liga,24,1996,23.0,30,16,21,8,1,12,21,57.1,9,24,15,9,43,73,113
872,Fernandinho,br,MF,Manchester City,Premier League,35,1985,13.2,31,17,8,14,9,20,43,46.5,23,11,2,9,23,54,17
873,Fernando,br,MF,Sevilla,La Liga,33,1987,28.3,54,28,24,25,5,23,43,53.5,20,25,11,14,41,95,70
874,Alex Ferrari,it,DF,Sampdoria,it Serie A,26,1994,9.8,27,15,16,9,2,15,24,62.5,9,18,6,12,23,50,26
875,David Ferreiro,es,MF,Huesca,La Liga,32,1988,28.1,25,12,12,8,5,8,49,16.3,41,21,1,20,25,50,15
876,Salvador Ferrer,es,DF,Spezia,it Serie A,22,1998,13.2,20,10,10,8,2,8,22,36.4,14,13,4,9,24,44,37
877,Facundo Ferreyra,ar,FW,Celta Vigo,La Liga,29,1991,3.3,4,3,1,2,1,0,2,0.0,2,5,0,5,2,6,2
878,Jordan Ferri,fr,MF,Montpellier,Ligue 1,28,1992,28.6,58,40,34,22,2,31,103,30.1,72,30,5,25,8,66,18
879,Marco Festa,it,GK,Crotone,it Serie A,28,1992,1.0,0,0,0,0,0,0,0,,0,0,0,0,0,0,0
880,Fidel,es,MF,Elche,La Liga,30,1989,26.6,46,30,28,15,3,25,64,39.1,39,22,2,20,16,62,14
881,Sam Field,eng,MF,West Brom,Premier League,22,1998,0.7,5,5,3,2,0,0,0,,0,4,1,3,2,7,4
882,Alfreð Finnbogason,is,FW,Augsburg,Bundesliga,31,1989,6.0,2,1,0,1,1,0,1,0.0,1,7,1,6,1,3,4
883,Roberto Firmino,br,FW,Liverpool,Premier League,28,1991,31.5,33,15,3,17,13,6,32,18.8,26,42,5,37,11,44,12
884,Junior Firpo,do,DF,Barcelona,La Liga,23,1996,3.2,1,1,1,0,0,0,1,0.0,1,5,3,2,4,5,7
885,Will Fish,eng,FW,Manchester Utd,Premier League,17,2003,0.0,0,0,0,0,0,0,0,,0,0,0,0,0,0,0
886,John Fleck,sct,MF,Sheffield Utd,Premier League,28,1991,28.6,51,33,28,18,5,26,83,31.3,57,26,4,22,28,79,12
887,Mark Flekken,nl,GK,Freiburg,Bundesliga,27,1993,3.0,0,0,0,0,0,0,0,,0,0,0,0,0,0,1
888,Florian Flick,de,MF,Schalke 04,Bundesliga,20,2000,4.0,10,7,4,6,0,7,16,43.8,9,4,3,1,7,17,5
889,Alexis Flips,fr,MF,Reims,Ligue 1,20,2000,0.5,0,0,0,0,0,0,2,0.0,2,0,0,0,0,0,1
890,Alessandro Florenzi,it,DF,Paris S-G,Ligue 1,29,1991,17.1,24,16,9,9,6,12,29,41.4,17,7,1,6,17,41,25
891,Kingsley Fobi,gh,DF,Granada,La Liga,21,1998,0.5,0,0,0,0,0,0,0,,0,0,0,0,1,1,1
892,Phil Foden,eng,FW,Manchester City,Premier League,20,2000,18.0,22,11,12,8,2,9,23,39.1,14,9,0,9,11,33,11
893,Mamadou Fofana,ml,MF,Metz,Ligue 1,22,1998,11.9,25,11,17,8,0,7,31,22.6,24,14,2,12,18,43,36
894,Seko Fofana,ci,MF,Lens,Ligue 1,25,1995,25.7,16,8,3,10,3,4,26,15.4,22,16,5,11,34,50,23
895,Wesley Fofana,fr,DF,Leicester City,Premier League,19,2000,25.1,51,37,27,22,2,31,46,67.4,15,28,16,12,61,112,94
896,Wesley Fofana,fr,DF,Saint-Étienne,Ligue 1,19,2000,3.5,6,4,6,0,0,3,4,75.0,1,3,3,0,8,14,14
897,Youssouf Fofana,fr,MF,Monaco,Ligue 1,21,1999,31.9,90,51,31,51,8,42,82,51.2,40,43,7,36,34,124,14
898,Thomas Foket,be,DF,Reims,Ligue 1,25,1994,36.9,77,43,50,20,7,40,69,58.0,29,28,7,21,69,146,92
899,Ramón Folch,es,MF,Elche,La Liga,30,1989,0.0,0,0,0,0,0,0,0,,0,0,0,0,0,0,0
900,Lamine Fomba,fr,MF,Nîmes,Ligue 1,22,1998,24.2,66,36,30,25,11,30,65,46.2,35,48,19,29,59,125,39
901,Thomas Fontaine,mg,DF,Lorient,Ligue 1,29,1991,3.6,5,2,5,0,0,2,2,100.0,0,3,2,1,5,10,14
902,José Fontán,es,DF,Celta Vigo,La Liga,20,2000,7.2,12,9,8,4,0,5,11,45.5,6,4,3,1,13,25,27
903,José Fonte,pt,DF,Lille,Ligue 1,36,1983,35.4,40,29,28,10,2,27,33,81.8,6,36,23,13,36,76,137
904,Fernando Forestieri,it,FW,Udinese,it Serie A,30,1990,6.1,9,7,4,4,1,3,7,42.9,4,7,0,7,2,11,0
905,Pablo Fornals,es,FW,West Ham,Premier League,24,1996,28.6,44,26,14,24,6,11,73,15.1,62,43,1,42,36,80,9
906,Emil Forsberg,se,FW,RB Leipzig,Bundesliga,28,1991,17.1,11,6,1,6,4,5,27,18.5,22,10,1,9,11,22,4
907,Fraser Forster,eng,GK,Southampton,Premier League,32,1988,8.0,1,0,1,0,0,1,2,50.0,1,0,0,0,0,1,9
908,Philipp Förster,de,MF,Stuttgart,Bundesliga,25,1995,16.8,22,13,7,12,3,6,25,24.0,19,18,1,17,15,37,2
909,Steven Fortes,cv,DF,Lens,Ligue 1,28,1992,15.9,33,20,20,10,3,16,22,72.7,6,25,10,15,27,60,52
910,Yassin Fortune,fr,FW,Angers,Ligue 1,21,1999,0.2,0,0,0,0,0,0,0,,0,0,0,0,0,0,0
911,Timothy Fosu-Mensah,nl,DF,Manchester Utd,Premier League,22,1998,0.9,2,0,1,1,0,1,1,100.0,0,0,0,0,3,5,1
912,Timothy Fosu-Mensah,nl,DF,Leverkusen,Bundesliga,22,1998,4.5,4,2,1,2,1,2,4,50.0,2,7,3,4,7,11,4
913,Daam Foulon,be,DF,Benevento,it Serie A,21,1999,11.3,26,15,21,5,0,16,28,57.1,12,12,3,9,14,40,34
914,Dimitri Foulquier,fr,DF,Granada,La Liga,27,1993,29.6,35,21,20,12,3,15,26,57.7,11,24,7,17,26,61,60
915,Juan Foyth,ar,DF,Villarreal,La Liga,22,1998,13.0,40,22,22,14,4,12,29,41.4,17,21,6,15,19,59,24
916,Gianluca Frabotta,it,DF,Juventus,it Serie A,21,1999,7.7,7,4,5,0,2,5,12,41.7,7,9,1,8,14,21,15
917,Raphael Framberger,de,DF,Augsburg,Bundesliga,24,1995,17.1,42,23,26,11,5,19,25,76.0,6,24,2,22,36,78,62
918,Tyrese Francois,au,DF,Fulham,Premier League,20,2000,0.2,0,0,0,0,0,0,0,,0,0,0,0,0,0,0
919,Ryan Fraser,sct,FW,Newcastle Utd,Premier League,26,1994,10.3,4,1,3,1,0,2,5,40.0,3,1,0,1,6,10,7
920,Fred,br,MF,Manchester Utd,Premier League,27,1993,26.6,81,39,39,38,4,29,89,32.6,60,49,9,40,45,126,26
921,Ryan Fredericks,eng,DF,West Ham,Premier League,27,1992,6.3,9,5,5,4,0,3,7,42.9,4,6,2,4,11,20,20
922,Remo Freuler,ch,MF,Atalanta,it Serie A,28,1992,30.1,63,39,17,38,8,32,76,42.1,44,52,4,48,39,102,27
923,Marco Friedl,at,DF,Werder Bremen,Bundesliga,22,1998,30.9,50,34,31,17,2,30,62,48.4,32,38,17,21,55,105,118
924,Marvin Friedrich,de,DF,Union Berlin,Bundesliga,24,1995,34.0,47,29,35,11,1,18,32,56.3,14,38,18,20,52,99,109
925,Jeremie Frimpong,nl,DF,Leverkusen,Bundesliga,19,2000,4.8,7,4,4,3,0,4,8,50.0,4,4,0,4,1,8,7
926,Jorge de Frutos,es,MF,Levante,La Liga,23,1997,24.3,48,24,21,21,6,11,41,26.8,30,25,2,23,16,64,18
927,Christian Fuchs,at,DF,Leicester City,Premier League,34,1986,7.8,18,7,15,2,1,8,15,53.3,7,6,4,2,16,34,34
928,Angelo Fulgini,fr,MF,Angers,Ligue 1,23,1996,30.3,22,13,4,12,6,12,34,35.3,22,17,0,17,15,37,9
929,Niclas Füllkrug,de,FW,Werder Bremen,Bundesliga,27,1993,9.7,7,3,2,4,1,1,13,7.7,12,10,4,6,3,10,13
930,Ramiro Funes Mori,ar,DF,Villarreal,La Liga,29,1991,8.1,12,8,7,5,0,7,11,63.6,4,7,5,2,8,20,42
931,Darnell Furlong,eng,DF,West Brom,Premier League,24,1995,32.6,45,27,27,12,6,21,44,47.7,23,39,16,23,49,94,90
932,Daniel Fuzato,br,GK,Roma,it Serie A,23,1997,5.0,0,0,0,0,0,0,0,,0,1,0,1,0,0,1
933,Baptiste Gabard,fr,MF,Saint-Étienne,Ligue 1,20,2000,1.5,4,3,1,3,0,1,5,20.0,4,4,0,4,1,5,0
934,Matteo Gabbia,it,DF,Milan,it Serie A,20,1999,6.2,9,5,3,6,0,2,2,100.0,0,8,6,2,3,12,21
935,Manolo Gabbiadini,it,FW,Sampdoria,it Serie A,28,1991,9.7,2,2,0,2,0,0,1,0.0,1,3,1,2,3,5,5
936,Mijat Gaćinović,rs,DF,Hoffenheim,Bundesliga,25,1995,9.1,18,10,6,11,1,9,24,37.5,15,13,0,13,18,36,15
937,Roberto Gagliardini,it,MF,Inter,it Serie A,26,1994,13.7,30,17,17,8,5,5,28,17.9,23,15,3,12,19,49,16
938,Riccardo Gagliolo,se,DF,Parma,it Serie A,30,1990,21.7,45,18,35,8,2,28,45,62.2,17,34,7,27,36,81,64
939,Adolfo Gaich,ar,FW,Benevento,it Serie A,21,1999,8.5,9,4,1,7,1,1,13,7.7,12,4,0,4,2,11,4
940,Andrey Galabinov,bg,FW,Spezia,it Serie A,31,1988,4.8,2,1,1,1,0,1,3,33.3,2,2,0,2,0,2,5
941,Javi Galán,es,DF,Huesca,La Liga,25,1994,34.1,88,54,47,35,6,46,72,63.9,26,30,4,26,39,127,61
942,Conor Gallagher,eng,MF,West Brom,Premier League,20,2000,28.1,81,41,30,39,12,29,97,29.9,68,47,8,39,27,108,31
943,Enric Gallego,es,FW,Osasuna,La Liga,33,1986,9.0,6,3,2,2,2,2,14,14.3,12,5,1,4,1,7,9
944,Kévin Gameiro,fr,FW,Valencia,La Liga,33,1987,12.0,7,4,3,2,2,3,11,27.3,8,10,0,10,0,7,3
945,Idrissa Gana Gueye,sn,MF,Paris S-G,Ligue 1,30,1989,17.6,63,35,20,34,9,26,50,52.0,24,26,7,19,20,83,9
946,Ignatius Ganago,cm,FW,Lens,Ligue 1,21,1999,14.5,4,3,0,2,2,3,12,25.0,9,7,1,6,6,10,3
947,Aleix García,es,MF,Eibar,La Liga,23,1997,4.9,5,4,2,2,1,1,10,10.0,9,5,0,5,8,13,2
948,Borja García,es,MF,Huesca,La Liga,29,1990,12.4,13,7,4,6,3,6,12,50.0,6,12,0,12,10,23,4
949,Dani García,es,MF,Athletic Club,La Liga,30,1990,21.3,39,19,10,23,6,15,46,32.6,31,20,7,13,33,72,34
950,David García,es,DF,Osasuna,La Liga,26,1994,35.0,26,17,13,13,0,13,24,54.2,11,36,19,17,59,85,171
951,Eric García,es,DF,Manchester City,Premier League,19,2001,4.3,8,7,5,3,0,5,7,71.4,2,4,1,3,4,12,10
952,Manu García,es,MF,Alavés,La Liga,34,1986,12.5,24,13,10,13,1,8,35,22.9,27,16,1,15,12,36,21
953,Raúl García,es,DF,Valladolid,La Liga,31,1989,5.6,10,8,5,5,0,6,20,30.0,14,5,1,4,9,19,10
954,Raúl García,es,FW,Athletic Club,La Liga,34,1986,19.4,34,19,9,19,6,7,22,31.8,15,30,1,29,15,49,20
955,Rubén García,es,MF,Osasuna,La Liga,27,1993,30.2,50,29,21,22,7,14,45,31.1,31,28,2,26,29,79,20
956,Sergi García,es,MF,Alavés,La Liga,21,1999,0.2,1,1,0,1,0,0,1,0.0,1,0,0,0,0,1,0
957,Unai García,es,DF,Osasuna,La Liga,28,1992,13.8,19,9,14,4,1,9,15,60.0,6,16,8,8,14,33,40
958,Mario Gaspar,es,DF,Villarreal,La Liga,29,1990,20.6,55,34,22,24,9,21,40,52.5,19,26,4,22,30,85,47
959,Manuel Gasparini,it,GK,Udinese,it Serie A,18,2002,0.0,0,0,0,0,0,0,0,,0,0,0,0,0,0,0
960,Dwight Gayle,eng,FW,Newcastle Utd,Premier League,29,1990,5.7,2,0,1,1,0,0,7,0.0,7,3,1,2,1,3,2
961,Paulo Gazzaniga,ar,GK,Elche,La Liga,28,1992,8.0,1,1,1,0,0,0,0,,0,0,0,0,1,2,4
962,Jean-Philippe Gbamin,ci,MF,Everton,Premier League,24,1995,0.1,1,0,0,1,0,0,0,,0,1,0,1,0,1,1
963,Yann Gboho,fr,MF,Rennes,Ligue 1,19,2001,3.4,6,3,3,1,2,3,8,37.5,5,1,0,1,1,7,3
964,David de Gea,es,GK,Manchester Utd,Premier League,29,1990,25.5,0,0,0,0,0,0,0,,0,0,0,0,0,0,8
965,Christian Gebauer,at,MF,Arminia,Bundesliga,26,1993,7.6,9,4,2,5,2,4,11,36.4,7,4,1,3,6,15,14
966,Theodor Gebre Selassie,cz,DF,Werder Bremen,Bundesliga,33,1986,33.7,61,35,39,17,5,28,64,43.8,36,33,11,22,58,119,98
967,Emrehan Gedikli,de,FW,Leverkusen,Bundesliga,17,2003,0.3,0,0,0,0,0,0,0,,0,0,0,0,0,0,0
968,Dennis Geiger,de,MF,Hoffenheim,Bundesliga,22,1998,7.3,13,10,3,8,2,5,8,62.5,3,10,0,10,3,16,0
969,Christian Gentner,de,MF,Union Berlin,Bundesliga,34,1985,11.5,17,8,9,5,3,5,18,27.8,13,13,1,12,17,34,16
970,Yannick Gerhardt,de,MF,Wolfsburg,Bundesliga,26,1994,21.5,52,32,14,32,6,21,52,40.4,31,34,4,30,21,73,30
971,Valère Germain,fr,FW,Marseille,Ligue 1,30,1990,9.5,8,6,2,4,2,3,11,27.3,8,7,2,5,11,19,22
972,Gervinho,ci,FW,Parma,it Serie A,33,1987,22.5,5,1,2,2,1,1,14,7.1,13,11,1,10,10,15,3
973,Willem Geubbels,fr,MF,Monaco,Ligue 1,18,2001,3.3,12,8,5,7,0,5,13,38.5,8,9,0,9,3,15,5
974,Hamadi Al Ghaddioui,ma,FW,Stuttgart,Bundesliga,29,1990,0.5,0,0,0,0,0,0,1,0.0,1,0,0,0,0,0,0
975,Anwar El Ghazi,nl,FW,Aston Villa,Premier League,25,1995,17.9,16,13,6,7,3,7,23,30.4,16,11,0,11,6,22,11
976,Paolo Ghiglione,it,DF,Genoa,it Serie A,23,1997,15.1,27,15,17,8,2,13,28,46.4,15,14,2,12,13,40,25
977,Faouzi Ghoulam,dz,DF,Napoli,it Serie A,29,1991,3.2,6,5,3,2,1,0,1,0.0,1,4,2,2,3,9,1
978,Kieran Gibbs,eng,DF,West Brom,Premier League,30,1989,9.0,15,11,11,3,1,8,10,80.0,2,8,6,2,16,31,30
979,Morgan Gibbs-White,eng,MF,Wolves,Premier League,20,2000,4.6,9,7,3,4,2,5,12,41.7,7,6,0,6,3,12,1
980,Niko Gießelmann,de,DF,Union Berlin,Bundesliga,28,1991,4.8,12,9,7,4,1,5,8,62.5,3,9,3,6,8,20,13
981,Rafał Gikiewicz,pl,GK,Augsburg,Bundesliga,32,1987,34.0,0,0,0,0,0,0,3,0.0,3,0,0,0,3,3,9
982,Bryan Gil,es,FW,Sevilla,La Liga,19,2001,0.1,1,1,0,1,0,0,0,,0,0,0,0,0,1,0
983,Bryan Gil,es,MF,Eibar,La Liga,19,2001,25.2,28,18,12,11,5,6,23,26.1,17,20,0,20,17,45,6
984,David Gil,es,GK,Cádiz,La Liga,26,1994,4.0,0,0,0,0,0,0,1,0.0,1,0,0,0,0,0,2
985,Billy Gilmour,sct,MF,Chelsea,Premier League,19,2001,2.9,4,2,1,2,1,2,7,28.6,5,3,2,1,3,7,1
986,Álvaro Giménez,es,FW,Cádiz,La Liga,29,1991,4.5,4,2,2,2,0,0,3,0.0,3,2,0,2,2,6,3
987,Daniel Ginczek,de,FW,Wolfsburg,Bundesliga,29,1991,2.4,2,2,1,1,0,2,8,25.0,6,2,0,2,1,3,2
988,Matthias Ginter,de,DF,Gladbach,Bundesliga,26,1994,34.0,26,16,15,10,1,14,24,58.3,10,43,32,11,51,77,121
989,Andrei Girotto,br,DF,Nantes,Ligue 1,28,1992,29.6,65,41,50,15,0,39,70,55.7,31,34,15,19,59,124,103
990,Olivier Giroud,fr,FW,Chelsea,Premier League,33,1986,8.3,4,2,0,1,3,1,7,14.3,6,4,1,3,5,9,10
991,Robert Glatzel,de,FW,Mainz 05,Bundesliga,26,1994,4.0,1,0,1,0,0,0,2,0.0,2,2,0,2,0,1,2
992,Kamil Glik,pl,DF,Benevento,it Serie A,32,1988,35.6,44,24,33,10,1,25,53,47.2,28,37,31,6,62,106,153
993,Serge Gnabry,de,FW,Bayern Munich,Bundesliga,25,1995,18.3,39,19,7,19,13,12,32,37.5,20,17,0,17,26,65,3
994,Ben Godfrey,eng,DF,Everton,Premier League,22,1998,29.8,55,33,37,15,3,27,41,65.9,14,56,37,19,33,88,120
995,Diego Godín,uy,DF,Cagliari,it Serie A,34,1986,27.9,60,32,51,9,0,24,39,61.5,15,41,24,17,56,116,117
996,Akaki Gogia,de,FW,Union Berlin,Bundesliga,28,1992,1.6,1,0,0,1,0,0,2,0.0,2,0,0,0,1,2,0
997,Amer Gojak,ba,MF,Torino,it Serie A,23,1997,5.3,1,0,1,0,0,1,7,14.3,6,5,0,5,3,4,1
998,Edoardo Goldaniga,it,DF,Genoa,it Serie A,26,1993,20.6,28,18,21,7,0,14,23,60.9,9,17,7,10,38,66,62
999,Vladimir Golemić,si,DF,Crotone,it Serie A,29,1991,26.0,33,16,17,13,3,14,19,73.7,5,38,26,12,40,73,97
1000,Pierluigi Gollini,it,GK,Atalanta,it Serie A,25,1995,24.0,1,0,1,0,0,1,2,50.0,1,1,0,1,1,2,11
1001,Aleksandr Golovin,ru,MF,Monaco,Ligue 1,24,1996,11.9,28,16,6,18,4,8,39,20.5,31,21,0,21,11,39,3
1002,Tomislav Gomelt,hr,MF,Crotone,it Serie A,25,1995,0.2,1,1,0,1,0,0,0,,0,0,0,0,1,2,0
1003,André Gomes,pt,MF,Everton,Premier League,27,1993,17.4,35,23,16,16,3,17,58,29.3,41,19,1,18,10,45,12
1004,Dani Gómez,es,FW,Levante,La Liga,22,1998,18.5,4,3,2,1,1,0,11,0.0,11,3,0,3,2,6,4
1005,Ibai Gómez,es,MF,Athletic Club,La Liga,30,1989,4.7,6,4,2,3,1,4,7,57.1,3,3,0,3,2,8,4
1006,Joe Gomez,eng,DF,Liverpool,Premier League,23,1997,6.6,3,2,1,1,1,0,4,0.0,4,3,2,1,4,7,29
1007,Maxi Gómez,uy,FW,Valencia,La Liga,23,1996,29.9,11,9,3,7,1,3,14,21.4,11,13,3,10,2,13,34
1008,Moi Gómez,es,MF,Villarreal,La Liga,26,1994,28.5,21,12,6,8,7,14,35,40.0,21,20,3,17,11,32,16
1009,Papu Gómez,ar,MF,Atalanta,it Serie A,32,1988,7.4,3,2,2,1,0,2,8,25.0,6,8,1,7,1,4,1
1010,Papu Gómez,ar,MF,Sevilla,La Liga,32,1988,10.2,9,6,2,4,3,2,12,16.7,10,13,2,11,7,16,6
1011,Sergi Gómez,es,DF,Sevilla,La Liga,28,1992,8.0,4,3,2,2,0,1,1,100.0,0,5,4,1,6,10,34
1012,Sergio Gómez,es,MF,Huesca,La Liga,19,2000,8.8,29,10,17,9,3,11,22,50.0,11,15,0,15,14,43,9
1013,Alfred Gomis,sn,GK,Dijon,Ligue 1,26,1993,5.0,1,0,1,0,0,1,2,50.0,1,0,0,0,1,2,7
1014,Alfred Gomis,sn,GK,Rennes,Ligue 1,26,1993,22.0,1,1,1,0,0,1,1,100.0,0,0,0,0,3,4,10
1015,Maxime Gonalons,fr,MF,Granada,La Liga,31,1989,16.4,53,37,18,33,2,15,37,40.5,22,17,0,17,25,78,21
1016,Vagner Gonçalves,cv,FW,Metz,Ligue 1,24,1996,10.7,16,9,5,5,6,2,15,13.3,13,6,0,6,4,20,1
1017,Álvaro González,es,DF,Marseille,Ligue 1,30,1990,31.5,26,17,20,6,0,19,31,61.3,12,30,18,12,33,59,119
1018,Bruno González,es,DF,Valladolid,La Liga,30,1990,25.1,26,17,18,8,0,17,31,54.8,14,22,14,8,37,63,112
1019,Diego González,es,DF,Elche,La Liga,25,1995,14.2,11,7,7,3,1,5,11,45.5,6,16,9,7,20,31,49
1020,Nicolás González,ar,FW,Stuttgart,Bundesliga,22,1998,10.4,5,5,1,2,2,0,6,0.0,6,10,3,7,4,9,6
1021,Sergio González,es,MF,Cádiz,La Liga,23,1997,1.0,1,0,0,1,0,1,2,50.0,1,0,0,0,2,3,0
1022,Urko González,es,MF,Real Sociedad,La Liga,19,2001,0.5,0,0,0,0,0,0,1,0.0,1,1,1,0,0,0,1
1023,Anthony Gordon,eng,FW,Everton,Premier League,19,2001,1.0,3,3,3,0,0,0,2,0.0,2,1,0,1,1,4,3
1024,Leon Goretzka,de,MF,Bayern Munich,Bundesliga,25,1995,18.9,37,23,12,21,4,16,39,41.0,23,30,2,28,44,81,11
1025,Andoni Gorosabel,es,DF,Real Sociedad,La Liga,23,1996,26.5,76,43,45,20,11,27,64,42.2,37,25,4,21,23,99,42
1026,Robin Gosens,de,DF,Atalanta,it Serie A,26,1994,28.0,46,35,20,15,11,17,41,41.5,24,50,7,43,41,87,34
1027,Amine Gouiri,dz,FW,Nice,Ligue 1,20,2000,30.5,31,18,7,16,8,10,41,24.4,31,22,6,16,17,48,23
1028,Lucas Gourna-Douath,fr,MF,Saint-Étienne,Ligue 1,16,2003,14.7,32,22,18,11,3,15,28,53.6,13,10,0,10,24,56,18
1029,Jeffrey Gouweleeuw,nl,DF,Augsburg,Bundesliga,29,1991,31.5,36,20,24,11,1,16,33,48.5,17,37,18,19,69,105,149
1030,Jonathan Gradit,fr,DF,Lens,Ligue 1,27,1992,31.4,60,39,26,28,6,22,38,57.9,16,37,19,18,56,116,81
1031,Karlan Grant,eng,FW,West Brom,Premier League,22,1997,12.5,5,3,3,2,0,2,4,50.0,2,7,0,7,5,10,17
1032,Alberto Grassi,it,MF,Parma,it Serie A,25,1995,13.1,30,11,14,13,3,8,29,27.6,21,22,9,13,26,56,32
1033,Andrew Gravillon,gp,DF,Lorient,Ligue 1,22,1998,25.2,26,17,17,9,0,13,28,46.4,15,44,31,13,59,85,118
1034,Demarai Gray,jm,FW,Leicester City,Premier League,24,1996,0.2,1,1,1,0,0,0,0,,0,0,0,0,0,1,0
1035,Demarai Gray,jm,FW,Leverkusen,Bundesliga,24,1996,4.9,3,2,1,2,0,1,1,100.0,0,3,0,3,4,7,3
1036,Adrian Grbić,at,FW,Lorient,Ligue 1,23,1996,10.7,6,4,2,2,2,1,7,14.3,6,6,0,6,5,11,7
1037,Jack Grealish,eng,FW,Aston Villa,Premier League,24,1995,24.3,31,14,8,16,7,15,24,62.5,9,20,3,17,12,43,5
1038,Etienne Green,eng,GK,Saint-Étienne,Ligue 1,20,2000,8.0,0,0,0,0,0,0,0,,0,0,0,0,0,0,3
1039,Mason Greenwood,eng,FW,Manchester Utd,Premier League,18,2001,20.2,13,10,6,4,3,5,22,22.7,17,9,0,9,5,18,1
1040,Michael Gregoritsch,at,FW,Augsburg,Bundesliga,26,1994,9.3,13,10,6,7,0,3,10,30.0,7,2,0,2,3,16,17
1041,Clément Grenier,fr,MF,Rennes,Ligue 1,29,1991,12.0,20,8,9,8,3,7,31,22.6,24,7,0,7,5,25,3
1042,Sebastian Griesbeck,de,MF,Union Berlin,Bundesliga,29,1990,9.9,20,9,8,11,1,8,19,42.1,11,13,3,10,5,25,8
1043,Antoine Griezmann,fr,FW,Barcelona,La Liga,29,1991,28.9,37,22,10,18,9,12,40,30.0,28,20,1,19,12,49,11
1044,Vincenzo Grifo,it,MF,Freiburg,Bundesliga,27,1993,25.7,18,7,6,7,5,14,34,41.2,20,13,0,13,27,45,18
1045,Lennart Grill,de,GK,Leverkusen,Bundesliga,21,1999,4.0,0,0,0,0,0,0,0,,0,0,0,0,0,0,2
1046,Florian Grillitsch,at,MF,Hoffenheim,Bundesliga,24,1995,20.9,37,21,21,13,3,19,52,36.5,33,38,7,31,51,88,47
1047,Christian Groß,de,MF,Werder Bremen,Bundesliga,31,1989,16.3,44,28,17,25,2,15,37,40.5,22,12,2,10,24,68,37
1048,Pascal Groß,de,MF,Brighton,Premier League,29,1991,27.6,45,24,24,15,6,24,53,45.3,29,25,4,21,23,68,18
1049,Kamil Grosicki,pl,MF,West Brom,Premier League,32,1988,1.6,2,1,2,0,0,2,8,25.0,6,1,0,1,2,4,1
1050,Ilia Gruev,bg,FW,Werder Bremen,Bundesliga,20,2000,0.0,0,0,0,0,0,0,0,,0,0,0,0,0,0,0
1051,Carlos Gruezo,ec,MF,Augsburg,Bundesliga,25,1995,23.2,57,32,20,32,5,20,52,38.5,32,32,5,27,35,92,29
1052,Vicente Guaita,es,GK,Crystal Palace,Premier League,33,1987,37.0,1,1,1,0,0,1,1,100.0,0,0,0,0,1,2,11
1053,Andrés Guardado,mx,MF,Betis,La Liga,33,1986,14.6,25,12,10,11,4,10,25,40.0,15,13,3,10,18,43,19
1054,Sergi Guardiola,es,FW,Valladolid,La Liga,29,1991,19.9,11,5,1,5,5,2,27,7.4,25,12,1,11,7,18,16
1055,Nemanja Gudelj,rs,MF,Sevilla,La Liga,28,1991,11.6,23,12,16,5,2,4,10,40.0,6,10,6,4,24,47,24
1056,Gonçalo Guedes,pt,MF,Valencia,La Liga,23,1996,25.4,18,12,8,7,3,10,45,22.2,35,24,1,23,8,26,7
1057,Mattéo Guendouzi,fr,MF,Hertha BSC,Bundesliga,21,1999,20.2,24,13,10,12,2,9,25,36.0,16,15,4,11,21,45,24
1058,Raphaël Guerreiro,pt,DF,Dortmund,Bundesliga,26,1993,24.6,30,13,14,8,8,16,31,51.6,15,21,4,17,28,58,31
1059,Evann Guessand,ci,FW,Nice,Ligue 1,19,2001,0.3,0,0,0,0,0,0,1,0.0,1,1,1,0,1,1,1
1060,Kelyan Guessoum,fr,DF,Nîmes,Ligue 1,21,1999,12.5,13,7,11,1,1,11,16,68.8,5,8,6,2,24,37,51
1061,Ander Guevara,es,MF,Real Sociedad,La Liga,23,1997,23.1,35,23,15,16,4,15,30,50.0,15,19,5,14,25,60,35
1062,Lamine Gueye,sn,FW,Metz,Ligue 1,22,1998,16.2,18,9,4,11,3,7,24,29.2,17,7,2,5,21,39,5
1063,Pape Gueye,sn,MF,Marseille,Ligue 1,21,1999,22.9,49,21,25,19,5,15,45,33.3,30,25,6,19,47,96,34
1064,John Guidetti,se,FW,Alavés,La Liga,28,1992,2.3,2,2,0,2,0,0,2,0.0,2,0,0,0,1,3,2
1065,Josuha Guilavogui,fr,MF,Wolfsburg,Bundesliga,29,1990,8.3,17,9,9,8,0,5,12,41.7,7,12,5,7,29,46,25
1066,Frederic Guilbert,fr,DF,Strasbourg,Ligue 1,25,1994,12.4,37,19,23,11,3,21,34,61.8,13,14,1,13,33,70,32
1067,Hugo Guillamón,es,DF,Valencia,La Liga,20,2000,22.1,23,13,17,6,0,8,20,40.0,12,19,14,5,27,50,102
1068,Bruno Guimarães,br,MF,Lyon,Ligue 1,22,1997,19.5,76,34,26,41,9,30,64,46.9,34,24,4,20,14,90,13
1069,Serhou Guirassy,gn,FW,Rennes,Ligue 1,24,1996,19.6,4,1,1,3,0,1,3,33.3,2,10,1,9,5,9,17
1070,Péter Gulácsi,hu,GK,RB Leipzig,Bundesliga,30,1990,33.0,1,0,1,0,0,1,2,50.0,1,0,0,0,2,3,7
1071,Manuel Gulde,de,DF,Freiburg,Bundesliga,29,1991,21.7,27,15,12,12,3,5,21,23.8,16,25,15,10,37,64,64
1072,Robert Gumny,pl,DF,Augsburg,Bundesliga,22,1998,15.3,24,15,12,9,3,15,23,65.2,8,12,2,10,18,42,31
1073,İlkay Gündoğan,de,MF,Manchester City,Premier League,29,1990,22.5,25,15,8,12,5,10,39,25.6,29,13,4,9,20,45,9
1074,Christian Günter,de,DF,Freiburg,Bundesliga,27,1993,34.0,34,19,18,13,3,15,43,34.9,28,38,9,29,29,63,40
1075,Koray Günter,de,DF,Hellas Verona,it Serie A,25,1994,19.6,20,10,10,9,1,4,9,44.4,5,27,21,6,70,90,87
1076,Jon Guridi,es,MF,Real Sociedad,La Liga,25,1995,9.2,19,9,10,6,3,8,22,36.4,14,8,1,7,10,29,9
1077,Malo Gusto,fr,DF,Lyon,Ligue 1,17,2003,0.0,0,0,0,0,0,0,0,,0,0,0,0,0,0,0
1078,Raúl Guti,es,MF,Elche,La Liga,23,1996,31.8,48,28,21,22,5,16,52,30.8,36,25,3,22,49,97,25
1079,Marcos Mauro López Gutiérrez,ar,DF,Cádiz,La Liga,29,1991,20.3,23,15,15,8,0,15,24,62.5,9,18,12,6,22,45,78
1080,Miguel Gutiérrez,es,DF,Real Madrid,La Liga,19,2001,3.5,4,0,0,3,1,1,7,14.3,6,3,0,3,5,9,5
1081,Manu Gyabuaa,it,MF,Atalanta,it Serie A,18,2001,0.0,0,0,0,0,0,0,0,,0,0,0,0,0,0,0
1082,Emmanuel Gyasi,gh,FW,Spezia,it Serie A,26,1994,31.7,30,16,16,10,4,9,31,29.0,22,13,2,11,14,44,8
1083,Erling Haaland,no,FW,Dortmund,Bundesliga,20,2000,26.7,7,2,1,3,3,1,4,25.0,3,19,4,15,4,11,16
1084,Janik Haberer,de,MF,Freiburg,Bundesliga,26,1994,5.4,7,4,4,3,0,3,15,20.0,12,4,1,3,7,14,9
1085,Alexander Hack,de,DF,Mainz 05,Bundesliga,26,1993,15.2,32,21,23,8,1,18,31,58.1,13,26,17,9,41,73,91
1086,Antwoine Hackford,eng,DF,Sheffield Utd,Premier League,16,2004,0.1,0,0,0,0,0,0,0,,0,0,0,0,0,0,0
1087,Munir El Haddadi,ma,FW,Sevilla,La Liga,24,1995,9.4,12,8,5,5,2,2,12,16.7,10,6,0,6,5,17,6
1088,André Hahn,de,FW,Augsburg,Bundesliga,29,1990,22.6,31,17,14,13,4,9,44,20.5,35,35,3,32,14,45,24
1089,Amadou Haidara,ml,MF,RB Leipzig,Bundesliga,22,1998,21.2,50,28,20,21,9,11,36,30.6,25,33,1,32,30,80,24
1090,Massadio Haïdara,ml,DF,Lens,Ligue 1,27,1992,23.7,48,32,21,21,6,23,37,62.2,14,29,6,23,35,83,60
1091,Achraf Hakimi,ma,DF,Inter,it Serie A,21,1998,29.6,53,32,23,19,11,23,48,47.9,25,31,1,30,22,75,23
1092,Sébastien Haller,ci,FW,West Ham,Premier League,26,1994,10.4,14,9,1,6,7,4,20,20.0,16,7,1,6,5,19,7
1093,Marcel Halstenberg,de,DF,RB Leipzig,Bundesliga,28,1991,18.3,29,18,20,8,1,19,41,46.3,22,15,3,12,16,45,35
1094,Pierre-Yves Hamel,fr,FW,Lorient,Ligue 1,26,1994,9.4,15,8,3,9,3,1,6,16.7,5,12,1,11,10,25,6
1095,Romain Hamouma,fr,FW,Saint-Étienne,Ligue 1,33,1987,19.7,12,7,5,6,1,4,24,16.7,20,17,1,16,7,19,11
1096,Samir Handanović,si,GK,Inter,it Serie A,36,1984,36.0,1,0,1,0,0,1,1,100.0,0,0,0,0,0,1,6
1097,Lukáš Haraslín,sk,FW,Sassuolo,it Serie A,24,1996,3.7,8,4,2,5,1,2,5,40.0,3,1,0,1,0,8,2
1098,Amine Harit,ma,MF,Schalke 04,Bundesliga,23,1997,23.3,22,13,8,11,3,10,23,43.5,13,9,1,8,17,39,7
1099,Rekeem Harper,eng,MF,West Brom,Premier League,20,2000,0.4,0,0,0,0,0,0,0,,0,2,0,2,1,1,0
1100,Jack Harrison,eng,MF,Leeds United,Premier League,23,1996,31.6,63,38,20,30,13,26,59,44.1,33,30,2,28,15,78,21
1101,Marcel Hartel,de,MF,Arminia,Bundesliga,24,1996,18.7,35,19,15,18,2,20,40,50.0,20,17,4,13,26,61,16
1102,Makoto Hasebe,jp,DF,Eint Frankfurt,Bundesliga,36,1984,25.4,43,29,21,20,2,25,51,49.0,26,31,12,19,31,74,68
1103,Hans Hateboer,nl,DF,Atalanta,it Serie A,26,1994,19.6,28,17,12,14,2,13,23,56.5,10,8,1,7,17,45,9
1104,Kortney Hause,eng,DF,Aston Villa,Premier League,25,1995,7.0,4,2,3,1,0,0,3,0.0,3,4,2,2,8,12,53
1105,Kai Havertz,de,MF,Chelsea,Premier League,21,1999,16.9,18,9,6,10,2,6,27,22.2,21,25,0,25,4,22,22
1106,Isaac Hayden,eng,MF,Newcastle Utd,Premier League,25,1995,21.6,52,29,23,22,7,14,35,40.0,21,32,9,23,43,95,47
1107,Eden Hazard,be,FW,Real Madrid,La Liga,29,1991,5.9,3,2,1,2,0,0,3,0.0,3,3,0,3,3,6,0
1108,Thorgan Hazard,be,MF,Dortmund,Bundesliga,27,1993,7.3,8,2,6,1,1,3,13,23.1,10,4,0,4,10,18,1
1109,Jonas Hector,de,MF,Köln,Bundesliga,30,1990,14.3,34,22,8,21,5,15,35,42.9,20,24,5,19,19,53,20
1110,Michael Hector,jm,DF,Fulham,Premier League,28,1992,2.9,3,2,1,2,0,1,6,16.7,5,4,2,2,0,3,6
1111,Hwang Hee-chan,kr,FW,RB Leipzig,Bundesliga,24,1996,5.1,3,2,1,0,2,1,7,14.3,6,4,0,4,1,4,1
1112,Ahmed Hegazi,eg,DF,West Brom,Premier League,29,1991,1.0,0,0,0,0,0,0,0,,0,2,0,2,1,1,7
1113,Dominique Heintz,de,DF,Freiburg,Bundesliga,26,1993,15.2,22,11,19,3,0,10,19,52.6,9,10,8,2,35,57,49
1114,Dean Henderson,eng,GK,Manchester Utd,Premier League,23,1997,12.5,1,1,1,0,0,1,2,50.0,1,0,0,0,0,1,3
1115,Jordan Henderson,eng,MF,Liverpool,Premier League,30,1990,18.9,24,15,12,9,3,10,26,38.5,16,12,1,11,34,58,30
1116,Jeff Hendrick,ie,MF,Newcastle Utd,Premier League,28,1992,15.8,8,3,5,3,0,1,13,7.7,12,14,9,5,19,27,18
1117,Benjamin Henrichs,de,DF,RB Leipzig,Bundesliga,23,1997,6.0,12,7,4,5,3,2,9,22.2,7,9,1,8,8,20,8
1118,Dalbert Henrique,br,DF,Rennes,Ligue 1,26,1993,4.1,7,6,4,2,1,6,8,75.0,2,8,2,6,5,12,8
1119,Eduardo Henrique,br,MF,Crotone,it Serie A,25,1995,10.3,5,2,1,4,0,3,12,25.0,9,6,1,5,7,12,7
1120,Luis Henrique,br,FW,Marseille,Ligue 1,18,2001,7.5,5,4,3,1,1,4,9,44.4,5,5,1,4,7,12,4
1121,Christophe Hérelle,mq,DF,Brest,Ligue 1,27,1992,15.3,19,13,12,6,1,10,12,83.3,2,13,9,4,31,50,41
1122,Jérôme Hergault,fr,DF,Lorient,Ligue 1,34,1986,18.1,38,23,22,10,6,17,31,54.8,14,16,2,14,22,60,34
1123,Mario Hermoso,es,DF,Atlético Madrid,La Liga,25,1995,28.6,55,31,40,11,4,37,61,60.7,24,23,10,13,36,91,73
1124,Aridane Hernández,es,DF,Osasuna,La Liga,31,1989,22.5,20,11,13,6,1,7,12,58.3,5,22,19,3,34,54,127
1125,Lucas Hernández,fr,DF,Bayern Munich,Bundesliga,24,1996,17.7,41,31,16,17,8,17,31,54.8,14,24,6,18,19,60,38
1126,Pablo Hernández,es,MF,Leeds United,Premier League,35,1985,4.7,5,3,2,1,2,5,16,31.3,11,2,0,2,0,5,0
1127,Theo Hernández,fr,DF,Milan,it Serie A,22,1997,32.6,48,29,22,21,5,19,38,50.0,19,29,6,23,34,82,64
1128,Hernani,br,MF,Parma,it Serie A,26,1994,24.3,51,25,21,27,3,29,66,43.9,37,35,4,31,31,82,40
1129,Ander Herrera,es,MF,Paris S-G,Ligue 1,30,1989,20.6,53,35,17,26,10,30,77,39.0,47,31,5,26,31,84,22
1130,Héctor Herrera,mx,MF,Atlético Madrid,La Liga,30,1990,7.6,12,7,5,6,1,7,13,53.8,6,7,2,5,14,26,8
1131,Sergio Herrera,es,GK,Osasuna,La Liga,27,1993,32.9,0,0,0,0,0,0,2,0.0,2,0,0,0,3,3,29
1132,Yangel Herrera,ve,MF,Granada,La Liga,22,1998,25.7,59,26,19,32,8,11,41,26.8,30,53,17,36,26,85,32
1133,Patrick Herrmann,de,FW,Gladbach,Bundesliga,29,1991,9.7,9,6,4,3,2,2,14,14.3,12,16,0,16,10,19,8
1134,Pablo Hervías,es,DF,Valladolid,La Liga,27,1993,13.4,19,12,7,9,3,9,26,34.6,17,6,0,6,11,30,8
1135,Përparim Hetemaj,fi,MF,Benevento,it Serie A,33,1986,24.6,44,27,21,18,5,26,61,42.6,35,41,5,36,22,66,24
1136,Son Heung-min,kr,FW,Tottenham,Premier League,28,1992,34.6,32,18,11,14,7,18,72,25.0,54,28,3,25,14,46,8
1137,Aaron Hickey,sct,DF,Bologna,it Serie A,18,2002,8.4,12,8,10,2,0,7,17,41.2,10,6,1,5,15,27,15
1138,Vitorino Hilton,br,DF,Montpellier,Ligue 1,42,1977,23.5,15,10,10,4,1,3,14,21.4,11,34,26,8,38,53,104
1139,Martin Hinteregger,at,DF,Eint Frankfurt,Bundesliga,27,1992,28.1,77,49,53,22,2,37,63,58.7,26,31,12,19,44,121,92
1140,Marwin Hitz,ch,GK,Dortmund,Bundesliga,32,1987,15.5,1,1,1,0,0,1,1,100.0,0,0,0,0,0,1,7
1141,Wesley Hoedt,nl,DF,Lazio,it Serie A,26,1994,10.6,22,16,18,4,0,10,17,58.8,7,9,5,4,17,39,48
1142,Ki-Jana Hoever,nl,DF,Wolves,Premier League,18,2002,6.4,14,6,11,2,1,10,22,45.5,12,2,0,2,9,23,23
1143,Nicolas Höfler,de,MF,Freiburg,Bundesliga,30,1990,30.3,54,28,16,31,7,23,59,39.0,36,34,10,24,66,120,41
1144,Jonas Hofmann,de,FW,Gladbach,Bundesliga,28,1992,20.2,26,20,12,12,2,10,53,18.9,43,27,2,25,27,53,9
1145,Marco Höger,de,DF,Köln,Bundesliga,30,1989,0.6,1,0,0,1,0,1,2,50.0,1,2,0,2,2,3,1
1146,Rob Holding,eng,DF,Arsenal,Premier League,24,1995,28.4,43,20,28,13,2,17,35,48.6,18,37,27,10,24,67,120
1147,Lucas Höler,de,FW,Freiburg,Bundesliga,26,1994,23.2,36,24,13,19,4,12,32,37.5,20,19,2,17,16,52,14
1148,Mason Holgate,eng,DF,Everton,Premier League,23,1996,25.4,56,36,31,18,7,20,50,40.0,30,37,13,24,35,91,90
1149,Jordan Holsgrove,sct,MF,Celta Vigo,La Liga,20,1999,1.6,6,4,4,1,1,5,8,62.5,3,2,0,2,2,8,1
1150,Franck Honorat,fr,MF,Brest,Ligue 1,23,1996,27.3,28,13,12,10,6,14,37,37.8,23,15,3,12,11,39,24
1151,Matthew Hoppe,us,FW,Schalke 04,Bundesliga,19,2001,14.5,6,6,1,3,2,2,12,16.7,10,8,2,6,4,10,15
1152,Jannes Horn,de,DF,Köln,Bundesliga,23,1997,19.6,35,19,23,11,1,23,31,74.2,8,19,2,17,10,45,45
1153,Timo Horn,de,GK,Köln,Bundesliga,27,1993,33.4,1,0,1,0,0,1,4,25.0,3,1,0,1,0,1,11
1154,Fraser Hornby,sct,FW,Reims,Ligue 1,20,1999,0.4,0,0,0,0,0,0,0,,0,0,0,0,1,1,0
1155,Conor Hourihane,ie,MF,Aston Villa,Premier League,29,1991,2.5,0,0,0,0,0,0,2,0.0,2,3,0,3,0,0,2
1156,Lukáš Hrádecký,fi,GK,Leverkusen,Bundesliga,30,1989,28.5,0,0,0,0,0,0,1,0.0,1,0,0,0,1,1,11
1157,Ajdin Hrustic,au,MF,Eint Frankfurt,Bundesliga,24,1996,3.0,6,5,2,3,1,3,10,30.0,7,2,0,2,4,10,3
1158,Florian Hübner,de,DF,Union Berlin,Bundesliga,29,1991,5.8,10,5,7,3,0,7,15,46.7,8,7,3,4,13,23,21
1159,Callum Hudson-Odoi,eng,FW,Chelsea,Premier League,19,2000,11.8,23,15,11,7,5,8,21,38.1,13,15,1,14,6,29,6
1160,Niall Huggins,wls,DF,Leeds United,Premier League,19,2000,0.4,0,0,0,0,0,0,1,0.0,1,0,0,0,0,0,1
1161,Mats Hummels,de,DF,Dortmund,Bundesliga,31,1988,31.3,58,40,34,18,6,26,42,61.9,16,31,22,9,73,131,122
1162,Adrien Hunou,fr,FW,Rennes,Ligue 1,26,1994,6.5,6,3,2,2,2,2,8,25.0,6,7,0,7,1,7,2
1163,Klaas-Jan Huntelaar,nl,FW,Schalke 04,Bundesliga,36,1983,6.5,4,2,0,2,2,0,2,0.0,2,3,1,2,2,6,3
1164,Elseid Hysaj,al,DF,Napoli,it Serie A,26,1994,19.6,29,17,16,11,2,17,33,51.5,16,18,4,14,30,59,52
1165,Pierre Højbjerg,dk,MF,Tottenham,Premier League,24,1995,38.0,98,51,45,42,11,54,129,41.9,75,51,9,42,48,146,66
1166,Simone Iacoponi,it,DF,Parma,it Serie A,33,1987,13.3,22,12,16,5,1,13,26,50.0,13,9,4,5,11,33,42
1167,Iago,br,DF,Augsburg,Bundesliga,23,1997,17.3,37,27,21,13,3,17,29,58.6,12,17,5,12,22,59,55
1168,Roger Ibanez,br,DF,Roma,it Serie A,21,1998,26.6,59,37,28,25,6,25,45,55.6,20,38,17,21,68,127,78
1169,Vedad Ibišević,ba,FW,Schalke 04,Bundesliga,35,1984,1.7,0,0,0,0,0,0,0,,0,1,0,1,1,1,1
1170,Vicente Iborra,es,MF,Villarreal,La Liga,32,1988,10.3,18,8,8,7,3,8,24,33.3,16,14,7,7,14,32,25
1171,Didier Ibrahim Ndong,ga,MF,Dijon,Ligue 1,26,1994,29.0,53,32,22,30,1,25,70,35.7,45,35,7,28,37,90,40
1172,Zlatan Ibrahimović,se,FW,Milan,it Serie A,38,1981,16.6,5,4,0,4,1,3,6,50.0,3,5,3,2,6,11,27
1173,Mauro Icardi,ar,FW,Paris S-G,Ligue 1,27,1993,12.0,6,2,1,2,3,4,13,30.8,9,3,1,2,3,9,7
1174,Oussama Idrissi,ma,FW,Sevilla,La Liga,24,1996,0.3,1,1,0,1,0,1,2,50.0,1,2,0,2,1,2,0
1175,Blendi Idrizi,xk,MF,Schalke 04,Bundesliga,22,1998,2.6,8,4,1,6,1,1,1,100.0,0,6,2,4,3,11,1
1176,Odion Ighalo,ng,FW,Manchester Utd,Premier League,31,1989,0.1,0,0,0,0,0,0,1,0.0,1,0,0,0,0,0,0
1177,Iglesias,es,DF,Getafe,La Liga,22,1998,6.7,27,15,14,10,3,11,19,57.9,8,11,1,10,17,44,19
1178,Borja Iglesias,es,FW,Betis,La Liga,27,1993,15.7,1,1,0,0,1,1,8,12.5,7,7,2,5,3,4,9
1179,Igor,br,DF,Fiorentina,it Serie A,22,1998,13.0,15,9,9,6,0,7,12,58.3,5,17,9,8,23,38,34
1180,Kelechi Iheanacho,ng,FW,Leicester City,Premier League,23,1996,16.2,12,5,2,4,6,4,17,23.5,13,14,0,14,2,14,1
1181,Jonathan Ikone,fr,MF,Lille,Ligue 1,22,1998,24.2,18,12,3,8,7,9,22,40.9,13,16,1,15,7,25,9
1182,Yun Il-lok,kr,MF,Montpellier,Ligue 1,28,1992,3.5,0,0,0,0,0,0,4,0.0,4,0,0,0,5,5,1
1183,Ivan Ilić,rs,MF,Hellas Verona,it Serie A,19,2001,20.4,26,14,11,11,4,7,21,33.3,14,17,5,12,27,53,26
1184,Josip Iličić,si,MF,Atalanta,it Serie A,32,1988,17.0,9,4,1,5,3,5,21,23.8,16,12,0,12,2,11,0
1185,Asier Illarramendi,es,MF,Real Sociedad,La Liga,30,1990,3.7,5,2,1,4,0,1,5,20.0,4,2,0,2,5,10,7
1186,Stefan Ilsanker,at,MF,Eint Frankfurt,Bundesliga,31,1989,17.5,33,20,17,15,1,21,42,50.0,21,30,8,22,30,63,51
1187,Ciro Immobile,it,FW,Lazio,it Serie A,30,1990,31.7,14,13,4,6,4,7,22,31.8,15,13,1,12,6,20,9
1188,Riccardo Improta,it,DF,Benevento,it Serie A,26,1993,25.9,39,23,25,8,6,21,45,46.7,24,23,4,19,28,67,47
1189,Roberto Inglese,it,FW,Parma,it Serie A,28,1991,6.4,5,2,1,2,2,2,11,18.2,9,10,0,10,0,5,3
1190,Danny Ings,eng,FW,Southampton,Premier League,28,1992,24.1,22,13,3,16,3,12,28,42.9,16,39,2,37,3,25,27
1191,Marcus Ingvartsen,dk,MF,Union Berlin,Bundesliga,24,1996,21.8,17,11,5,6,6,8,26,30.8,18,22,0,22,18,35,10
1192,Lorenzo Insigne,it,FW,Napoli,it Serie A,29,1991,31.8,26,18,8,12,6,13,72,18.1,59,30,1,29,37,63,6
1193,Roberto Insigne,it,MF,Benevento,it Serie A,26,1994,17.8,16,10,8,3,5,7,27,25.9,20,10,0,10,7,23,9
1194,Pablo Insua,es,DF,Huesca,La Liga,26,1993,17.6,37,18,26,9,2,14,31,45.2,17,14,8,6,24,61,68
1195,Takashi Inui,jp,MF,Eibar,La Liga,32,1988,20.2,13,8,6,3,4,3,12,25.0,9,19,0,19,12,25,7
1196,Artur Ioniță,md,MF,Benevento,it Serie A,29,1990,31.5,47,22,11,31,5,17,63,27.0,46,38,14,24,19,66,28
1197,Alexander Isak,se,FW,Real Sociedad,La Liga,20,1999,26.0,9,5,0,3,6,3,8,37.5,5,17,1,16,3,12,7
1198,Isco,es,MF,Real Madrid,La Liga,28,1992,10.1,13,9,5,5,3,2,14,14.3,12,7,1,6,2,15,2
1199,Ardian Ismajli,al,DF,Spezia,it Serie A,23,1996,14.4,19,9,10,8,1,8,13,61.5,5,10,7,3,23,42,52
1200,Abass Issah,gh,DF,Mainz 05,Bundesliga,21,1998,0.2,0,0,0,0,0,0,0,,0,0,0,0,0,0,0
1201,Branislav Ivanović,rs,DF,West Brom,Premier League,36,1984,8.5,14,5,11,3,0,7,13,53.8,6,11,5,6,8,22,25
1202,Alex Iwobi,ng,FW,Everton,Premier League,24,1996,17.1,27,10,10,14,3,13,25,52.0,12,20,1,19,16,43,14
1203,Jairo Izquierdo,es,MF,Cádiz,La Liga,26,1993,14.2,21,13,13,8,0,12,31,38.7,19,7,1,6,14,35,12
1204,José Izquierdo,co,DF,Brighton,Premier League,28,1992,0.1,0,0,0,0,0,0,0,,0,0,0,0,0,0,0
1205,Armando Izzo,it,DF,Torino,it Serie A,28,1992,22.3,30,16,13,13,4,13,33,39.4,20,22,9,13,53,83,62
1206,Phil Jagielka,eng,DF,Sheffield Utd,Premier League,37,1982,5.8,5,4,4,0,1,2,7,28.6,5,11,5,6,10,15,26
1207,Alireza Jahanbakhsh,ir,FW,Brighton,Premier League,26,1993,5.9,9,7,3,5,1,2,12,16.7,10,8,0,8,8,17,1
1208,Mato Jajalo,ba,MF,Udinese,it Serie A,32,1988,0.4,1,1,1,0,0,1,1,100.0,0,1,0,1,2,3,0
1209,Ismail Jakobs,sn,MF,Köln,Bundesliga,20,1999,19.2,25,10,17,4,4,11,21,52.4,10,18,1,17,16,41,36
1210,Daniel James,wls,FW,Manchester Utd,Premier League,22,1997,10.1,15,9,4,7,4,3,18,16.7,15,10,1,9,0,15,6
1211,Reece James,eng,DF,Chelsea,Premier League,20,1999,26.4,55,35,24,22,9,21,44,47.7,23,36,7,29,17,72,52
1212,Alexandre Jankewitz,ch,MF,Southampton,Premier League,18,2001,0.0,2,1,2,0,0,1,1,100.0,0,0,0,0,0,2,0
1213,Saidy Janko,gm,DF,Valladolid,La Liga,24,1995,13.6,19,10,12,5,2,8,14,57.1,6,9,1,8,18,37,47
1214,Jakub Jankto,cz,MF,Sampdoria,it Serie A,24,1996,26.8,28,17,14,7,7,11,35,31.4,24,16,1,15,24,52,34
1215,Tony Jantschke,de,DF,Gladbach,Bundesliga,30,1990,3.0,2,2,1,1,0,1,3,33.3,2,6,4,2,4,6,7
1216,Adnan Januzaj,be,FW,Real Sociedad,La Liga,25,1995,11.3,9,8,0,6,3,3,8,37.5,5,7,2,5,3,12,4
1217,Rune Jarstein,no,GK,Hertha BSC,Bundesliga,35,1984,8.0,0,0,0,0,0,0,0,,0,0,0,0,0,0,7
1218,Jason,es,MF,Valencia,La Liga,26,1994,4.9,9,3,5,2,2,4,16,25.0,12,6,1,5,10,19,4
1219,Luis Javier Suárez,co,FW,Granada,La Liga,22,1997,18.5,19,11,5,7,7,6,17,35.3,11,10,1,9,8,27,11
1220,Corentin Jean,fr,FW,Lens,Ligue 1,25,1995,6.4,4,3,1,1,2,0,5,0.0,5,4,0,4,2,6,2
1221,Daniel Jebbison,eng,FW,Sheffield Utd,Premier League,16,2003,3.2,6,2,1,3,2,3,7,42.9,4,6,1,5,1,7,0
1222,Tin Jedvaj,hr,DF,Leverkusen,Bundesliga,24,1995,1.7,5,2,2,3,0,1,3,33.3,2,2,1,1,2,7,9
1223,Fredrik Jensen,fi,FW,Augsburg,Bundesliga,22,1997,4.2,3,2,1,2,0,3,6,50.0,3,4,1,3,2,5,6
1224,Jesé,es,FW,Paris S-G,Ligue 1,27,1993,0.3,0,0,0,0,0,0,1,0.0,1,0,0,0,0,0,0
1225,Gabriel Jesus,br,FW,Manchester City,Premier League,23,1997,22.9,17,6,5,5,7,11,28,39.3,17,16,0,16,15,32,5
1226,Juan Jesus,br,DF,Roma,it Serie A,29,1991,1.7,3,1,2,1,0,2,4,50.0,2,1,0,1,2,5,5
1227,Raúl Jiménez,mx,FW,Wolves,Premier League,29,1991,9.1,3,2,1,2,0,0,7,0.0,7,2,0,2,8,11,12
1228,Joaquín,es,FW,Betis,La Liga,39,1981,14.3,9,3,1,5,3,4,12,33.3,8,8,0,8,17,26,11
1229,John Joe,ie,MF,Getafe,La Liga,16,2003,0.7,2,0,0,2,0,0,0,,0,0,0,0,0,2,0
1230,Joelinton,br,FW,Newcastle Utd,Premier League,23,1996,22.0,33,21,7,21,5,14,37,37.8,23,30,2,28,9,42,24
1231,Marco John,de,DF,Hoffenheim,Bundesliga,18,2002,11.1,21,15,9,5,7,10,22,45.5,12,18,1,17,16,37,21
1232,Ben Johnson,eng,DF,West Ham,Premier League,20,2000,5.8,11,5,5,3,3,7,9,77.8,2,5,1,4,11,22,9
1233,Sam Johnstone,eng,GK,West Brom,Premier League,27,1993,37.0,0,0,0,0,0,0,0,,0,0,0,0,2,2,15
1234,Curtis Jones,eng,MF,Liverpool,Premier League,19,2001,13.1,16,6,6,7,3,12,25,48.0,13,13,0,13,19,35,11
1235,Frenkie de Jong,nl,MF,Barcelona,La Liga,23,1997,35.0,44,27,21,19,4,15,35,42.9,20,20,4,16,38,82,29
1236,Luuk de Jong,nl,FW,Sevilla,La Liga,29,1990,14.1,9,5,3,2,4,1,7,14.3,6,11,3,8,5,14,15
1237,Jony,es,MF,Osasuna,La Liga,29,1991,9.7,7,3,1,2,4,5,20,25.0,15,5,0,5,14,21,3
1238,Joan Jordán,es,MF,Sevilla,La Liga,26,1994,26.7,52,28,17,29,6,17,76,22.4,59,22,3,19,27,79,25
1239,Jorginho,it,MF,Chelsea,Premier League,28,1991,22.3,57,30,22,31,4,31,76,40.8,45,33,5,28,40,97,21
1240,Josan,es,MF,Elche,La Liga,30,1989,21.4,34,18,23,11,0,13,39,33.3,26,24,1,23,21,55,26
1241,Willian José,br,FW,Wolves,Premier League,28,1991,12.3,2,1,1,1,0,1,4,25.0,3,6,1,5,1,3,12
1242,Willian José,br,FW,Real Sociedad,La Liga,28,1991,7.7,3,1,0,3,0,1,3,33.3,2,3,1,2,0,3,8
1243,Joselu,es,FW,Alavés,La Liga,30,1990,33.6,27,14,6,15,6,8,28,28.6,20,26,3,23,15,42,58
1244,Josema,es,DF,Elche,La Liga,24,1996,21.8,43,28,33,10,0,10,18,55.6,8,17,7,10,37,80,92
1245,Jota,pt,MF,Valladolid,La Liga,21,1999,7.4,7,3,1,4,2,5,10,50.0,5,4,0,4,6,13,5
1246,Jota,es,MF,Alavés,La Liga,29,1991,15.5,19,14,6,7,6,3,29,10.3,26,12,0,12,9,28,9
1247,Diogo Jota,pt,FW,Liverpool,Premier League,23,1996,12.4,12,6,4,7,1,2,29,6.9,27,9,0,9,5,17,3
1248,Stevan Jovetić,me,FW,Monaco,Ligue 1,30,1989,8.9,8,4,2,3,3,3,13,23.1,10,1,0,1,3,11,3
1249,Luka Jović,rs,FW,Real Madrid,La Liga,22,1997,1.7,0,0,0,0,0,0,0,,0,0,0,0,0,0,0
1250,Luka Jović,rs,FW,Eint Frankfurt,Bundesliga,22,1997,9.9,2,0,0,2,0,0,4,0.0,4,3,0,3,1,3,7
1251,Juanmi,es,FW,Betis,La Liga,27,1993,6.7,13,9,3,5,5,4,18,22.2,14,4,0,4,2,15,4
1252,Hamed Junior Traorè,ci,MF,Sassuolo,it Serie A,20,2000,19.9,29,17,10,10,9,14,35,40.0,21,27,3,24,18,47,9
1253,Vinicius Júnior,br,FW,Real Madrid,La Liga,20,2000,21.9,32,22,14,10,8,11,43,25.6,32,28,0,28,7,39,4
1254,James Justin,eng,DF,Leicester City,Premier League,22,1998,23.0,61,37,38,18,5,20,41,48.8,21,36,10,26,30,91,58
1255,Musa Juwara,gm,MF,Bologna,it Serie A,18,2001,0.5,2,2,2,0,0,1,3,33.3,2,1,0,1,0,2,0
1256,Jens Jønsson,dk,MF,Cádiz,La Liga,27,1993,29.1,55,29,25,25,5,22,52,42.3,30,39,7,32,51,106,45
1257,Ozan Kabak,tr,DF,Liverpool,Premier League,20,2000,8.9,19,10,11,4,4,6,9,66.7,3,2,2,0,12,31,28
1258,Ozan Kabak,tr,DF,Schalke 04,Bundesliga,20,2000,13.8,17,9,11,5,1,6,13,46.2,7,20,11,9,13,30,57
1259,Abdoul Kader Bamba,fr,FW,Nantes,Ligue 1,26,1994,10.2,18,3,7,8,3,11,18,61.1,7,10,0,10,7,25,4
1260,Pavel Kadeřábek,cz,DF,Hoffenheim,Bundesliga,28,1992,17.6,15,12,7,6,2,6,15,40.0,9,12,3,9,18,33,31
1261,Tino Kadewere,zw,FW,Lyon,Ligue 1,24,1996,22.3,35,22,12,16,7,17,49,34.7,32,16,3,13,21,56,31
1262,Damian Kądzior,pl,FW,Eibar,La Liga,28,1992,2.2,1,0,0,1,0,1,5,20.0,4,1,0,1,0,1,0
1263,Florian Kainz,at,MF,Köln,Bundesliga,27,1992,5.0,4,2,0,4,0,2,8,25.0,6,7,0,7,3,7,3
1264,Gaël Kakuta,cd,MF,Lens,Ligue 1,29,1991,26.6,38,23,10,18,10,8,44,18.2,36,24,3,21,17,55,4
1265,Sasa Kalajdzic,at,FW,Stuttgart,Bundesliga,23,1997,23.7,16,12,4,5,7,2,17,11.8,15,10,1,9,9,25,21
1266,Arnaud Kalimuendo,fr,FW,Paris S-G,Ligue 1,18,2002,0.8,0,0,0,0,0,0,0,,0,0,0,0,0,0,0
1267,Arnaud Kalimuendo,fr,FW,Lens,Ligue 1,18,2002,13.5,8,2,2,2,4,1,7,14.3,6,11,0,11,2,10,2
1268,Nikola Kalinić,hr,FW,Hellas Verona,it Serie A,32,1988,11.8,5,1,2,2,1,0,3,0.0,3,6,0,6,1,6,7
1269,Yayah Kallon,sl,FW,Genoa,it Serie A,19,2001,0.5,0,0,0,0,0,0,0,,0,0,0,0,0,0,0
1270,Samuel Kalu,ng,FW,Bordeaux,Ligue 1,22,1997,10.7,21,12,11,8,2,4,13,30.8,9,14,0,14,9,30,2
1271,Pierre Kalulu,fr,DF,Milan,it Serie A,20,2000,8.1,18,14,11,6,1,10,14,71.4,4,9,3,6,19,37,20
1272,Daichi Kamada,jp,MF,Eint Frankfurt,Bundesliga,23,1996,26.2,48,28,21,16,11,16,49,32.7,33,18,1,17,14,62,22
1273,Aboubakar Kamara,mr,FW,Fulham,Premier League,25,1995,3.5,2,2,1,1,0,0,5,0.0,5,6,0,6,1,3,0
1274,Aboubakar Kamara,mr,FW,Dijon,Ligue 1,25,1995,6.2,3,1,0,2,1,1,7,14.3,6,1,0,1,0,3,2
1275,Bingourou Kamara,sn,GK,Strasbourg,Ligue 1,23,1996,8.0,1,1,1,0,0,1,3,33.3,2,0,0,0,1,2,2
1276,Boubacar Kamara,fr,MF,Marseille,Ligue 1,20,1999,32.2,88,51,31,49,8,40,74,54.1,34,36,13,23,34,122,51
1277,Hassane Kamara,ci,DF,Nice,Ligue 1,26,1994,32.9,65,39,40,16,9,27,49,55.1,22,39,12,27,55,120,61
1278,Marcin Kamiński,pl,DF,Stuttgart,Bundesliga,28,1992,2.4,1,1,0,0,1,0,0,,0,2,1,1,1,2,10
1279,Kevin Kampl,si,MF,RB Leipzig,Bundesliga,29,1990,21.5,38,26,9,24,5,18,35,51.4,17,20,2,18,29,67,14
1280,Harry Kane,eng,FW,Tottenham,Premier League,27,1993,34.2,22,12,1,17,4,8,26,30.8,18,28,11,17,11,33,40
1281,Lee Kang-in,kr,FW,Valencia,La Liga,19,2001,14.0,15,11,8,4,3,3,31,9.7,28,12,0,12,2,17,0
1282,Wilfried Kanga,ci,FW,Angers,Ligue 1,22,1998,1.5,0,0,0,0,0,0,1,0.0,1,1,0,1,0,0,2
1283,N'Golo Kanté,fr,MF,Chelsea,Premier League,29,1991,23.8,79,42,39,35,5,27,56,48.2,29,42,4,38,59,138,34
1284,Jimmy Kaparos,de,MF,Schalke 04,Bundesliga,18,2001,0.2,0,0,0,0,0,0,1,0.0,1,0,0,0,0,0,0
1285,Yann Karamoh,fr,FW,Parma,it Serie A,22,1998,14.4,27,17,8,12,7,11,31,35.5,20,6,0,6,4,31,11
1286,Isaac Karamoko,fr,DF,Sassuolo,it Serie A,18,2002,0.0,1,0,0,0,1,1,1,100.0,0,0,0,0,0,1,0
1287,Atakan Karazor,,DF,Stuttgart,Bundesliga,23,1996,11.5,20,12,12,7,1,13,22,59.1,9,18,8,10,21,41,50
1288,Augustus Kargbo,sl,FW,Crotone,it Serie A,20,1999,0.4,0,0,0,0,0,0,0,,0,0,0,0,0,0,0
1289,Loris Karius,de,GK,Union Berlin,Bundesliga,27,1993,3.2,0,0,0,0,0,0,0,,0,0,0,0,0,0,2
1290,Rick Karsdorp,nl,DF,Roma,it Serie A,25,1995,28.3,36,23,19,12,5,21,48,43.8,27,18,1,17,30,66,32
1291,Silas Katompa,cd,DF,Stuttgart,Bundesliga,21,1998,21.3,48,29,19,19,10,21,44,47.7,23,29,1,28,22,70,11
1292,Noah Katterbach,de,DF,Köln,Bundesliga,19,2001,12.3,18,11,11,6,1,13,21,61.9,8,7,3,4,23,41,22
1293,Eiji Kawashima,jp,GK,Strasbourg,Ligue 1,37,1983,24.0,1,0,1,0,0,1,1,100.0,0,0,0,0,0,1,4
1294,Moise Kean,it,FW,Everton,Premier League,20,2000,0.2,0,0,0,0,0,0,0,,0,0,0,0,0,0,0
1295,Moise Kean,it,FW,Paris S-G,Ligue 1,20,2000,18.9,11,8,2,6,3,3,12,25.0,9,7,1,6,8,19,10
1296,Michael Keane,eng,DF,Everton,Premier League,27,1993,33.2,28,15,20,8,0,14,31,45.2,17,46,33,13,51,79,161
1297,Neeskens Kebano,cd,FW,Fulham,Premier League,28,1992,1.3,0,0,0,0,0,0,1,0.0,1,3,0,3,0,0,0
1298,Thilo Kehrer,de,DF,Paris S-G,Ligue 1,23,1996,18.0,31,26,17,11,3,10,26,38.5,16,16,4,12,15,46,37
1299,Habib Keita,ml,MF,Lyon,Ligue 1,18,2002,0.1,0,0,0,0,0,0,0,,0,0,0,0,0,0,0
1300,Naby Keïta,gn,MF,Liverpool,Premier League,25,1995,5.8,11,5,1,8,2,7,17,41.2,10,10,0,10,9,20,6
1301,Yannik Keitel,de,MF,Freiburg,Bundesliga,20,2000,5.5,12,8,7,4,1,7,9,77.8,2,9,3,6,10,22,8
1302,Caoimhín Kelleher,ie,GK,Liverpool,Premier League,21,1998,2.0,0,0,0,0,0,0,0,,0,0,0,0,0,0,2
1303,Stephane Keller,cm,DF,Alavés,La Liga,18,2001,0.2,1,0,1,0,0,1,1,100.0,0,0,0,0,0,1,0
1304,Martin Kelly,eng,DF,Crystal Palace,Premier League,30,1990,0.0,1,0,1,0,0,1,1,100.0,0,0,0,0,0,1,0
1305,Marc-Oliver Kempf,de,DF,Stuttgart,Bundesliga,25,1995,30.3,49,26,28,18,3,29,49,59.2,20,40,25,15,68,117,103
1306,Kenedy,br,FW,Granada,La Liga,24,1996,16.3,22,12,10,7,5,5,25,20.0,20,21,4,17,26,48,15
1307,Jonjoe Kenny,eng,DF,Everton,Premier League,23,1997,0.9,2,1,1,0,1,2,2,100.0,0,0,0,0,1,3,3
1308,Franck Kessié,ci,MF,Milan,it Serie A,23,1996,35.8,53,30,28,19,6,20,38,52.6,18,47,15,32,46,99,51
1309,Reda Khadra,de,MF,Brighton,Premier League,19,2001,0.1,0,0,0,0,0,0,0,,0,0,0,0,0,0,0
1310,Omar Khailoti,it,DF,Bologna,it Serie A,18,2001,0.3,0,0,0,0,0,0,0,,0,2,0,2,1,1,0
1311,Saîf-Eddine Khaoui,tn,FW,Marseille,Ligue 1,25,1995,6.7,19,11,7,6,6,7,16,43.8,9,8,0,8,12,31,1
1312,Wahbi Khazri,tn,FW,Saint-Étienne,Ligue 1,29,1991,13.1,24,15,12,7,5,12,24,50.0,12,10,1,9,4,28,11
1313,Rani Khedira,de,MF,Augsburg,Bundesliga,26,1994,20.2,29,10,13,15,1,10,20,50.0,10,14,5,9,31,60,47
1314,Sami Khedira,de,MF,Hertha BSC,Bundesliga,33,1987,4.4,11,6,3,7,1,6,12,50.0,6,4,0,4,9,20,7
1315,Kiké,es,FW,Eibar,La Liga,30,1989,34.3,24,18,5,7,12,6,22,27.3,16,24,1,23,7,31,29
1316,Luca Kilian,de,DF,Mainz 05,Bundesliga,20,1999,4.2,14,7,10,4,0,9,17,52.9,8,3,1,2,13,27,12
1317,Max Kilman,eng,DF,Wolves,Premier League,23,1997,14.6,21,14,13,4,4,8,14,57.1,6,17,8,9,19,40,46
1318,Joshua Kimmich,de,MF,Bayern Munich,Bundesliga,25,1995,24.4,40,28,16,19,5,10,53,18.9,43,25,5,20,36,76,19
1319,Presnel Kimpembe,fr,DF,Paris S-G,Ligue 1,24,1995,25.6,46,28,23,19,4,24,34,70.6,10,19,11,8,30,76,61
1320,Joshua King,no,MF,Everton,Premier League,28,1992,1.6,4,1,2,1,1,0,0,,0,3,0,3,1,5,1
1321,Simon Kjær,dk,DF,Milan,it Serie A,31,1989,26.6,45,26,23,20,2,18,30,60.0,12,42,26,16,42,87,125
1322,Davy Klaassen,nl,MF,Werder Bremen,Bundesliga,27,1993,2.5,3,1,0,1,2,0,5,0.0,5,5,1,4,3,6,4
1323,Felix Klaus,de,DF,Wolfsburg,Bundesliga,27,1992,1.5,7,4,3,4,0,4,5,80.0,1,4,0,4,2,9,4
1324,Klauss,br,MF,Hoffenheim,Bundesliga,23,1997,0.6,1,0,0,0,1,0,1,0.0,1,0,0,0,0,1,0
1325,Ragnar Klavan,ee,DF,Cagliari,it Serie A,34,1985,8.6,15,9,9,5,1,7,11,63.6,4,9,4,5,8,23,34
1326,Philipp Klement,de,MF,Stuttgart,Bundesliga,27,1992,4.7,7,3,6,0,1,3,7,42.9,4,9,2,7,6,13,7
1327,Mateusz Klich,pl,MF,Leeds United,Premier League,30,1990,26.6,38,20,14,20,4,14,61,23.0,47,13,4,9,11,49,16
1328,Mateo Klimowicz,de,MF,Stuttgart,Bundesliga,20,2000,13.3,20,15,6,10,4,5,18,27.8,13,5,1,4,2,22,2
1329,Fabian Klos,de,FW,Arminia,Bundesliga,32,1987,30.1,24,13,9,11,4,7,26,26.9,19,20,6,14,4,28,29
1330,Lukas Klostermann,de,DF,RB Leipzig,Bundesliga,24,1996,16.1,23,19,8,12,3,11,18,61.1,7,16,6,10,18,41,44
1331,Justin Kluivert,nl,MF,Roma,it Serie A,21,1999,0.2,0,0,0,0,0,0,0,,0,0,0,0,0,0,0
1332,Justin Kluivert,nl,FW,RB Leipzig,Bundesliga,21,1999,9.0,2,1,1,1,0,0,2,0.0,2,4,0,4,5,7,3
1333,Lukas Klünter,de,DF,Hertha BSC,Bundesliga,24,1996,11.0,10,5,6,4,0,5,10,50.0,5,3,1,2,11,21,29
1334,Ansgar Knauff,de,MF,Dortmund,Bundesliga,18,2002,0.8,0,0,0,0,0,0,1,0.0,1,3,1,2,0,0,0
1335,Robin Knoche,de,DF,Union Berlin,Bundesliga,28,1992,33.8,44,29,30,12,2,23,39,59.0,16,43,27,16,49,93,118
1336,Gregor Kobel,ch,GK,Stuttgart,Bundesliga,22,1997,33.0,2,2,2,0,0,2,2,100.0,0,0,0,0,2,4,8
1337,Robin Koch,de,DF,Leeds United,Premier League,24,1996,12.6,27,16,17,10,0,10,19,52.6,9,18,12,6,27,54,34
1338,Giorgi Kochorashvili,ge,MF,Levante,La Liga,21,1999,0.3,1,0,1,0,0,0,0,,0,0,0,0,0,1,0
1339,Kenan Kodro,ba,FW,Valladolid,La Liga,26,1993,5.1,0,0,0,0,0,0,2,0.0,2,2,1,1,2,2,6
1340,Kenan Kodro,ba,FW,Athletic Club,La Liga,26,1993,0.5,0,0,0,0,0,0,1,0.0,1,0,0,0,0,0,0
1341,Dominik Kohr,de,MF,Mainz 05,Bundesliga,26,1994,14.1,47,31,14,26,7,20,39,51.3,19,18,5,13,27,74,15
1342,Dominik Kohr,de,MF,Eint Frankfurt,Bundesliga,26,1994,2.9,11,7,0,7,4,4,9,44.4,5,5,1,4,9,20,9
1343,Koba Koindredi,fr,MF,Valencia,La Liga,18,2001,0.2,1,1,1,0,0,0,1,0.0,1,0,0,0,0,1,0
1344,Koke,es,MF,Atlético Madrid,La Liga,28,1992,33.6,64,42,22,31,11,28,98,28.6,70,35,6,29,36,100,40
1345,Aleksandr Kokorin,ru,FW,Fiorentina,it Serie A,29,1991,1.0,1,0,0,1,0,0,1,0.0,1,1,0,1,0,1,0
1346,Aleksandar Kolarov,rs,DF,Inter,it Serie A,34,1985,4.3,4,4,0,4,0,1,2,50.0,1,2,0,2,7,11,8
1347,Sead Kolašinac,ba,DF,Arsenal,Premier League,27,1993,1.0,0,0,0,0,0,0,0,,0,0,0,0,1,1,0
1348,Sead Kolašinac,ba,DF,Schalke 04,Bundesliga,27,1993,15.8,20,17,10,7,3,8,18,44.4,10,17,5,12,20,40,17
1349,Randal Kolo Muani,fr,FW,Nantes,Ligue 1,21,1998,33.7,22,14,1,13,8,7,27,25.9,20,15,2,13,8,30,26
1350,Timothée Kolodziejczak,fr,DF,Saint-Étienne,Ligue 1,28,1991,22.6,28,15,23,5,0,19,27,70.4,8,24,15,9,36,64,80
1351,Ghislain Konan,ci,DF,Reims,Ligue 1,24,1995,29.0,57,32,35,17,5,32,56,57.1,24,25,11,14,30,87,67
1352,Ibrahima Konaté,fr,DF,RB Leipzig,Bundesliga,21,1999,7.7,6,4,2,3,1,2,8,25.0,6,6,3,3,8,14,24
1353,Moussa Konaté,sn,FW,Dijon,Ligue 1,27,1993,13.3,5,3,1,2,2,2,11,18.2,9,4,1,3,5,10,8
1354,Geoffrey Kondogbia,cf,MF,Valencia,La Liga,27,1993,4.9,16,9,9,4,3,7,19,36.8,12,6,1,5,8,24,8
1355,Geoffrey Kondogbia,cf,MF,Atlético Madrid,La Liga,27,1993,6.8,30,20,12,16,2,11,20,55.0,9,11,5,6,11,41,8
1356,Lamine Koné,ci,DF,Strasbourg,Ligue 1,31,1989,11.6,9,6,5,4,0,5,8,62.5,3,4,3,1,15,24,36
1357,Moussa Koné,sn,FW,Nîmes,Ligue 1,23,1996,19.5,13,6,1,8,4,2,9,22.2,7,7,1,6,2,15,7
1358,Youssouf Koné,ml,DF,Elche,La Liga,25,1995,0.8,2,0,1,0,1,0,1,0.0,1,0,0,0,0,2,0
1359,Terence Kongolo,nl,DF,Fulham,Premier League,26,1994,1.0,3,2,1,2,0,1,1,100.0,0,0,0,0,2,5,3
1360,Ezri Konsa,eng,DF,Aston Villa,Premier League,22,1997,35.5,25,13,18,6,1,9,13,69.2,4,53,47,6,29,54,162
1361,Laurent Koscielny,fr,DF,Bordeaux,Ligue 1,34,1985,24.6,29,17,18,11,0,16,24,66.7,8,44,34,10,54,83,115
1362,Filip Kostić,rs,DF,Eint Frankfurt,Bundesliga,27,1992,28.2,54,31,22,23,9,22,54,40.7,32,43,6,37,26,80,28
1363,Márk Kosznovszky,hu,MF,Parma,it Serie A,18,2002,1.0,2,2,1,1,0,1,4,25.0,3,2,0,2,1,3,1
1364,Christian Kouamé,ci,FW,Fiorentina,it Serie A,22,1997,11.1,9,4,2,4,3,4,12,33.3,8,9,1,8,5,14,4
1365,Kalidou Koulibaly,sn,DF,Napoli,it Serie A,29,1991,24.5,36,24,25,7,4,19,32,59.4,13,46,26,20,29,65,64
1366,Jules Koundé,fr,DF,Sevilla,La Liga,21,1998,33.1,27,15,14,11,2,10,24,41.7,14,24,16,8,40,67,104
1367,Boubakar Kouyaté,ml,DF,Metz,Ligue 1,23,1997,21.8,60,35,45,15,0,32,58,55.2,26,44,27,17,60,120,132
1368,Cheikhou Kouyaté,sn,DF,Crystal Palace,Premier League,30,1989,34.7,58,37,44,12,2,25,43,58.1,18,42,26,16,32,90,125
1369,Mateo Kovačić,hr,MF,Chelsea,Premier League,26,1994,20.2,46,28,19,24,3,17,32,53.1,15,18,1,17,15,61,11
1370,Viktor Kovalenko,ua,FW,Atalanta,it Serie A,24,1996,0.0,0,0,0,0,0,0,0,,0,0,0,0,0,0,1
1371,Emil Krafth,se,DF,Newcastle Utd,Premier League,25,1994,14.3,19,8,9,9,1,12,25,48.0,13,15,9,6,15,34,52
1372,Andrej Kramarić,hr,FW,Hoffenheim,Bundesliga,29,1991,26.4,7,4,4,0,3,3,8,37.5,5,8,1,7,7,14,5
1373,Christoph Kramer,de,MF,Gladbach,Bundesliga,29,1991,22.6,55,37,22,28,5,28,58,48.3,30,32,11,21,34,89,39
1374,Jean-Philippe Krasso,ci,FW,Saint-Étienne,Ligue 1,23,1997,2.5,5,3,1,4,0,2,4,50.0,2,5,0,5,1,6,3
1375,Toni Kroos,de,MF,Real Madrid,La Liga,30,1990,23.5,42,22,15,15,12,11,44,25.0,33,26,6,20,15,57,10
1376,Filip Krovinović,hr,MF,West Brom,Premier League,24,1995,6.1,13,10,6,5,2,6,18,33.3,12,2,0,2,4,17,2
1377,Rade Krunić,ba,MF,Milan,it Serie A,26,1993,8.0,15,12,6,6,3,7,17,41.2,10,12,2,10,10,25,9
1378,Max Kruse,de,FW,Union Berlin,Bundesliga,32,1988,18.1,7,3,1,5,1,2,9,22.2,7,11,0,11,3,10,3
1379,Lukas Kübler,de,DF,Freiburg,Bundesliga,27,1992,9.8,15,8,9,5,1,9,14,64.3,5,9,3,6,21,36,31
1380,Takefusa Kubo,jp,MF,Villarreal,La Liga,19,2001,3.3,1,1,0,0,1,1,5,20.0,4,2,0,2,1,2,2
1381,Takefusa Kubo,jp,MF,Getafe,La Liga,19,2001,8.9,7,4,2,3,2,1,14,7.1,13,14,0,14,14,21,4
1382,Juraj Kucka,sk,MF,Parma,it Serie A,33,1987,25.9,67,36,21,37,9,26,74,35.1,48,25,3,22,28,95,25
1383,Kuki,es,MF,Valladolid,La Liga,22,1998,0.3,1,1,0,0,1,0,1,0.0,1,0,0,0,0,1,0
1384,Dejan Kulusevski,se,MF,Juventus,it Serie A,20,2000,21.4,33,19,12,10,11,14,43,32.6,29,22,0,22,9,42,2
1385,Marash Kumbulla,al,DF,Roma,it Serie A,20,2000,15.1,16,11,8,7,1,5,17,29.4,12,12,5,7,24,40,38
1386,Pierre Kunde,cm,MF,Mainz 05,Bundesliga,25,1995,5.7,8,4,1,5,2,2,9,22.2,7,6,0,6,10,18,9
1387,Fabian Kunze,de,MF,Arminia,Bundesliga,22,1998,14.1,38,26,19,15,4,19,42,45.2,23,19,3,16,18,56,22
1388,Jasmin Kurtić,si,MF,Parma,it Serie A,31,1989,30.4,46,28,22,21,3,21,70,30.0,49,22,2,20,33,79,57
1389,Layvin Kurzawa,fr,DF,Paris S-G,Ligue 1,27,1992,14.2,26,19,10,10,6,9,28,32.1,19,20,5,15,28,54,26
1390,Dereck Kutesa,ch,MF,Reims,Ligue 1,22,1997,7.6,15,7,7,3,5,5,14,35.7,9,7,1,6,7,22,3
1391,Ahmed Kutucu,tr,FW,Schalke 04,Bundesliga,20,2000,1.2,1,0,0,0,1,1,2,50.0,1,1,0,1,0,1,0
1392,Enock Kwateng,fr,DF,Bordeaux,Ligue 1,23,1997,11.5,21,12,15,4,2,14,27,51.9,13,15,3,12,26,47,27
1393,Giorgos Kyriakopoulos,gr,DF,Sassuolo,it Serie A,24,1996,16.2,35,18,17,12,6,8,28,28.6,20,16,5,11,15,50,42
1394,Antonino La Gumina,it,FW,Sampdoria,it Serie A,24,1996,3.8,3,2,0,1,2,0,3,0.0,3,5,1,4,3,6,5
1395,Gaëtan Laborde,fr,FW,Montpellier,Ligue 1,26,1994,36.2,43,22,21,17,5,16,60,26.7,44,29,3,26,16,59,25
1396,Alexandre Lacazette,fr,FW,Arsenal,Premier League,29,1991,21.4,18,10,4,11,3,4,22,18.2,18,20,1,19,12,30,13
1397,Tom Lacoux,fr,MF,Bordeaux,Ligue 1,18,2002,5.8,22,14,10,11,1,9,21,42.9,12,12,3,9,12,34,7
1398,Maxence Lacroix,fr,DF,Wolfsburg,Bundesliga,20,2000,28.8,49,29,37,12,0,24,45,53.3,21,51,21,30,65,114,140
1399,Alban Lafont,fr,GK,Nantes,Ligue 1,21,1999,38.0,1,0,1,0,0,1,1,100.0,0,1,0,1,0,1,14
1400,Víctor Laguardia,es,DF,Alavés,La Liga,30,1989,29.2,20,12,13,6,1,14,31,45.2,17,25,13,12,37,57,104
1401,Konrad Laimer,at,DF,RB Leipzig,Bundesliga,23,1997,0.9,2,0,0,1,1,0,4,0.0,4,2,0,2,1,3,0
1402,Stefan Lainer,at,DF,Gladbach,Bundesliga,27,1992,30.8,62,37,30,22,10,27,60,45.0,33,34,5,29,35,97,85
1403,Diego Lainez,mx,FW,Betis,La Liga,20,2000,9.6,9,4,3,5,1,6,16,37.5,10,15,0,15,11,20,6
1404,Kenny Lala,mg,DF,Strasbourg,Ligue 1,28,1991,20.4,22,13,13,8,1,11,22,50.0,11,12,6,6,23,45,33
1405,Adam Lallana,eng,MF,Brighton,Premier League,32,1988,17.7,28,13,11,13,4,8,39,20.5,31,18,3,15,15,43,13
1406,Érik Lamela,ar,FW,Tottenham,Premier League,28,1992,8.0,17,9,1,11,5,8,21,38.1,13,11,1,10,6,23,2
1407,Sam Lammers,nl,FW,Atalanta,it Serie A,23,1997,3.2,2,0,0,2,0,0,6,0.0,6,0,0,0,0,2,3
1408,Tariq Lamptey,gh,DF,Brighton,Premier League,19,2000,9.8,17,9,7,6,4,6,13,46.2,7,8,1,7,19,36,12
1409,Loïck Landre,fr,DF,Nîmes,Ligue 1,28,1992,18.1,14,7,9,5,0,13,28,46.4,15,22,19,3,31,45,52
1410,Michael Langer,at,GK,Schalke 04,Bundesliga,35,1985,2.7,0,0,0,0,0,0,0,,0,0,0,0,0,0,3
1411,Manuel Lanzini,ar,MF,West Ham,Premier League,27,1993,6.3,9,2,3,4,2,3,10,30.0,7,9,0,9,7,16,5
1412,Gianluca Lapadula,pe,FW,Benevento,it Serie A,30,1990,28.5,22,12,3,13,6,6,25,24.0,19,18,3,15,5,27,16
1413,Aymeric Laporte,es,DF,Manchester City,Premier League,26,1994,14.9,13,6,10,3,0,7,11,63.6,4,12,7,5,11,24,28
1414,Julien Laporte,fr,DF,Lorient,Ligue 1,26,1993,29.5,65,39,48,16,1,42,74,56.8,32,34,23,11,65,130,125
1415,Danilo Larangeira,br,DF,Bologna,it Serie A,36,1984,34.8,33,24,23,10,0,8,29,27.6,21,58,36,22,51,84,127
1416,Gautier Larsonneur,fr,GK,Brest,Ligue 1,23,1997,35.0,1,1,1,0,0,1,1,100.0,0,2,0,2,0,1,16
1417,Kevin Lasagna,it,FW,Udinese,it Serie A,27,1992,12.3,6,1,2,3,1,3,14,21.4,11,11,0,11,6,12,7
1418,Kevin Lasagna,it,FW,Hellas Verona,it Serie A,27,1992,14.1,7,3,0,5,2,1,5,20.0,4,12,1,11,1,8,11
1419,Jamaal Lascelles,eng,DF,Newcastle Utd,Premier League,26,1993,18.1,14,7,5,9,0,3,6,50.0,3,27,17,10,12,26,86
1420,Paul Lasne,fr,MF,Brest,Ligue 1,31,1989,18.7,46,26,25,19,2,17,40,42.5,23,25,5,20,47,93,17
1421,Toni Lato,es,DF,Valencia,La Liga,22,1997,8.1,13,6,7,3,3,6,13,46.2,7,12,1,11,10,23,21
1422,Danny Latza,de,MF,Mainz 05,Bundesliga,30,1989,20.0,43,26,12,19,12,23,70,32.9,47,39,3,36,27,70,23
1423,Armand Lauriente,fr,MF,Lorient,Ligue 1,21,1998,18.0,30,10,10,19,1,7,26,26.9,19,21,0,21,15,45,4
1424,Vincent Laurini,fr,DF,Parma,it Serie A,31,1989,9.7,16,11,8,6,2,7,9,77.8,2,8,4,4,17,33,22
1425,Lauti,uy,MF,Celta Vigo,La Liga,19,2001,0.2,0,0,0,0,0,0,0,,0,0,0,0,0,0,1
1426,Wesley Lautoa,nc,MF,Dijon,Ligue 1,32,1987,17.9,36,20,20,13,3,11,37,29.7,26,17,8,9,29,65,33
1427,Valentino Lazaro,at,DF,Gladbach,Bundesliga,24,1996,13.8,17,11,7,5,5,12,19,63.2,7,18,1,17,15,32,20
1428,Darko Lazović,rs,DF,Hellas Verona,it Serie A,29,1990,27.8,29,17,8,17,4,20,42,47.6,22,17,7,10,20,49,29
1429,Manuel Lazzari,it,DF,Lazio,it Serie A,26,1993,29.0,24,14,15,4,5,14,39,35.9,25,22,3,19,18,42,28
1430,Jérémy Le Douaron,fr,FW,Brest,Ligue 1,22,1998,9.1,15,10,9,4,2,7,21,33.3,14,14,1,13,8,23,11
1431,Enzo Le Fée,fr,MF,Lorient,Ligue 1,20,2000,20.2,51,28,23,23,5,27,73,37.0,46,30,6,24,25,76,10
1432,Vincent Le Goff,fr,DF,Lorient,Ligue 1,30,1989,25.6,42,29,16,24,2,18,49,36.7,31,27,5,22,44,86,44
1433,Maxime Le Marchand,fr,DF,Fulham,Premier League,30,1989,1.4,2,2,2,0,0,2,2,100.0,0,0,0,0,0,2,3
1434,Robin Le Normand,es,DF,Real Sociedad,La Liga,23,1996,30.5,34,20,25,8,1,9,19,47.4,10,35,24,11,36,70,87
1435,Damien Le Tallec,fr,MF,Montpellier,Ligue 1,30,1990,13.6,16,10,10,4,2,10,30,33.3,20,15,8,7,25,41,21
1436,James Lea Siliki,cm,MF,Rennes,Ligue 1,24,1996,2.8,5,2,1,3,1,2,2,100.0,0,3,0,3,1,6,1
1437,Rafael Leão,pt,FW,Milan,it Serie A,21,1999,21.4,13,6,4,7,2,6,15,40.0,9,17,0,17,4,17,14
1438,Jean-Louis Leca,fr,GK,Lens,Ligue 1,34,1985,36.8,3,2,3,0,0,3,5,60.0,2,0,0,0,1,4,14
1439,Mathew Leckie,au,FW,Hertha BSC,Bundesliga,29,1991,5.6,12,3,5,5,2,4,11,36.4,7,8,0,8,13,25,9
1440,Benjamin Lecomte,fr,GK,Monaco,Ligue 1,29,1991,28.0,0,0,0,0,0,0,2,0.0,2,1,0,1,2,2,20
1441,Jeremías Ledesma,ar,GK,Cádiz,La Liga,27,1993,32.0,1,0,1,0,0,1,1,100.0,0,1,0,1,0,1,22
1442,Pierre Lees-Melou,fr,MF,Nice,Ligue 1,27,1993,22.9,67,39,33,31,3,25,83,30.1,58,50,14,36,29,96,31
1443,Lucas Leiva,br,MF,Lazio,it Serie A,33,1987,23.7,68,32,38,28,2,30,86,34.9,56,21,0,21,57,125,21
1444,Florian Lejeune,fr,DF,Alavés,La Liga,29,1991,33.5,43,32,36,7,0,21,35,60.0,14,38,24,14,51,94,149
1445,Iñigo Lekue,es,DF,Athletic Club,La Liga,27,1993,7.2,9,7,6,3,0,3,8,37.5,5,8,1,7,4,13,24
1446,Thomas Lemar,fr,MF,Atlético Madrid,La Liga,24,1995,15.2,30,17,9,17,4,11,24,45.8,13,22,1,21,11,41,10
1447,Mario Lemina,ga,MF,Fulham,Premier League,26,1993,18.9,62,35,25,30,7,23,44,52.3,21,26,5,21,30,92,21
1448,Fabien Lemoine,fr,MF,Lorient,Ligue 1,33,1987,21.5,74,45,39,33,2,36,89,40.4,53,25,1,24,27,101,35
1449,Clément Lenglet,fr,DF,Barcelona,La Liga,25,1995,27.5,36,21,23,10,3,19,28,67.9,9,26,12,14,33,69,71
1450,Bernd Leno,de,GK,Arsenal,Premier League,28,1992,34.8,1,0,1,0,0,1,1,100.0,0,1,0,1,0,1,11
1451,Christopher Lenz,de,DF,Union Berlin,Bundesliga,25,1994,25.0,74,41,39,30,5,35,71,49.3,36,34,5,29,35,109,50
1452,Pedro León,es,MF,Eibar,La Liga,33,1986,10.4,9,8,3,3,3,3,17,17.6,14,11,0,11,7,16,2
1453,Sergio León,es,FW,Levante,La Liga,31,1989,8.3,6,2,0,4,2,2,8,25.0,6,4,0,4,3,9,2
1454,Lukas Lerager,dk,MF,Genoa,it Serie A,27,1993,12.9,24,13,14,9,1,11,30,36.7,19,13,3,10,14,38,25
1455,Mehdi Léris,dz,DF,Sampdoria,it Serie A,22,1998,4.3,11,5,6,4,1,6,16,37.5,10,12,2,10,12,23,15
1456,Khanya Leshabela,za,MF,Leicester City,Premier League,20,1999,0.1,0,0,0,0,0,0,0,,0,0,0,0,0,0,0
1457,Karlo Letica,hr,GK,Sampdoria,it Serie A,23,1997,1.0,0,0,0,0,0,0,0,,0,0,0,0,0,0,2
1458,Gaetano Letizia,it,DF,Benevento,it Serie A,30,1990,17.4,36,25,19,13,4,17,36,47.2,19,15,3,12,20,56,42
1459,Robert Lewandowski,pl,FW,Bayern Munich,Bundesliga,31,1988,27.3,15,9,0,7,8,2,13,15.4,11,9,1,8,3,18,11
1460,Jamal Lewis,nir,DF,Newcastle Utd,Premier League,22,1998,20.4,37,20,23,13,1,16,38,42.1,22,21,7,14,11,48,44
1461,Aaron Leya Iseka,be,FW,Metz,Ligue 1,22,1997,11.2,6,4,2,3,1,0,4,0.0,4,4,2,2,0,6,6
1462,Yanis Lhery,fr,MF,Saint-Étienne,Ligue 1,17,2003,0.3,0,0,0,0,0,0,0,,0,0,0,0,0,0,0
1463,Dimitri Liénard,fr,MF,Strasbourg,Ligue 1,32,1988,20.3,39,27,17,19,3,24,55,43.6,31,23,1,22,18,57,10
1464,Philipp Lienhart,at,DF,Freiburg,Bundesliga,24,1996,33.3,21,13,12,7,2,9,20,45.0,11,30,21,9,42,63,100
1465,Matthijs de Ligt,nl,DF,Juventus,it Serie A,20,1999,24.7,37,19,20,16,1,18,28,64.3,10,42,21,21,31,68,64
1466,Isaac Lihadji,fr,MF,Lille,Ligue 1,18,2002,2.2,11,4,2,6,3,4,5,80.0,1,5,1,4,1,12,0
1467,Dimitris Limnios,gr,MF,Köln,Bundesliga,22,1998,4.2,9,6,3,5,1,5,6,83.3,1,5,0,5,2,11,1
1468,Victor Lindelöf,se,DF,Manchester Utd,Premier League,26,1994,28.7,22,10,12,10,0,12,24,50.0,12,22,14,8,30,52,95
1469,Karol Linetty,pl,MF,Torino,it Serie A,25,1995,20.4,38,28,13,19,6,16,45,35.6,29,19,5,14,15,53,7
1470,Jesse Lingard,eng,MF,West Ham,Premier League,27,1992,15.8,12,6,4,8,0,5,14,35.7,9,7,1,6,4,16,0
1471,Pol Lirola,es,DF,Fiorentina,it Serie A,22,1997,5.5,13,8,8,2,3,6,12,50.0,6,6,3,3,6,19,9
1472,Pol Lirola,es,DF,Marseille,Ligue 1,22,1997,17.3,28,16,11,15,2,16,28,57.1,12,18,5,13,25,53,26
1473,Jake Livermore,eng,MF,West Brom,Premier League,30,1989,13.8,33,18,14,16,3,14,31,45.2,17,21,6,15,16,49,26
1474,Diego Llorente,es,DF,Leeds United,Premier League,26,1993,13.4,34,21,21,13,0,19,32,59.4,13,18,13,5,20,54,40
1475,Diego Llorente,es,DF,Real Sociedad,La Liga,26,1993,1.0,1,0,1,0,0,1,2,50.0,1,1,1,0,2,3,5
1476,Fernando Llorente,es,FW,Udinese,it Serie A,35,1985,7.9,4,1,2,2,0,2,5,40.0,3,3,0,3,2,6,17
1477,Fernando Llorente,es,FW,Napoli,it Serie A,35,1985,0.6,0,0,0,0,0,0,0,,0,0,0,0,0,0,0
1478,Marcos Llorente,es,MF,Atlético Madrid,La Liga,25,1995,32.8,71,42,21,40,10,26,62,41.9,36,40,3,37,29,100,28
1479,Hugo Lloris,fr,GK,Tottenham,Premier League,33,1986,38.0,0,0,0,0,0,0,1,0.0,1,0,0,0,0,0,10
1480,Giovani Lo Celso,ar,MF,Tottenham,Premier League,24,1996,10.5,28,22,12,11,5,10,29,34.5,19,12,1,11,7,35,5
1481,Stanislav Lobotka,sk,MF,Napoli,it Serie A,25,1994,1.7,1,1,0,1,0,0,1,0.0,1,1,1,0,0,1,1
1482,Manuel Locatelli,it,MF,Sassuolo,it Serie A,22,1998,32.0,81,47,43,28,10,29,56,51.8,27,35,15,20,51,132,65
1483,Renan Lodi,br,DF,Atlético Madrid,La Liga,22,1998,12.5,30,17,13,12,5,17,26,65.4,9,15,0,15,16,46,18
1484,Ruben Loftus-Cheek,eng,FW,Chelsea,Premier League,24,1996,0.7,0,0,0,0,0,0,0,,0,0,0,0,0,0,0
1485,Ruben Loftus-Cheek,eng,MF,Fulham,Premier League,24,1996,21.2,25,14,7,15,3,7,23,30.4,16,20,2,18,7,32,18
1486,Niklas Lomb,de,GK,Leverkusen,Bundesliga,27,1993,1.5,0,0,0,0,0,0,0,,0,0,0,0,0,0,0
1487,Kevin Long,ie,DF,Burnley,Premier League,29,1990,7.1,11,6,9,2,0,7,9,77.8,2,11,7,4,6,17,24
1488,Shane Long,ie,FW,Southampton,Premier League,33,1987,2.3,2,1,0,0,2,2,3,66.7,1,0,0,0,3,5,1
1489,Matthew Longstaff,eng,MF,Newcastle Utd,Premier League,20,2000,4.2,3,2,2,1,0,2,8,25.0,6,7,0,7,7,10,2
1490,Sean Longstaff,eng,MF,Newcastle Utd,Premier League,22,1997,15.7,31,14,13,15,3,18,42,42.9,24,26,5,21,19,50,14
1491,Ademola Lookman,ng,FW,Fulham,Premier League,22,1997,30.5,35,11,18,9,8,13,44,29.5,31,31,1,30,20,55,9
1492,Anthony Lopes,pt,GK,Lyon,Ligue 1,29,1990,38.0,1,1,1,0,0,1,2,50.0,1,1,0,1,1,2,20
1493,Rony Lopes,pt,FW,Nice,Ligue 1,24,1995,19.8,20,14,4,13,3,6,27,22.2,21,14,3,11,8,28,6
1494,Adrián López,es,FW,Osasuna,La Liga,32,1988,5.3,3,3,0,1,2,1,5,20.0,4,3,0,3,0,3,3
1495,Javi López,es,DF,Alavés,La Liga,18,2002,2.8,5,5,3,2,0,2,3,66.7,1,2,0,2,3,8,3
1496,Maxime Lopez,fr,MF,Sassuolo,it Serie A,22,1997,20.7,24,13,15,6,3,14,41,34.1,27,9,0,9,16,40,10
1497,Maxime Lopez,fr,FW,Marseille,Ligue 1,22,1997,1.5,1,1,1,0,0,0,2,0.0,2,0,0,0,2,3,2
1498,Pedro López Muñoz,es,DF,Huesca,La Liga,36,1983,11.9,23,15,10,8,5,15,22,68.2,7,10,4,6,16,39,23
1499,Pau López,es,GK,Roma,it Serie A,25,1994,20.2,2,0,2,0,0,2,2,100.0,0,1,0,1,0,2,7
1500,Roberto López,es,MF,Real Sociedad,La Liga,20,2000,5.6,5,1,1,2,2,2,5,40.0,3,2,0,2,4,9,6
1501,Unai López,es,MF,Athletic Club,La Liga,24,1995,15.8,27,17,13,13,1,10,29,34.5,19,20,5,15,18,45,9
1502,Dion Lopy,sn,MF,Reims,Ligue 1,18,2002,2.8,1,1,0,1,0,0,0,,0,0,0,0,2,3,1
1503,Jordan Lotomba,ch,DF,Nice,Ligue 1,21,1998,23.6,35,25,19,11,5,20,34,58.8,14,19,7,12,33,68,52
1504,Adrien Louveau,fr,MF,Lens,Ligue 1,20,2000,0.1,0,0,0,0,0,0,0,,0,0,0,0,0,0,1
1505,Imran Louza,ma,MF,Nantes,Ligue 1,21,1999,26.4,55,28,25,26,4,21,69,30.4,48,20,4,16,33,88,15
1506,Matteo Lovato,it,DF,Hellas Verona,it Serie A,20,2000,15.4,21,12,14,5,2,10,21,47.6,11,20,10,10,37,58,48
1507,Max Lowe,eng,DF,Sheffield Utd,Premier League,23,1997,6.1,26,11,18,6,2,9,21,42.9,12,12,4,8,5,31,11
1508,Eduard Löwen,de,MF,Hertha BSC,Bundesliga,23,1997,0.9,5,1,3,1,1,2,5,40.0,3,1,0,1,1,6,1
1509,Matthew Lowton,eng,DF,Burnley,Premier League,31,1989,34.0,54,32,31,22,1,32,73,43.8,41,36,13,23,56,110,91
1510,Anthony Lozano,hn,FW,Cádiz,La Liga,27,1993,16.9,12,4,1,5,6,2,13,15.4,11,3,1,2,3,15,8
1511,Hirving Lozano,mx,FW,Napoli,it Serie A,25,1995,21.8,29,18,10,13,6,10,36,27.8,26,37,1,36,18,47,14
1512,Jan Luca Schuler,de,FW,Schalke 04,Bundesliga,21,1999,0.4,2,2,1,1,0,0,1,0.0,1,1,0,1,0,2,0
1513,Jean Lucas,br,MF,Lyon,Ligue 1,22,1998,1.9,3,2,2,1,0,1,4,25.0,3,3,1,2,2,5,1
1514,Jean Lucas,br,MF,Brest,Ligue 1,22,1998,11.2,19,13,10,9,0,8,29,27.6,21,7,0,7,8,27,10
1515,Anderson Lucoqui,ao,DF,Arminia,Bundesliga,23,1997,17.8,40,25,23,17,0,20,40,50.0,20,30,7,23,27,67,53
1516,Jeison Lucumí,co,MF,Elche,La Liga,25,1995,0.5,1,1,0,1,0,0,0,,0,1,0,1,0,1,0
1517,Kilian Ludewig,de,DF,Schalke 04,Bundesliga,20,2000,5.8,16,6,10,5,1,8,25,32.0,17,7,0,7,3,19,14
1518,Florentino Luís,pt,MF,Monaco,Ligue 1,20,1999,2.7,7,2,4,2,1,6,10,60.0,4,1,0,1,6,13,2
1519,José Luis Gayà,es,DF,Valencia,La Liga,25,1995,31.6,59,33,40,13,6,33,68,48.5,35,22,3,19,38,97,62
1520,José Luis Morales,es,MF,Levante,La Liga,33,1987,27.1,18,10,7,9,2,8,36,22.2,28,17,0,17,11,29,11
1521,José Luis Palomino,ar,DF,Atalanta,it Serie A,30,1990,27.0,67,33,41,19,7,24,48,50.0,24,30,16,14,79,146,60
1522,Luisinho,pt,DF,Huesca,La Liga,35,1985,2.0,3,3,2,1,0,1,3,33.3,2,3,0,3,4,7,7
1523,Luismi,es,MF,Elche,La Liga,28,1992,1.9,4,2,1,3,0,1,2,50.0,1,2,0,2,4,8,0
1524,David Luiz,br,DF,Arsenal,Premier League,33,1987,15.5,12,9,5,7,0,4,4,100.0,0,16,9,7,16,28,50
1525,Douglas Luiz,br,MF,Aston Villa,Premier League,22,1998,30.9,49,18,22,26,1,20,58,34.5,38,52,17,35,43,92,44
1526,Romelu Lukaku,be,FW,Inter,it Serie A,27,1993,32.0,11,1,1,6,4,6,14,42.9,8,11,1,10,3,14,34
1527,Dodi Lukebakio,be,FW,Hertha BSC,Bundesliga,22,1997,20.6,21,14,13,5,3,9,20,45.0,11,14,1,13,12,33,8
1528,Saša Lukić,rs,MF,Torino,it Serie A,23,1996,23.4,32,13,11,18,3,15,50,30.0,35,23,5,18,17,49,17
1529,Senad Lulić,ba,DF,Lazio,it Serie A,34,1986,8.0,14,7,6,5,3,7,15,46.7,8,10,1,9,4,18,13
1530,John Lundstram,eng,MF,Sheffield Utd,Premier League,26,1994,22.6,25,16,12,11,2,13,47,27.7,34,26,8,18,14,39,29
1531,Sebastiano Luperto,it,DF,Crotone,it Serie A,23,1996,20.9,38,20,28,8,2,16,27,59.3,11,17,7,10,27,65,74
1532,Andreas Luthe,de,GK,Union Berlin,Bundesliga,33,1987,30.8,1,1,1,0,0,1,3,33.3,2,1,0,1,0,1,8
1533,Lyanco,br,DF,Torino,it Serie A,23,1997,21.8,21,14,13,6,2,8,14,57.1,6,36,26,10,46,67,76
1534,Charalambos Lykogiannis,gr,DF,Cagliari,it Serie A,26,1993,26.9,34,21,22,9,3,22,38,57.9,16,34,13,21,32,66,94
1535,Yann M'Vila,fr,MF,Saint-Étienne,Ligue 1,30,1990,0.2,0,0,0,0,0,0,2,0.0,2,0,0,0,1,1,0
1536,Alexis Mac Allister,ar,MF,Brighton,Premier League,21,1998,12.4,26,12,6,16,4,11,38,28.9,27,25,4,21,9,35,4
1537,Darwin Machís,ve,FW,Granada,La Liga,27,1993,22.5,30,17,12,10,8,6,19,31.6,13,21,2,19,22,52,13
1538,Tim Maciejewski,de,FW,Union Berlin,Bundesliga,19,2001,0.1,0,0,0,0,0,0,0,,0,0,0,0,0,0,0
1539,Luca Mack,de,MF,Stuttgart,Bundesliga,20,2000,0.1,0,0,0,0,0,0,0,,0,0,0,0,0,0,1
1540,Yvann Macon,fr,DF,Saint-Étienne,Ligue 1,21,1998,6.0,30,20,20,8,2,7,19,36.8,12,6,2,4,9,39,13
1541,James Maddison,eng,MF,Leicester City,Premier League,23,1996,23.3,32,16,5,16,11,14,41,34.1,27,14,1,13,9,41,5
1542,Mikail Maden,no,FW,Schalke 04,Bundesliga,18,2002,0.1,0,0,0,0,0,0,0,,0,0,0,0,0,0,0
1543,Pablo Maffeo,es,DF,Huesca,La Liga,23,1997,21.8,26,17,21,4,1,12,26,46.2,14,18,6,12,35,61,27
1544,Gabriel Magalhães,br,DF,Arsenal,Premier League,22,1997,22.2,25,15,19,5,1,13,19,68.4,6,27,19,8,26,51,74
1545,Lisandro Magallán,ar,DF,Crotone,it Serie A,26,1993,24.2,54,31,28,24,2,17,42,40.5,25,29,15,14,44,98,78
1546,Christian Maggio,it,DF,Benevento,it Serie A,38,1982,3.3,9,4,2,7,0,3,9,33.3,6,4,1,3,2,11,6
1547,Giulio Maggiore,it,MF,Spezia,it Serie A,22,1998,24.6,61,36,26,28,7,21,53,39.6,32,33,6,27,19,80,25
1548,Francesco Magnanelli,it,MF,Sassuolo,it Serie A,35,1984,4.9,7,5,2,5,0,3,10,30.0,7,6,2,4,13,20,10
1549,Giangiacomo Magnani,it,DF,Hellas Verona,it Serie A,24,1995,16.8,26,15,14,9,3,9,16,56.3,7,25,16,9,44,70,105
1550,Hugo Magnetti,fr,MF,Brest,Ligue 1,22,1998,6.7,24,12,10,13,1,20,40,50.0,20,6,1,5,14,38,8
1551,Harry Maguire,eng,DF,Manchester Utd,Premier League,27,1993,33.9,29,17,19,10,0,18,29,62.1,11,28,23,5,60,89,122
1552,Abdallahi Mahmoud,mr,MF,Alavés,La Liga,20,2000,0.7,2,2,1,1,0,0,1,0.0,1,0,0,0,1,3,0
1553,Hicham Mahou,fr,FW,Nice,Ligue 1,21,1999,0.4,1,1,1,0,0,1,2,50.0,1,2,0,2,1,2,0
1554,Riyad Mahrez,dz,FW,Manchester City,Premier League,29,1991,21.7,20,5,2,10,8,6,30,20.0,24,19,0,19,8,28,4
1555,Arne Maier,de,MF,Arminia,Bundesliga,21,1999,11.5,13,9,5,7,1,4,11,36.4,7,10,3,7,8,21,11
1556,Arne Maier,de,MF,Hertha BSC,Bundesliga,21,1999,0.3,1,1,0,1,0,0,1,0.0,1,0,0,0,0,1,0
1557,Habib Maïga,ci,MF,Metz,Ligue 1,24,1996,29.9,81,52,36,40,5,42,85,49.4,43,37,6,31,49,130,36
1558,Mike Maignan,fr,GK,Lille,Ligue 1,25,1995,38.0,0,0,0,0,0,0,0,,0,0,0,0,0,0,7
1559,Ainsley Maitland-Niles,eng,MF,Arsenal,Premier League,22,1997,5.4,11,7,6,5,0,8,12,66.7,4,12,2,10,14,25,7
1560,Ainsley Maitland-Niles,eng,MF,West Brom,Premier League,22,1997,13.7,22,10,7,8,7,9,28,32.1,19,12,1,11,17,39,24
1561,Josh Maja,ng,FW,Fulham,Premier League,21,1998,9.0,7,4,0,3,4,4,10,40.0,6,3,1,2,4,11,1
1562,Josh Maja,ng,FW,Bordeaux,Ligue 1,21,1998,8.9,8,2,3,3,2,3,14,21.4,11,3,0,3,6,14,9
1563,Radosław Majecki,pl,GK,Monaco,Ligue 1,20,1999,1.0,0,0,0,0,0,0,0,,0,0,0,0,0,0,1
1564,Abdul Majeed Waris,gh,FW,Strasbourg,Ligue 1,28,1991,6.1,1,1,1,0,0,1,6,16.7,5,0,0,0,2,3,2
1565,Marco Majouga,cf,FW,Nîmes,Ligue 1,19,2001,1.4,1,1,1,0,0,1,3,33.3,2,0,0,0,0,1,0
1566,Jean-Victor Makengo,fr,MF,Udinese,it Serie A,22,1998,5.8,8,7,5,3,0,3,13,23.1,10,7,1,6,5,13,7
1567,Nemanja Maksimović,rs,MF,Getafe,La Liga,25,1995,30.3,50,28,22,24,4,19,46,41.3,27,40,9,31,57,107,46
1568,Nikola Maksimović,rs,DF,Napoli,it Serie A,28,1991,13.4,18,9,11,6,1,9,18,50.0,9,15,6,9,21,39,49
1569,Filip Malbašić,rs,FW,Cádiz,La Liga,27,1992,9.6,12,7,4,5,3,6,18,33.3,12,10,0,10,4,16,2
1570,Kévin Malcuit,ma,DF,Fiorentina,it Serie A,29,1991,2.3,5,3,2,2,1,0,1,0.0,1,5,0,5,3,8,6
1571,Kévin Malcuit,ma,FW,Napoli,it Serie A,29,1991,0.4,2,1,2,0,0,0,1,0.0,1,0,0,0,2,4,2
1572,Daniel Maldini,it,FW,Milan,it Serie A,18,2001,0.3,1,0,0,1,0,0,2,0.0,2,0,0,0,0,1,0
1573,Ruslan Malinovskyi,ua,MF,Atalanta,it Serie A,27,1993,20.8,19,8,2,13,4,8,23,34.8,15,16,1,15,2,21,4
1574,Yunus Mallı,tr,MF,Wolfsburg,Bundesliga,28,1992,0.6,1,0,0,1,0,1,1,100.0,0,0,0,0,0,1,0
1575,Hugo Mallo,es,DF,Celta Vigo,La Liga,29,1991,28.9,58,40,34,23,1,24,52,46.2,28,42,11,31,37,95,77
1576,Mickael Malsa,mq,MF,Levante,La Liga,24,1995,26.0,55,26,28,24,3,23,51,45.1,28,38,9,29,43,98,36
1577,Dennis Man,ro,FW,Parma,it Serie A,21,1998,7.8,12,6,6,4,2,6,21,28.6,15,5,0,5,2,14,6
1578,Hianga Mananga Mbock,fr,MF,Brest,Ligue 1,20,1999,5.1,4,3,2,2,0,2,9,22.2,7,2,0,2,3,7,6
1579,Vincent Manceau,fr,DF,Angers,Ligue 1,31,1989,25.7,42,27,23,17,2,30,63,47.6,33,23,2,21,35,77,61
1580,Gianluca Mancini,it,DF,Roma,it Serie A,24,1996,31.7,50,29,29,19,2,18,31,58.1,13,38,18,20,72,122,77
1581,Steve Mandanda,fr,GK,Marseille,Ligue 1,35,1985,37.0,0,0,0,0,0,0,1,0.0,1,0,0,0,2,2,8
1582,Reinildo Mandava,mz,DF,Lille,Ligue 1,26,1994,24.2,79,43,39,32,8,35,58,60.3,23,26,3,23,45,124,53
1583,Aïssa Mandi,dz,DF,Betis,La Liga,28,1991,26.6,30,17,20,10,0,10,16,62.5,6,21,13,8,39,69,90
1584,Rolando Mandragora,it,MF,Udinese,it Serie A,23,1997,4.4,8,5,3,4,1,3,10,30.0,7,10,3,7,6,14,5
1585,Rolando Mandragora,it,MF,Torino,it Serie A,23,1997,16.9,19,4,4,9,6,7,30,23.3,23,19,6,13,20,39,19
1586,Mario Mandžukić,hr,FW,Milan,it Serie A,34,1986,2.4,7,6,2,4,1,2,3,66.7,1,0,0,0,2,9,3
1587,Sadio Mané,sn,FW,Liverpool,Premier League,28,1992,31.2,48,30,6,22,20,12,33,36.4,21,30,0,30,15,63,11
1588,Niccolò Manfredini,it,GK,Benevento,it Serie A,32,1988,1.0,0,0,0,0,0,0,0,,0,0,0,0,0,0,2
1589,Eliaquim Mangala,fr,DF,Valencia,La Liga,29,1991,3.6,0,0,0,0,0,0,1,0.0,1,8,6,2,6,6,12
1590,Orel Mangala,be,MF,Stuttgart,Bundesliga,22,1998,23.4,27,15,13,11,3,17,28,60.7,11,27,10,17,26,53,30
1591,Thomas Mangani,fr,MF,Angers,Ligue 1,33,1987,29.9,54,37,25,26,3,30,90,33.3,60,31,8,23,38,92,39
1592,Vito Mannone,it,GK,Monaco,Ligue 1,32,1988,9.0,0,0,0,0,0,0,0,,0,0,0,0,0,0,3
1593,Kostas Manolas,gr,DF,Napoli,it Serie A,29,1991,25.5,31,18,24,7,0,17,24,70.8,7,22,13,9,23,54,82
1594,Javier Manquillo,es,DF,Newcastle Utd,Premier League,26,1994,9.2,24,14,8,14,2,11,17,64.7,6,8,1,7,9,33,15
1595,Juan Manuel Ramos,uy,DF,Spezia,it Serie A,23,1996,3.3,5,0,3,0,2,4,7,57.1,3,1,0,1,2,7,6
1596,Myziane Maolida,km,FW,Nice,Ligue 1,21,1999,12.0,13,8,4,4,5,4,11,36.4,7,6,1,5,6,19,4
1597,Faitout Maouassa,fr,DF,Rennes,Ligue 1,22,1998,13.0,20,11,10,8,2,11,19,57.9,8,9,1,8,17,37,36
1598,Sekou Mara,fr,FW,Bordeaux,Ligue 1,18,2002,2.5,5,3,1,3,1,2,10,20.0,8,0,0,0,1,6,1
1599,Fernando Marçal,br,DF,Wolves,Premier League,31,1989,6.9,13,5,6,7,0,6,11,54.5,5,11,2,9,12,25,25
1600,Fernando Marçal,br,DF,Lyon,Ligue 1,31,1989,0.9,1,0,0,1,0,0,0,,0,0,0,0,2,3,0
1601,Marcelo,br,DF,Real Madrid,La Liga,32,1988,11.7,25,21,11,6,8,11,24,45.8,13,13,1,12,10,35,15
1602,Marcelo,br,DF,Lyon,Ligue 1,33,1987,32.3,44,29,30,12,2,26,37,70.3,11,35,25,10,49,93,122
1603,Solly March,eng,DF,Brighton,Premier League,26,1994,18.6,49,23,24,15,10,18,34,52.9,16,30,5,25,22,71,30
1604,Federico Marchetti,it,GK,Genoa,it Serie A,37,1983,3.7,1,0,1,0,0,1,1,100.0,0,0,0,0,0,1,2
1605,Riccardo Marchizza,it,DF,Spezia,it Serie A,22,1998,17.3,20,11,12,5,3,12,21,57.1,9,13,4,9,11,31,27
1606,Gian Marco Ferrari,it,DF,Sassuolo,it Serie A,28,1992,33.5,32,20,15,14,3,10,23,43.5,13,46,37,9,50,82,100
1607,Iván Marcone,ar,MF,Elche,La Liga,30,1990,29.4,64,41,42,17,5,35,84,41.7,49,27,8,19,36,100,33
1608,Óscar de Marcos,es,DF,Athletic Club,La Liga,31,1989,16.9,28,17,12,10,6,10,25,40.0,15,12,1,11,12,40,38
1609,Dario Maresic,at,DF,Reims,Ligue 1,20,1999,5.7,12,7,8,4,0,8,14,57.1,6,7,2,5,10,22,17
1610,José Mari,es,MF,Cádiz,La Liga,32,1987,16.1,32,17,13,18,1,14,31,45.2,17,16,7,9,27,59,33
1611,Pablo Marí,es,DF,Arsenal,Premier League,26,1993,10.0,15,9,12,3,0,5,10,50.0,5,8,7,1,9,24,30
1612,José María Giménez,uy,DF,Atlético Madrid,La Liga,25,1995,19.6,20,7,14,5,1,12,17,70.6,5,17,11,6,21,41,65
1613,Mariano,do,FW,Real Madrid,La Liga,26,1993,5.7,4,2,2,1,1,0,9,0.0,9,3,1,2,0,4,3
1614,Jordan Marié,fr,MF,Dijon,Ligue 1,28,1991,15.9,34,17,9,23,2,23,56,41.1,33,14,5,9,23,57,12
1615,Adrián Marín,es,DF,Alavés,La Liga,23,1997,1.0,1,1,0,1,0,0,2,0.0,2,1,0,1,2,3,2
1616,Adrián Marín,es,DF,Granada,La Liga,23,1997,3.0,5,2,1,3,1,2,3,66.7,1,5,2,3,4,9,9
1617,Răzvan Marin,ro,MF,Cagliari,it Serie A,24,1996,32.9,54,33,26,22,6,27,53,50.9,26,29,10,19,29,83,15
1618,Guillermo Maripán,cl,DF,Monaco,Ligue 1,26,1994,23.2,26,11,17,9,0,15,27,55.6,12,18,11,7,27,53,66
1619,Marlon,br,DF,Sassuolo,it Serie A,24,1995,19.4,19,13,13,6,0,13,18,72.2,5,23,17,6,27,46,44
1620,Omar Marmoush,eg,FW,Wolfsburg,Bundesliga,21,1999,0.0,0,0,0,0,0,0,0,,0,0,0,0,0,0,0
1621,Marquinhos,br,DF,Paris S-G,Ligue 1,26,1994,23.6,27,21,14,10,3,15,26,57.7,11,21,9,12,27,54,75
1622,Luca Marrone,it,DF,Crotone,it Serie A,30,1990,17.6,25,18,16,9,0,13,21,61.9,8,22,11,11,26,51,56
1623,Roger Martí,es,FW,Levante,La Liga,29,1991,24.4,11,7,5,4,2,6,23,26.1,17,10,3,7,4,15,6
1624,Anthony Martial,fr,FW,Manchester Utd,Premier League,24,1995,16.4,2,1,1,1,0,0,10,0.0,10,17,3,14,1,3,8
1625,Aarón Martín,es,DF,Celta Vigo,La Liga,23,1997,17.1,34,20,15,16,3,10,33,30.3,23,15,4,11,13,47,37
1626,Aarón Martín,es,DF,Mainz 05,Bundesliga,23,1997,2.9,3,2,2,1,0,2,4,50.0,2,1,0,1,2,5,2
1627,Álex Martín,es,DF,Cádiz,La Liga,22,1998,1.1,2,0,1,1,0,2,4,50.0,2,1,1,0,0,2,6
1628,Jonas Martin,fr,MF,Rennes,Ligue 1,30,1990,5.4,11,9,5,4,2,5,14,35.7,9,11,2,9,13,24,2
1629,Gabriel Martinelli,br,FW,Arsenal,Premier League,19,2001,6.5,7,1,2,3,2,4,10,40.0,6,6,0,6,8,15,4
1630,Emiliano Martínez,ar,GK,Aston Villa,Premier League,27,1992,38.0,3,3,3,0,0,3,4,75.0,1,0,0,0,2,5,10
1631,Iñigo Martínez,es,DF,Athletic Club,La Liga,29,1991,28.0,22,15,16,6,0,9,27,33.3,18,17,7,10,28,50,96
1632,Javi Martínez,es,MF,Osasuna,La Liga,20,1999,5.1,9,4,1,6,2,5,12,41.7,7,9,0,9,5,14,4
1633,Javi Martínez,es,DF,Bayern Munich,Bundesliga,31,1988,5.2,10,5,4,4,2,7,9,77.8,2,8,4,4,13,23,19
1634,Josep Martinez,es,GK,RB Leipzig,Bundesliga,22,1998,1.0,0,0,0,0,0,0,0,,0,0,0,0,0,0,0
1635,Lautaro Martínez,ar,FW,Inter,it Serie A,22,1997,28.5,25,12,5,11,9,7,24,29.2,17,31,1,30,27,52,16
1636,Pablo Martinez,fr,DF,Nîmes,Ligue 1,31,1989,6.0,10,7,7,3,0,7,7,100.0,0,6,4,2,11,21,28
1637,Lucas Martínez Quarta,ar,DF,Fiorentina,it Serie A,24,1996,16.5,32,20,17,11,4,18,41,43.9,23,27,9,18,39,71,48
1638,Gelson Martins,pt,MF,Monaco,Ligue 1,25,1995,17.2,41,26,12,16,13,15,37,40.5,22,20,0,20,13,54,8
1639,Adam Marušić,me,DF,Lazio,it Serie A,27,1992,33.0,38,22,22,15,1,20,40,50.0,20,38,6,32,40,78,54
1640,Sylvain Marveaux,fr,MF,Lorient,Ligue 1,34,1986,2.2,6,3,1,4,1,3,3,100.0,0,2,0,2,1,7,2
1641,Marvin,es,DF,Real Madrid,La Liga,20,2000,1.5,3,2,0,3,0,1,2,50.0,1,1,0,1,2,5,3
1642,Omar Mascarell,gq,MF,Schalke 04,Bundesliga,27,1993,19.6,41,24,15,19,7,21,54,38.9,33,40,14,26,37,78,32
1643,Andrea Masiello,it,DF,Genoa,it Serie A,34,1986,28.5,38,22,29,6,3,23,48,47.9,25,32,13,19,53,91,107
1644,Jordi Masip,es,GK,Valladolid,La Liga,31,1989,25.0,0,0,0,0,0,0,2,0.0,2,2,0,2,2,2,8
1645,Roberto Massimo,de,DF,Stuttgart,Bundesliga,19,2000,8.4,21,11,13,5,3,11,24,45.8,13,5,1,4,11,32,13
1646,Giuseppe Mastinu,it,FW,Spezia,it Serie A,28,1991,0.4,1,1,0,0,1,1,1,100.0,0,1,0,1,0,1,0
1647,Arthur Masuaku,cd,DF,West Ham,Premier League,26,1993,11.2,20,12,14,6,0,11,34,32.4,23,12,0,12,8,28,28
1648,Jaime Mata,es,FW,Getafe,La Liga,31,1988,22.6,12,7,1,3,8,3,18,16.7,15,13,2,11,6,18,16
1649,Juan Mata,es,FW,Manchester Utd,Premier League,32,1988,5.7,1,0,1,0,0,0,7,0.0,7,3,0,3,3,4,3
1650,Pape Matar Sarr,sn,MF,Metz,Ligue 1,17,2002,17.7,45,29,19,21,5,20,38,52.6,18,24,4,20,27,72,16
1651,Eliot Matazo,be,MF,Monaco,Ligue 1,18,2002,3.5,11,5,6,5,0,3,7,42.9,4,1,0,1,1,12,2
1652,Jean-Philippe Mateta,fr,FW,Crystal Palace,Premier League,23,1997,2.5,1,1,0,1,0,1,3,33.3,2,1,0,1,0,1,2
1653,Jean-Philippe Mateta,fr,FW,Mainz 05,Bundesliga,23,1997,11.1,6,3,1,3,2,0,3,0.0,3,3,1,2,4,10,6
1654,Nemanja Matić,rs,MF,Manchester Utd,Premier League,31,1988,12.3,25,11,13,12,0,13,31,41.9,18,19,5,14,22,47,10
1655,Joël Matip,cm,DF,Liverpool,Premier League,28,1991,7.7,14,9,7,7,0,7,8,87.5,1,6,0,6,7,21,22
1656,Rabbi Matondo,wls,FW,Schalke 04,Bundesliga,19,2000,2.4,3,2,0,3,0,2,3,66.7,1,1,0,1,1,4,1
1657,Ryder Matos,br,MF,Udinese,it Serie A,27,1993,0.1,0,0,0,0,0,0,0,,0,0,0,0,0,0,0
1658,Henning Matriciani,de,DF,Schalke 04,Bundesliga,20,2000,0.3,1,1,1,0,0,1,1,100.0,0,1,0,1,0,1,1
1659,Chrislain Matsima,fr,DF,Monaco,Ligue 1,18,2002,3.9,5,4,3,2,0,4,7,57.1,3,3,0,3,4,9,12
1660,Federico Mattiello,it,DF,Spezia,it Serie A,25,1995,0.4,0,0,0,0,0,0,0,,0,0,0,0,0,0,0
1661,Neal Maupay,fr,FW,Brighton,Premier League,23,1996,27.9,20,8,9,7,4,4,24,16.7,20,20,0,20,13,33,6
1662,Tony Mauricio,fr,MF,Lens,Ligue 1,26,1994,5.6,19,12,7,8,4,11,17,64.7,6,8,1,7,3,22,4
1663,Stephy Mavididi,eng,FW,Montpellier,Ligue 1,22,1998,22.6,18,5,7,10,1,8,23,34.8,15,12,0,12,14,32,6
1664,Konstantinos Mavropanos,gr,DF,Stuttgart,Bundesliga,22,1997,16.3,42,29,29,12,1,27,46,58.7,19,25,10,15,59,101,66
1665,Eric Maxim Choupo-Moting,cm,FW,Bayern Munich,Bundesliga,31,1989,9.1,8,2,0,5,3,1,4,25.0,3,6,0,6,2,10,7
1666,Borja Mayoral,es,FW,Roma,it Serie A,23,1997,17.2,3,2,0,0,3,1,10,10.0,9,5,0,5,0,3,5
1667,Borja Mayoral,es,FW,Real Madrid,La Liga,23,1997,0.3,0,0,0,0,0,0,1,0.0,1,0,0,0,0,0,0
1668,Youssef Maziz,fr,MF,Metz,Ligue 1,22,1998,2.9,2,0,1,1,0,1,5,20.0,4,1,0,1,6,8,1
1669,Antonio Mazzotta,it,DF,Crotone,it Serie A,30,1989,0.6,1,1,0,1,0,0,0,,0,0,0,0,0,1,1
1670,Kevin Mbabu,ch,DF,Wolfsburg,Bundesliga,25,1995,18.2,51,33,27,17,7,24,35,68.6,11,28,7,21,22,73,59
1671,Kylian Mbappé,fr,FW,Paris S-G,Ligue 1,21,1998,26.4,4,2,0,1,3,2,9,22.2,7,7,1,6,3,7,4
1672,Ibrahima Mbaye,sn,DF,Bologna,it Serie A,25,1994,4.8,6,5,5,1,0,3,5,60.0,2,5,3,2,1,7,10
1673,Jean-Manuel Mbom,de,MF,Werder Bremen,Bundesliga,20,2000,12.9,19,13,14,3,2,8,27,29.6,19,17,6,11,13,32,27
1674,Nathanael Mbuku,cd,MF,Reims,Ligue 1,18,2002,24.6,33,19,9,13,11,8,28,28.6,20,17,0,17,14,47,10
1675,James McArthur,sct,MF,Crystal Palace,Premier League,32,1987,16.3,57,32,25,27,5,15,39,38.5,24,28,3,25,23,80,31
1676,Oliver McBurnie,sct,FW,Sheffield Utd,Premier League,24,1996,14.7,15,7,7,7,1,5,17,29.4,12,10,3,7,6,21,30
1677,Alex McCarthy,eng,GK,Southampton,Premier League,30,1989,30.0,1,0,1,0,0,1,4,25.0,3,0,0,0,0,1,11
1678,James McCarthy,ie,MF,Crystal Palace,Premier League,29,1990,9.1,16,12,9,7,0,8,21,38.1,13,15,7,8,8,24,12
1679,John McGinn,sct,MF,Aston Villa,Premier League,25,1994,37.0,61,37,23,31,7,27,84,32.1,57,38,6,32,43,104,23
1680,David McGoldrick,ie,FW,Sheffield Utd,Premier League,32,1987,26.6,33,21,8,15,10,13,31,41.9,18,19,3,16,2,35,25
1681,Weston McKennie,us,MF,Juventus,it Serie A,21,1998,18.9,34,19,9,20,5,12,33,36.4,21,21,3,18,28,62,26
1682,Dwight McNeil,eng,MF,Burnley,Premier League,20,1999,34.1,47,24,24,18,5,18,56,32.1,38,44,6,38,32,79,32
1683,Scott McTominay,sct,MF,Manchester Utd,Premier League,23,1996,23.7,51,24,23,25,3,23,36,63.9,13,35,10,25,29,80,46
1684,Gary Medel,cl,DF,Bologna,it Serie A,32,1987,5.7,12,9,6,5,1,4,10,40.0,6,8,6,2,7,19,10
1685,Facundo Medina,ar,DF,Lens,Ligue 1,21,1999,22.3,39,22,22,15,2,24,38,63.2,14,25,9,16,39,78,51
1686,Nathan de Medina,be,DF,Arminia,Bundesliga,22,1997,7.1,16,10,9,6,1,3,10,30.0,7,12,2,10,11,27,22
1687,Ben Mee,eng,DF,Burnley,Premier League,30,1989,29.9,32,15,16,14,2,14,29,48.3,15,54,45,9,43,75,148
1688,Joshua Mees,de,FW,Union Berlin,Bundesliga,24,1996,0.1,0,0,0,0,0,0,0,,0,0,0,0,0,0,0
1689,Admir Mehmedi,ch,MF,Wolfsburg,Bundesliga,29,1991,9.1,17,9,6,7,4,6,16,37.5,10,7,0,7,5,22,1
1690,Soualiho Meïté,fr,MF,Torino,it Serie A,26,1994,10.2,11,7,6,4,1,5,16,31.3,11,18,1,17,10,21,9
1691,Soualiho Meïté,fr,MF,Milan,it Serie A,26,1994,6.5,18,10,10,6,2,8,17,47.1,9,9,2,7,8,26,16
1692,Hannibal Mejbri,tn,MF,Manchester Utd,Premier League,17,2003,0.1,0,0,0,0,0,0,0,,0,0,0,0,0,0,0
1693,Farid El Melali,dz,FW,Angers,Ligue 1,23,1997,4.6,9,5,5,4,0,2,13,15.4,11,12,0,12,6,15,2
1694,Filippo Melegoni,it,MF,Genoa,it Serie A,21,1999,4.3,7,6,2,5,0,3,6,50.0,3,5,0,5,5,12,8
1695,Gonzalo Melero,es,MF,Levante,La Liga,26,1994,20.6,24,15,11,6,7,10,39,25.6,29,14,5,9,18,42,22
1696,Birger Meling,no,DF,Nîmes,Ligue 1,25,1994,25.9,49,31,27,15,7,33,50,66.0,17,43,9,34,36,85,70
1697,Arthur Melo,br,MF,Juventus,it Serie A,23,1996,12.9,17,9,7,10,0,12,31,38.7,19,6,1,5,18,35,9
1698,Memphis,nl,FW,Lyon,Ligue 1,26,1994,32.5,4,3,0,3,1,1,20,5.0,19,11,1,10,5,9,3
1699,Houboulang Mendes,gw,DF,Lorient,Ligue 1,22,1998,14.4,28,19,19,5,4,16,28,57.1,12,14,2,12,14,42,35
1700,Pedro Mendes,pt,DF,Montpellier,Ligue 1,29,1990,18.1,21,19,16,5,0,14,21,66.7,7,23,13,10,34,55,58
1701,Thiago Mendes,br,MF,Lyon,Ligue 1,28,1992,24.9,37,22,13,20,4,18,38,47.4,20,33,7,26,39,76,21
1702,Brais Méndez,es,MF,Celta Vigo,La Liga,23,1997,29.7,59,31,23,27,9,16,65,24.6,49,27,2,25,32,91,34
1703,Édgar Méndez,es,MF,Alavés,La Liga,30,1990,23.2,39,29,18,13,8,15,48,31.3,33,20,3,17,19,58,14
1704,Eñaut Mendía,es,FW,Eibar,La Liga,21,1999,0.7,2,1,2,0,0,1,2,50.0,1,1,1,0,0,2,0
1705,Batista Mendy,fr,MF,Nantes,Ligue 1,20,2000,0.8,1,1,0,1,0,0,1,0.0,1,3,1,2,1,2,1
1706,Benjamin Mendy,fr,DF,Manchester City,Premier League,26,1994,10.6,13,9,1,8,4,5,21,23.8,16,12,5,7,5,18,14
1707,Edouard Mendy,sn,GK,Chelsea,Premier League,28,1992,30.5,0,0,0,0,0,0,1,0.0,1,0,0,0,1,1,9
1708,Edouard Mendy,sn,GK,Rennes,Ligue 1,28,1992,1.0,0,0,0,0,0,0,0,,0,0,0,0,0,0,0
1709,Ferland Mendy,fr,DF,Real Madrid,La Liga,25,1995,24.5,26,16,17,6,3,12,24,50.0,12,16,4,12,26,52,32
1710,Nampalys Mendy,sn,MF,Leicester City,Premier League,28,1992,16.2,26,17,18,6,2,7,20,35.0,13,12,1,11,14,40,8
1711,Hamza Mendyl,ma,FW,Schalke 04,Bundesliga,22,1997,1.1,2,2,2,0,0,0,2,0.0,2,2,0,2,0,2,2
1712,Levent Mercan,de,FW,Schalke 04,Bundesliga,19,2000,0.1,0,0,0,0,0,0,0,,0,0,0,0,0,0,0
1713,Jorge Meré,es,DF,Köln,Bundesliga,23,1997,14.4,13,6,9,3,1,6,13,46.2,7,14,11,3,15,28,63
1714,Alex Meret,it,GK,Napoli,it Serie A,23,1997,22.0,0,0,0,0,0,0,1,0.0,1,0,0,0,0,0,5
1715,Mikel Merino,es,MF,Real Sociedad,La Liga,24,1996,23.9,61,36,14,36,11,18,45,40.0,27,36,8,28,32,93,26
1716,Martín Merquelanz,es,MF,Real Sociedad,La Liga,25,1995,6.1,9,3,3,2,4,2,7,28.6,5,7,1,6,3,12,4
1717,Yıldırım Mert Çetin,tr,DF,Hellas Verona,it Serie A,23,1997,4.6,8,4,3,5,0,2,6,33.3,4,7,5,2,14,22,11
1718,Dries Mertens,be,FW,Napoli,it Serie A,33,1987,16.2,16,14,4,7,5,5,25,20.0,20,7,1,6,9,25,3
1719,Roque Mesa,es,MF,Valladolid,La Liga,31,1989,19.6,46,29,18,24,4,20,47,42.6,27,11,2,9,14,60,23
1720,Illan Meslier,fr,GK,Leeds United,Premier League,20,2000,35.0,0,0,0,0,0,0,1,0.0,1,0,0,0,0,0,17
1721,Lionel Messi,ar,FW,Barcelona,La Liga,33,1987,33.6,18,10,3,9,6,6,17,35.3,11,12,0,12,6,24,0
1722,Junior Messias,br,MF,Crotone,it Serie A,29,1991,35.7,60,35,26,24,10,22,70,31.4,48,32,12,20,35,95,40
1723,Thomas Meunier,be,DF,Dortmund,Bundesliga,28,1991,16.4,30,21,19,6,5,20,29,69.0,9,16,6,10,18,48,29
1724,Mexer,mz,DF,Bordeaux,Ligue 1,31,1988,7.9,9,6,8,0,1,5,10,50.0,5,8,5,3,17,26,22
1725,Max Meyer,de,MF,Köln,Bundesliga,24,1995,3.9,7,4,3,3,1,4,8,50.0,4,4,1,3,3,10,1
1726,Omenuke Mfulu,cd,MF,Elche,La Liga,26,1994,8.8,18,12,10,8,0,5,15,33.3,10,7,1,6,11,29,18
1727,Míchel,es,MF,Valladolid,La Liga,32,1988,10.5,18,11,10,3,5,5,22,22.7,17,10,1,9,9,27,12
1728,Jonas Michelbrink,de,MF,Hertha BSC,Bundesliga,19,2001,0.4,0,0,0,0,0,0,0,,0,0,0,0,0,0,0
1729,Clément Michelin,fr,DF,Lens,Ligue 1,23,1997,12.8,25,19,13,9,3,9,16,56.3,7,13,4,9,25,50,32
1730,Edouard Michut,fr,MF,Paris S-G,Ligue 1,17,2003,0.0,0,0,0,0,0,0,0,,0,0,0,0,0,0,0
1731,Petar Mićin,rs,MF,Udinese,it Serie A,21,1998,0.2,0,0,0,0,0,0,0,,0,0,0,0,0,0,0
1732,Florian Miguel,fr,DF,Nîmes,Ligue 1,23,1996,17.1,14,13,12,2,0,9,17,52.9,8,21,13,8,45,59,66
1733,Valentin Mihaila,ro,FW,Parma,it Serie A,20,2000,7.8,2,1,1,1,0,0,10,0.0,10,8,1,7,5,7,8
1734,Nikola Milenković,rs,DF,Fiorentina,it Serie A,22,1997,33.7,49,29,33,14,2,21,33,63.6,12,42,33,9,44,93,122
1735,Arkadiusz Milik,pl,FW,Marseille,Ligue 1,26,1994,13.6,14,9,0,7,7,2,12,16.7,10,5,1,4,2,16,9
1736,Sergej Milinković-Savić,rs,MF,Lazio,it Serie A,25,1995,30.5,59,40,20,30,9,27,84,32.1,57,52,12,40,33,92,47
1737,Vanja Milinković-Savić,rs,GK,Torino,it Serie A,23,1997,5.0,1,1,1,0,0,1,1,100.0,0,0,0,0,0,1,1
1738,Éder Militão,br,DF,Real Madrid,La Liga,22,1998,12.6,20,8,13,6,1,8,14,57.1,6,19,6,13,19,39,42
1739,Luka Milivojević,rs,MF,Crystal Palace,Premier League,29,1991,26.2,65,34,25,31,9,42,77,54.5,35,29,6,23,35,100,47
1740,Luis Milla,es,MF,Granada,La Liga,25,1994,13.9,22,11,11,10,1,6,28,21.4,22,10,0,10,24,46,16
1741,Pere Milla,es,FW,Elche,La Liga,27,1992,22.0,24,17,12,10,2,8,37,21.6,29,17,5,12,13,37,17
1742,Álex Millán,es,FW,Villarreal,La Liga,20,1999,0.0,0,0,0,0,0,0,0,,0,0,0,0,0,0,0
1743,Vincenzo Millico,it,FW,Torino,it Serie A,19,2000,0.2,0,0,0,0,0,0,0,,0,0,0,0,0,0,0
1744,Enzo Millot,fr,MF,Monaco,Ligue 1,18,2002,0.5,2,0,0,1,1,1,1,100.0,0,0,0,0,2,4,0
1745,James Milner,eng,MF,Liverpool,Premier League,34,1986,11.9,26,19,9,14,3,11,33,33.3,22,30,3,27,14,40,16
1746,Santi Mina,es,FW,Celta Vigo,La Liga,24,1995,26.8,31,13,9,12,10,6,37,16.2,31,15,3,12,6,37,17
1747,Yerry Mina,co,DF,Everton,Premier League,25,1994,21.5,21,14,17,4,0,8,12,66.7,4,30,23,7,24,45,110
1748,Takumi Minamino,jp,MF,Southampton,Premier League,25,1995,7.9,7,3,2,5,0,2,19,10.5,17,13,1,12,4,11,9
1749,Takumi Minamino,jp,MF,Liverpool,Premier League,25,1995,3.3,4,3,1,2,1,0,12,0.0,12,1,0,1,2,6,3
1750,Tyrone Mings,eng,DF,Aston Villa,Premier League,27,1993,35.5,32,16,23,7,2,16,24,66.7,8,59,40,19,41,73,172
1751,Óscar Mingueza,es,DF,Barcelona,La Liga,21,1999,21.1,52,33,28,17,7,30,53,56.6,23,19,6,13,20,72,48
1752,Rafa Mir,es,FW,Huesca,La Liga,23,1997,32.0,15,9,4,4,7,7,22,31.8,15,14,2,12,15,30,25
1753,Jorge Miramón,es,DF,Levante,La Liga,31,1989,19.2,32,22,26,6,0,21,35,60.0,14,22,2,20,27,59,54
1754,Aleksei Miranchuk,ru,MF,Atalanta,it Serie A,24,1995,7.5,24,13,8,9,7,6,9,66.7,3,1,0,1,3,27,1
1755,Juan Miranda,es,DF,Betis,La Liga,20,2000,18.4,27,11,16,9,2,16,32,50.0,16,18,2,16,29,56,58
1756,Antonio Mirante,it,GK,Roma,it Serie A,37,1983,12.8,0,0,0,0,0,0,1,0.0,1,1,0,1,0,0,7
1757,Tyrick Mitchell,eng,DF,Crystal Palace,Premier League,20,1999,19.0,64,35,48,9,7,23,40,57.5,17,29,10,19,21,85,62
1758,Aleksandar Mitrović,rs,FW,Fulham,Premier League,25,1994,15.6,7,4,0,3,4,2,8,25.0,6,12,3,9,3,10,8
1759,Stefan Mitrović,rs,DF,Strasbourg,Ligue 1,30,1990,30.9,36,27,29,7,0,24,37,64.9,13,23,13,10,31,67,108
1760,Maximilian Mittelstädt,de,DF,Hertha BSC,Bundesliga,23,1997,20.0,66,39,42,21,3,35,72,48.6,37,34,5,29,55,121,61
1761,Henrikh Mkhitaryan,am,MF,Roma,it Serie A,31,1989,30.5,58,24,13,27,18,13,62,21.0,49,34,0,34,39,97,10
1762,Jakub Moder,pl,DF,Brighton,Premier League,21,1999,7.2,15,7,5,7,3,7,20,35.0,13,12,1,11,3,18,9
1763,Anthony Modeste,fr,FW,Saint-Étienne,Ligue 1,32,1988,3.3,2,1,0,2,0,1,4,25.0,3,3,1,2,0,2,3
1764,Anthony Modeste,fr,FW,Köln,Bundesliga,32,1988,2.5,2,0,0,2,0,0,1,0.0,1,0,0,0,0,2,2
1765,Luka Modrić,hr,MF,Real Madrid,La Liga,34,1985,30.4,37,23,18,16,3,13,36,36.1,23,14,2,12,48,85,14
1766,Terem Moffi,ng,FW,Lorient,Ligue 1,21,1999,23.0,13,8,0,8,5,4,19,21.1,15,5,2,3,4,17,8
1767,Kevin Möhwald,de,MF,Werder Bremen,Bundesliga,27,1993,17.3,15,9,9,5,1,4,18,22.2,14,10,3,7,32,47,19
1768,Niklas Moisander,fi,DF,Werder Bremen,Bundesliga,34,1985,13.6,14,11,11,3,0,8,14,57.1,6,15,8,7,22,36,61
1769,Dion Moise Sahi,ci,FW,Strasbourg,Ligue 1,18,2001,1.0,1,0,0,1,0,1,1,100.0,0,1,0,1,0,1,0
1770,Johan Mojica,co,DF,Atalanta,it Serie A,27,1992,3.3,4,4,3,1,0,2,3,66.7,1,3,0,3,7,11,6
1771,Johan Mojica,co,DF,Elche,La Liga,27,1992,13.4,21,10,15,5,1,8,18,44.4,10,15,4,11,15,36,27
1772,Guillem Molina,es,DF,Valencia,La Liga,20,2000,1.7,1,0,1,0,0,0,5,0.0,5,1,1,0,4,5,5
1773,Jorge Molina,es,FW,Granada,La Liga,38,1982,17.9,11,4,3,5,3,8,22,36.4,14,5,1,4,3,14,19
1774,Nahuel Molina,ar,DF,Udinese,it Serie A,22,1998,20.3,27,18,13,10,4,16,42,38.1,26,26,4,22,21,48,49
1775,Salvatore Molina,it,MF,Crotone,it Serie A,28,1992,25.7,39,22,18,14,7,29,45,64.4,16,30,8,22,17,56,41
1776,Victor Mollejo,es,MF,Getafe,La Liga,19,2001,0.8,2,1,1,0,1,0,1,0.0,1,0,0,0,0,2,0
1777,Florent Mollet,fr,MF,Montpellier,Ligue 1,28,1991,26.2,20,15,7,11,2,12,47,25.5,35,18,4,14,32,52,9
1778,Jayson Molumby,ie,MF,Brighton,Premier League,20,1999,0.0,0,0,0,0,0,0,0,,0,0,0,0,0,0,0
1779,Alkhaly Momo Cissé,gn,FW,Stuttgart,Bundesliga,17,2002,0.4,1,1,1,0,0,0,0,,0,1,0,1,0,1,0
1780,Jon Moncayola,es,MF,Osasuna,La Liga,22,1998,29.6,61,36,27,23,11,24,67,35.8,43,27,9,18,23,84,38
1781,Gabriele Moncini,it,FW,Benevento,it Serie A,24,1996,4.0,2,1,2,0,0,0,1,0.0,1,2,0,2,2,4,4
1782,Thomas Monconduit,fr,MF,Lorient,Ligue 1,29,1991,12.8,28,15,9,16,3,15,41,36.6,26,10,3,7,13,41,21
1783,Kévin Monnet-Paquet,fr,MF,Saint-Étienne,Ligue 1,31,1988,6.3,11,7,7,2,2,5,10,50.0,5,5,0,5,6,17,7
1784,Nacho Monreal,es,DF,Real Sociedad,La Liga,34,1986,23.1,31,19,17,11,3,7,20,35.0,13,14,3,11,31,62,43
1785,Cristóbal Montiel,es,MF,Fiorentina,it Serie A,20,2000,0.0,0,0,0,0,0,0,1,0.0,1,0,0,0,0,0,0
1786,Lorenzo Montipò,it,GK,Benevento,it Serie A,24,1996,37.0,0,0,0,0,0,0,0,,0,1,0,1,0,0,16
1787,Ángel Montoro,es,MF,Granada,La Liga,32,1988,15.1,15,9,7,7,1,4,16,25.0,12,13,3,10,22,37,21
1788,Martín Montoya,es,DF,Betis,La Liga,29,1991,2.7,6,3,2,2,2,1,3,33.3,2,1,1,0,2,8,6
1789,Emre Mor,tr,FW,Celta Vigo,La Liga,23,1997,5.6,8,4,1,3,4,0,3,0.0,3,5,0,5,5,13,0
1790,Luca Mora,it,MF,Spezia,it Serie A,32,1988,1.3,3,1,1,2,0,2,4,50.0,2,2,1,1,0,3,2
1791,Wesley Moraes,br,FW,Aston Villa,Premier League,23,1996,0.2,0,0,0,0,0,0,1,0.0,1,0,0,0,0,0,0
1792,Álvaro Morata,es,FW,Juventus,it Serie A,27,1992,22.4,17,12,2,10,5,4,28,14.3,24,22,2,20,5,22,21
1793,Jan Morávek,cz,MF,Augsburg,Bundesliga,30,1989,3.0,5,3,4,1,0,1,8,12.5,7,3,0,3,7,12,2
1794,Jon Morcillo,es,MF,Athletic Club,La Liga,21,1998,15.1,16,9,3,6,7,7,30,23.3,23,9,0,9,15,31,11
1795,Jérémy Morel,mg,DF,Lorient,Ligue 1,36,1984,27.7,31,19,21,10,0,20,39,51.3,19,26,11,15,44,75,81
1796,Alberto Moreno,es,DF,Villarreal,La Liga,28,1992,2.1,7,4,7,0,0,2,5,40.0,3,2,1,1,3,10,2
1797,Álex Moreno,es,DF,Betis,La Liga,27,1993,19.8,42,26,25,12,5,20,43,46.5,23,18,4,14,35,77,48
1798,Gerard Moreno,es,FW,Villarreal,La Liga,28,1992,29.7,24,15,8,10,6,7,34,20.6,27,17,4,13,15,39,26
1799,Tete Morente,es,MF,Elche,La Liga,23,1996,22.4,31,17,17,9,5,9,39,23.1,30,20,0,20,13,44,28
1800,Mateu Morey,es,DF,Dortmund,Bundesliga,20,2000,9.2,13,7,4,7,2,9,12,75.0,3,6,1,5,18,31,7
1801,Wes Morgan,jm,DF,Leicester City,Premier League,36,1984,0.2,0,0,0,0,0,0,0,,0,0,0,0,0,0,1
1802,Ilaix Moriba,gn,MF,Barcelona,La Liga,17,2003,6.0,14,6,5,7,2,5,10,50.0,5,16,1,15,5,19,4
1803,Raúl Moro,es,FW,Lazio,it Serie A,17,2002,0.1,0,0,0,0,0,0,1,0.0,1,0,0,0,0,0,0
1804,Loren Morón,es,FW,Betis,La Liga,26,1993,11.0,11,7,2,6,3,1,16,6.3,15,11,0,11,3,14,14
1805,Pedro Mosquera,es,MF,Huesca,La Liga,32,1988,22.8,38,18,19,18,1,13,53,24.5,40,23,6,17,31,69,38
1806,Aimen Moueffek,fr,DF,Saint-Étienne,Ligue 1,19,2001,8.3,25,15,16,6,3,13,32,40.6,19,17,2,15,9,34,18
1807,Youssoufa Moukoko,de,FW,Dortmund,Bundesliga,15,2004,4.7,3,2,1,1,1,0,0,,0,3,0,3,0,3,2
1808,Harold Moukoudi,cm,DF,Saint-Étienne,Ligue 1,22,1997,25.3,46,27,37,8,1,28,38,73.7,10,24,10,14,42,88,78
1809,Jessy Moulin,fr,GK,Saint-Étienne,Ligue 1,34,1986,29.0,2,1,2,0,0,2,3,66.7,1,0,0,0,2,4,9
1810,Steve Mounié,bj,FW,Brest,Ligue 1,25,1994,29.8,15,11,3,11,1,3,28,10.7,25,18,3,15,12,27,40
1811,Mason Mount,eng,MF,Chelsea,Premier League,21,1999,32.1,75,35,22,38,15,25,69,36.2,44,40,2,38,31,106,14
1812,Lucas Moura,br,FW,Tottenham,Premier League,27,1992,15.7,32,16,12,16,4,8,29,27.6,21,12,0,12,18,50,10
1813,Lys Mousset,fr,FW,Sheffield Utd,Premier League,24,1996,3.3,1,0,0,0,1,0,2,0.0,2,1,0,1,0,1,1
1814,João Moutinho,pt,MF,Wolves,Premier League,33,1986,28.1,75,40,34,35,6,35,91,38.5,56,18,3,15,47,122,28
1815,Samuel Moutoussamy,cd,FW,Nantes,Ligue 1,23,1996,0.9,0,0,0,0,0,0,1,0.0,1,1,0,1,0,0,0
1816,Loris Mouyokolo,fr,DF,Lorient,Ligue 1,19,2001,0.2,1,1,1,0,0,1,1,100.0,0,1,1,0,0,1,1
1817,Javi Moyano,es,DF,Valladolid,La Liga,34,1986,1.1,0,0,0,0,0,0,0,,0,2,0,2,0,0,2
1818,Nordi Mukiele,fr,DF,RB Leipzig,Bundesliga,22,1997,18.6,44,30,14,28,2,21,37,56.8,16,33,1,32,23,67,33
1819,Mert Müldür,tr,DF,Sassuolo,it Serie A,21,1999,18.6,43,20,26,9,8,27,53,50.9,26,17,1,16,36,79,41
1820,Florian Müller,de,GK,Freiburg,Bundesliga,22,1997,31.0,0,0,0,0,0,0,3,0.0,3,1,0,1,2,2,10
1821,Sebastian Müller,de,MF,Arminia,Bundesliga,19,2001,0.0,0,0,0,0,0,0,0,,0,0,0,0,0,0,0
1822,Thomas Müller,de,MF,Bayern Munich,Bundesliga,30,1989,29.7,49,22,11,23,15,24,73,32.9,49,43,3,40,21,70,18
1823,Joel Mumbongo,se,FW,Burnley,Premier League,21,1999,0.4,0,0,0,0,0,0,0,,0,1,0,1,0,0,0
1824,Marshall Munetsi,zw,MF,Reims,Ligue 1,24,1996,21.4,35,19,19,14,2,21,41,51.2,20,33,25,8,57,92,85
1825,Iker Muniain,es,MF,Athletic Club,La Liga,27,1992,21.6,20,7,4,10,6,6,24,25.0,18,15,0,15,11,31,4
1826,Aihen Muñoz,es,DF,Real Sociedad,La Liga,22,1997,13.4,23,16,15,5,3,11,19,57.9,8,12,2,10,10,33,31
1827,Joaquín Muñoz,es,FW,Huesca,La Liga,21,1999,0.5,0,0,0,0,0,0,2,0.0,2,0,0,0,1,1,0
1828,Luis Muriel,co,FW,Atalanta,it Serie A,29,1991,16.0,20,9,4,8,8,9,26,34.6,17,17,0,17,7,27,4
1829,Jeison Murillo,co,DF,Celta Vigo,La Liga,28,1992,30.0,45,21,35,9,1,24,44,54.5,20,29,17,12,36,81,100
1830,Vedat Muriqi,xk,FW,Lazio,it Serie A,26,1994,9.2,3,1,0,2,1,0,8,0.0,8,9,2,7,3,6,20
1831,Jacob Murphy,eng,DF,Newcastle Utd,Premier League,25,1995,18.1,39,24,25,12,2,24,49,49.0,25,27,3,24,14,53,29
1832,Nicola Murru,it,DF,Torino,it Serie A,25,1994,6.3,9,6,1,5,3,3,5,60.0,2,11,1,10,12,21,24
1833,Petar Musa,hr,FW,Union Berlin,Bundesliga,22,1998,7.9,12,8,3,6,3,4,8,50.0,4,10,0,10,4,16,5
1834,Mateo Musacchio,ar,DF,Lazio,it Serie A,29,1990,2.5,1,1,1,0,0,0,0,,0,5,2,3,2,3,5
1835,Mateo Musacchio,ar,DF,Milan,it Serie A,29,1990,0.4,2,1,2,0,0,2,3,66.7,1,1,0,1,3,5,0
1836,Yunus Musah,us,MF,Valencia,La Liga,17,2002,17.0,21,18,12,3,6,8,24,33.3,16,20,0,20,15,36,12
1837,Jamal Musiala,de,FW,Bayern Munich,Bundesliga,17,2003,9.8,20,12,5,7,8,7,22,31.8,15,17,2,15,14,34,3
1838,Juan Musso,ar,GK,Udinese,it Serie A,26,1994,35.0,1,1,1,0,0,1,1,100.0,0,0,0,0,1,2,8
1839,Shkodran Mustafi,de,DF,Arsenal,Premier League,28,1992,0.5,1,1,1,0,0,1,1,100.0,0,1,0,1,0,1,3
1840,Shkodran Mustafi,de,DF,Schalke 04,Bundesliga,28,1992,11.5,16,5,15,1,0,3,12,25.0,9,20,15,5,32,48,76
1841,Yoshinori Mutō,jp,FW,Eibar,La Liga,28,1992,12.5,12,7,1,4,7,3,8,37.5,5,5,0,5,3,15,2
1842,Phillipp Mwene,at,DF,Mainz 05,Bundesliga,26,1994,18.6,36,23,21,11,4,19,38,50.0,19,26,3,23,24,60,33
1843,Joakim Mæhle,dk,DF,Atalanta,it Serie A,23,1997,13.5,18,10,7,5,6,8,19,42.1,11,17,2,15,11,29,5
1844,Obite N'Dicka,ci,DF,Eint Frankfurt,Bundesliga,20,1999,22.7,31,23,16,15,0,16,28,57.1,12,27,6,21,47,78,85
1845,Kévin N'Doram,fr,MF,Metz,Ligue 1,24,1996,3.4,3,2,0,3,0,1,3,33.3,2,0,0,0,6,9,2
1846,Stanley N'Soki,fr,DF,Nice,Ligue 1,21,1999,13.8,27,19,15,9,3,13,22,59.1,9,17,4,13,26,53,38
1847,Nacho,es,DF,Valladolid,La Liga,31,1989,20.1,43,21,29,10,4,24,52,46.2,28,21,1,20,29,72,47
1848,Nacho,es,DF,Real Madrid,La Liga,30,1990,22.2,27,14,13,11,3,12,35,34.3,23,19,9,10,40,67,58
1849,Yuto Nagatomo,jp,DF,Marseille,Ligue 1,33,1986,17.7,23,16,12,8,3,9,18,50.0,9,14,3,11,29,52,43
1850,Kenny Nagera,fr,FW,Paris S-G,Ligue 1,18,2002,0.0,0,0,0,0,0,0,0,,0,0,0,0,0,0,0
1851,Radja Nainggolan,be,MF,Cagliari,it Serie A,32,1988,20.5,41,26,22,14,5,19,34,55.9,15,18,0,18,15,56,15
1852,Radja Nainggolan,be,MF,Inter,it Serie A,32,1988,0.5,0,0,0,0,0,0,0,,0,0,0,0,1,1,0
1853,Marvelous Nakamba,zw,MF,Aston Villa,Premier League,26,1994,8.3,22,14,10,11,1,7,12,58.3,5,16,5,11,17,39,9
1854,Nahitan Nández,uy,MF,Cagliari,it Serie A,24,1995,30.4,56,28,23,23,10,25,68,36.8,43,26,4,22,23,79,49
1855,Nano,es,FW,Cádiz,La Liga,25,1995,0.1,0,0,0,0,0,0,0,,0,0,0,0,0,0,0
1856,Paul Nardi,fr,GK,Lorient,Ligue 1,26,1994,23.0,0,0,0,0,0,0,1,0.0,1,1,0,1,0,0,15
1857,Matija Nastasić,rs,DF,Schalke 04,Bundesliga,27,1993,13.6,11,7,9,2,0,9,16,56.3,7,22,18,4,26,37,51
1858,Roberto Navarro,es,MF,Real Sociedad,La Liga,18,2002,0.4,1,1,1,0,0,0,2,0.0,2,0,0,0,1,2,0
1859,Ximo Navarro,es,DF,Alavés,La Liga,30,1990,26.4,54,30,36,17,1,14,30,46.7,16,14,4,10,47,101,75
1860,Jesús Navas,es,DF,Sevilla,La Liga,34,1985,31.4,27,21,15,11,1,15,22,68.2,7,10,3,7,37,64,62
1861,Keylor Navas,cr,GK,Paris S-G,Ligue 1,33,1986,28.0,0,0,0,0,0,0,0,,0,0,0,0,0,0,10
1862,Raúl Navas,es,DF,Osasuna,La Liga,32,1988,1.9,6,3,5,1,0,4,6,66.7,2,0,0,0,3,9,13
1863,Papa Ndiaga Yade,mr,FW,Metz,Ligue 1,20,2000,11.1,15,8,9,2,4,7,20,35.0,13,9,0,9,4,19,6
1864,Iliman Ndiaye,sn,MF,Sheffield Utd,Premier League,20,2000,0.1,1,1,0,1,0,1,1,100.0,0,0,0,0,0,1,0
1865,Wilfred Ndidi,ng,MF,Leicester City,Premier League,23,1996,24.2,96,63,45,44,7,26,66,39.4,40,38,11,27,61,157,55
1866,Bridge Ndilu,fr,FW,Nantes,Ligue 1,20,2000,0.5,0,0,0,0,0,0,2,0.0,2,2,0,2,0,0,0
1867,Tanguy Ndombele,fr,MF,Tottenham,Premier League,23,1996,23.2,41,20,11,21,9,18,44,40.9,26,28,4,24,19,60,15
1868,Dan Ndoye,ch,FW,Nice,Ligue 1,19,2000,6.1,7,6,3,4,0,1,8,12.5,7,4,0,4,7,14,4
1869,Paul Nebel,de,MF,Mainz 05,Bundesliga,17,2002,0.6,1,1,0,1,0,0,1,0.0,1,0,0,0,2,3,0
1870,Álvaro Negredo,es,FW,Cádiz,La Liga,34,1985,24.4,11,5,3,4,4,5,11,45.5,6,7,2,5,3,14,19
1871,Reiss Nelson,eng,FW,Arsenal,Premier League,20,1999,0.8,1,0,0,0,1,0,0,,0,0,0,0,1,2,1
1872,Ilija Nestorovski,mk,FW,Udinese,it Serie A,30,1990,7.8,6,4,2,3,1,2,13,15.4,11,5,0,5,1,7,7
1873,Neto,br,GK,Barcelona,La Liga,31,1989,7.0,0,0,0,0,0,0,1,0.0,1,0,0,0,0,0,3
1874,Pedro Neto,pt,FW,Wolves,Premier League,20,2000,28.3,16,9,4,6,6,6,28,21.4,22,18,2,16,31,47,8
1875,Luca Netz,de,DF,Hertha BSC,Bundesliga,17,2003,3.4,14,8,12,2,0,6,17,35.3,11,3,0,3,6,20,8
1876,Manuel Neuer,de,GK,Bayern Munich,Bundesliga,34,1986,33.0,0,0,0,0,0,0,1,0.0,1,0,0,0,2,2,12
1877,Florian Neuhaus,de,MF,Gladbach,Bundesliga,23,1997,29.1,48,28,19,26,3,19,63,30.2,44,35,7,28,50,98,20
1878,Carlos Neva,es,DF,Granada,La Liga,24,1996,20.0,12,6,6,6,0,6,11,54.5,5,16,4,12,27,39,58
1879,Rúben Neves,pt,MF,Wolves,Premier League,23,1997,29.7,86,46,42,38,6,36,88,40.9,52,55,11,44,65,151,46
1880,Neymar,br,MF,Paris S-G,Ligue 1,28,1992,15.7,14,11,1,6,7,8,37,21.6,29,8,0,8,9,23,0
1881,Yvan Neyou,cm,MF,Saint-Étienne,Ligue 1,23,1997,27.1,58,31,24,33,1,25,60,41.7,35,34,5,29,31,89,13
1882,Jessic Ngankam,de,FW,Hertha BSC,Bundesliga,20,2000,3.3,5,2,1,2,2,1,3,33.3,2,6,1,5,0,5,1
1883,Muzinga Ngonda,cd,DF,Dijon,Ligue 1,25,1994,25.6,59,40,37,21,1,30,50,60.0,20,28,3,25,72,131,58
1884,Ahmad Ngouyamsa,td,DF,Dijon,Ligue 1,19,2000,1.7,6,4,5,1,0,4,8,50.0,4,2,1,1,2,8,8
1885,Opa Nguette,sn,FW,Metz,Ligue 1,26,1994,12.6,15,8,2,8,5,3,10,30.0,7,14,2,12,1,16,1
1886,Moussa Niakhate,sn,DF,Mainz 05,Bundesliga,24,1996,31.8,42,22,28,13,1,14,29,48.3,15,31,15,16,49,91,79
1887,Ibrahima Niane,sn,FW,Metz,Ligue 1,21,1999,7.4,1,1,0,0,1,1,2,50.0,1,3,0,3,0,1,8
1888,M'Baye Niang,sn,FW,Rennes,Ligue 1,25,1994,4.7,3,2,2,1,0,0,0,,0,2,0,2,1,4,2
1889,Mamor Niang,sn,MF,Getafe,La Liga,18,2002,0.2,1,1,0,1,0,0,0,,0,1,0,1,0,1,0
1890,Tanguy Nianzou,fr,DF,Bayern Munich,Bundesliga,18,2002,1.3,3,1,3,0,0,1,1,100.0,0,0,0,0,3,6,1
1891,Florian Niederlechner,de,FW,Augsburg,Bundesliga,29,1990,19.3,7,5,1,4,2,0,10,0.0,10,8,3,5,10,17,18
1892,Nieto,es,FW,Cádiz,La Liga,22,1998,0.2,1,1,0,1,0,0,0,,0,0,0,0,0,1,1
1893,Saúl Ñíguez,es,MF,Atlético Madrid,La Liga,25,1994,22.6,57,34,27,23,7,30,59,50.8,29,35,2,33,19,76,43
1894,Joakim Nilsson,se,DF,Arminia,Bundesliga,26,1994,24.0,36,24,23,12,1,14,23,60.9,9,29,22,7,39,75,111
1895,Casimir Ninga,td,FW,Angers,Ligue 1,27,1993,0.3,0,0,0,0,0,0,0,,0,0,0,0,0,0,1
1896,Nino,es,FW,Elche,La Liga,40,1980,3.2,0,0,0,0,0,0,1,0.0,1,1,0,1,0,0,0
1897,Fernando Niño,es,FW,Villarreal,La Liga,19,2000,6.6,8,3,0,4,4,2,9,22.2,7,1,0,1,2,10,2
1898,Eddie Nketiah,eng,FW,Arsenal,Premier League,21,1999,4.7,3,1,0,2,1,0,2,0.0,2,6,0,6,0,3,5
1899,Nicolas Nkoulou,cm,DF,Torino,it Serie A,30,1990,15.1,14,9,11,3,0,7,12,58.3,5,28,14,14,33,47,71
1900,Niels Nkounkou,fr,DF,Everton,Premier League,19,2000,0.9,4,3,1,2,1,3,8,37.5,5,4,0,4,0,4,4
1901,Christopher Nkunku,fr,FW,RB Leipzig,Bundesliga,22,1997,21.0,16,11,3,7,6,8,18,44.4,10,27,1,26,9,25,14
1902,Dan Nlundulu,eng,FW,Southampton,Premier League,21,1999,1.2,0,0,0,0,0,0,1,0.0,1,2,0,2,0,0,2
1903,Mark Noble,eng,MF,West Ham,Premier League,33,1987,7.9,8,4,2,5,1,4,14,28.6,10,7,3,4,13,21,3
1904,Nolito,es,MF,Celta Vigo,La Liga,33,1986,28.9,70,36,30,30,10,32,92,34.8,60,46,2,44,22,92,19
1905,Arnaud Nordin,fr,MF,Saint-Étienne,Ligue 1,22,1998,19.7,14,8,5,5,4,6,21,28.6,15,13,2,11,9,23,10
1906,Håvard Nordtveit,no,DF,Hoffenheim,Bundesliga,30,1990,7.8,6,2,5,1,0,6,8,75.0,2,4,2,2,13,19,42
1907,Will Norris,eng,GK,Burnley,Premier League,26,1993,2.0,0,0,0,0,0,0,0,,0,0,0,0,0,0,0
1908,Oliver Norwood,nir,MF,Sheffield Utd,Premier League,29,1991,24.7,49,22,16,28,5,21,72,29.2,51,29,12,17,36,85,51
1909,Olivier Ntcham,cm,MF,Marseille,Ligue 1,24,1996,1.3,1,0,0,1,0,1,3,33.3,2,3,1,2,2,3,3
1910,Alexander Nübel,de,GK,Bayern Munich,Bundesliga,23,1996,1.0,0,0,0,0,0,0,0,,0,0,0,0,0,0,1
1911,Kasim Nuhu,gh,DF,Hoffenheim,Bundesliga,25,1995,11.0,13,7,9,4,0,6,10,60.0,4,8,3,5,15,28,38
1912,Unai Núñez,es,DF,Athletic Club,La Liga,23,1997,23.4,23,12,16,7,0,10,15,66.7,5,19,14,5,32,55,110
1913,Bram Nuytinck,nl,DF,Udinese,it Serie A,30,1990,18.2,21,15,10,9,2,13,20,65.0,7,30,17,13,25,46,77
1914,Kelechi Nwakali,ng,MF,Huesca,La Liga,22,1998,1.6,4,3,1,2,1,0,4,0.0,4,1,0,1,1,5,1
1915,Simeon Nwankwo,ng,FW,Crotone,it Serie A,28,1992,32.7,9,2,2,6,1,3,22,13.6,19,21,5,16,6,15,51
1916,Gerzino Nyamsi,fr,DF,Rennes,Ligue 1,23,1997,9.7,12,10,2,8,2,4,6,66.7,2,8,5,3,10,22,32
1917,Allan Nyom,cm,MF,Getafe,La Liga,32,1988,25.8,38,23,14,19,5,15,30,50.0,15,16,2,14,22,60,42
1918,M'Bala Nzola,ao,FW,Spezia,it Serie A,23,1996,21.1,12,5,2,6,4,4,7,57.1,3,15,1,14,3,15,20
1919,Steven Nzonzi,fr,MF,Rennes,Ligue 1,31,1988,32.3,34,16,15,16,3,12,31,38.7,19,24,10,14,16,50,26
1920,Jack O'Connell,eng,DF,Sheffield Utd,Premier League,26,1994,2.0,3,1,1,1,1,0,1,0.0,1,4,3,1,2,5,7
1921,Dara O'Shea,ie,DF,West Brom,Premier League,21,1999,23.4,45,25,30,13,2,21,45,46.7,24,32,17,15,45,90,108
1922,Michael Obafemi,ie,FW,Southampton,Premier League,20,2000,0.7,1,0,0,1,0,0,1,0.0,1,1,0,1,0,1,0
1923,Pedro Obiang,gq,MF,Sassuolo,it Serie A,28,1992,16.3,35,22,17,15,3,12,35,34.3,23,26,7,19,22,57,27
1924,Jan Oblak,si,GK,Atlético Madrid,La Liga,27,1993,38.0,0,0,0,0,0,0,0,,0,0,0,0,0,0,6
1925,Lucas Ocampos,ar,FW,Sevilla,La Liga,26,1994,29.2,36,24,12,16,8,13,37,35.1,24,33,1,32,19,55,30
1926,Bastian Oczipka,de,DF,Schalke 04,Bundesliga,31,1989,21.4,33,20,22,10,1,7,21,33.3,14,22,4,18,24,57,41
1927,Brian Oddei,it,FW,Sassuolo,it Serie A,17,2002,0.5,2,1,1,1,0,2,3,66.7,1,1,0,1,0,2,1
1928,Denis Odoi,gh,DF,Fulham,Premier League,32,1988,3.0,3,3,2,1,0,1,4,25.0,3,3,1,2,5,8,5
1929,Álvaro Odriozola,es,DF,Real Madrid,La Liga,24,1995,9.2,14,7,5,8,1,3,5,60.0,2,6,3,3,6,20,12
1930,Angelo Ogbonna,it,DF,West Ham,Premier League,32,1988,27.7,26,13,20,5,1,9,17,52.9,8,25,11,14,30,56,119
1931,Stefano Okaka,it,FW,Udinese,it Serie A,30,1989,16.5,10,7,2,5,3,2,10,20.0,8,7,1,6,2,12,19
1932,Shinji Okazaki,jp,FW,Huesca,La Liga,34,1986,12.5,7,5,5,0,2,0,5,0.0,5,5,0,5,4,11,6
1933,Masaya Okugawa,jp,MF,Arminia,Bundesliga,24,1996,10.2,17,8,5,11,1,6,14,42.9,8,17,2,15,8,25,5
1934,Lucas Olaza,uy,DF,Valladolid,La Liga,26,1994,14.0,20,9,11,7,2,9,17,52.9,8,15,7,8,15,35,38
1935,Lucas Olaza,uy,DF,Celta Vigo,La Liga,26,1994,17.9,25,16,12,12,1,10,18,55.6,8,15,1,14,24,49,34
1936,Christian Oliva,uy,MF,Cagliari,it Serie A,24,1996,4.3,10,4,6,3,1,6,17,35.3,11,11,1,10,8,18,7
1937,Christian Oliva,uy,MF,Valencia,La Liga,24,1996,2.2,2,0,1,1,0,1,6,16.7,5,1,0,1,6,8,0
1938,Kiko Olivas,es,DF,Valladolid,La Liga,31,1988,2.0,3,2,2,1,0,3,5,60.0,2,2,2,0,7,10,3
1939,Paulo Oliveira,pt,DF,Eibar,La Liga,28,1992,29.3,42,21,32,8,2,19,36,52.8,17,39,14,25,59,101,112
1940,Mathías Olivera,uy,DF,Getafe,La Liga,22,1997,29.0,61,33,31,21,9,32,56,57.1,24,33,3,30,31,92,55
1941,Maximiliano Olivera,uy,DF,Fiorentina,it Serie A,28,1992,1.0,2,0,1,1,0,1,1,100.0,0,3,1,2,0,2,8
1942,Dani Olmo,es,MF,RB Leipzig,Bundesliga,22,1998,24.4,23,14,6,13,4,4,23,17.4,19,15,0,15,13,36,21
1943,Robin Olsen,se,GK,Everton,Premier League,30,1990,7.0,0,0,0,0,0,0,0,,0,0,0,0,0,0,4
1944,Jonas Omlin,ch,GK,Montpellier,Ligue 1,26,1994,29.7,1,1,1,0,0,1,4,25.0,3,0,0,0,0,1,9
1945,Jérôme Onguéné,cm,DF,Genoa,it Serie A,22,1997,2.0,2,1,2,0,0,2,7,28.6,5,2,0,2,2,4,8
1946,Karim Onisiwo,at,FW,Mainz 05,Bundesliga,28,1992,20.5,31,20,7,15,9,14,23,60.9,9,20,1,19,5,36,12
1947,Josh Onomah,eng,MF,Fulham,Premier League,23,1997,4.2,11,8,1,6,4,0,5,0.0,5,4,2,2,2,13,1
1948,Javier Ontiveros,es,FW,Huesca,La Liga,22,1997,10.2,21,14,10,10,1,9,26,34.6,17,12,0,12,9,30,6
1949,Henry Onyekuru,ng,FW,Monaco,Ligue 1,23,1997,1.6,1,0,1,0,0,1,4,25.0,3,1,0,1,0,1,0
1950,Willi Orban,hu,DF,RB Leipzig,Bundesliga,27,1992,26.3,40,26,19,15,6,23,37,62.2,14,29,20,9,40,80,74
1951,Fabián Orellana,cl,MF,Valladolid,La Liga,34,1986,23.8,33,19,12,14,7,12,55,21.8,43,18,0,18,15,48,9
1952,Divock Origi,be,FW,Liverpool,Premier League,25,1995,2.1,3,2,0,2,1,1,3,33.3,2,5,1,4,1,4,2
1953,Riccardo Orsolini,it,FW,Bologna,it Serie A,23,1997,19.5,37,18,13,12,12,16,39,41.0,23,22,3,19,10,47,22
1954,Stefan Ortega,de,GK,Arminia,Bundesliga,27,1992,34.0,2,1,2,0,0,2,6,33.3,4,0,0,0,0,2,12
1955,Yuya Osako,jp,MF,Werder Bremen,Bundesliga,30,1990,8.5,12,8,2,5,5,2,9,22.2,7,6,1,5,5,17,7
1956,Ben Osborn,eng,MF,Sheffield Utd,Premier League,25,1994,17.8,33,18,15,10,8,13,40,32.5,27,20,3,17,12,45,17
1957,Victor Osimhen,ng,FW,Napoli,it Serie A,21,1998,17.5,22,15,2,6,14,3,15,20.0,12,6,0,6,7,29,10
1958,Yordan Osorio,ve,DF,Parma,it Serie A,26,1994,20.1,22,14,13,9,0,9,24,37.5,15,30,18,12,53,75,77
1959,David Ospina,co,GK,Napoli,it Serie A,31,1988,16.0,0,0,0,0,0,0,0,,0,0,0,0,0,0,4
1960,Owen Otasowie,us,MF,Wolves,Premier League,19,2001,2.1,5,5,3,2,0,1,2,50.0,1,1,1,0,3,8,4
1961,Otávio,br,MF,Bordeaux,Ligue 1,26,1994,17.3,54,31,33,19,2,26,55,47.3,29,20,5,15,26,80,36
1962,Paulo Otávio,br,DF,Wolfsburg,Bundesliga,25,1994,19.3,60,40,32,22,6,34,62,54.8,28,51,7,44,42,102,59
1963,Remi Oudin,fr,FW,Bordeaux,Ligue 1,23,1996,26.9,34,16,22,7,5,15,36,41.7,21,22,2,20,51,85,40
1964,Alexandre Oukidja,dz,GK,Metz,Ligue 1,32,1988,34.0,0,0,0,0,0,0,1,0.0,1,1,0,1,0,0,17
1965,Zinédine Ould Khaled,fr,MF,Angers,Ligue 1,20,2000,0.4,0,0,0,0,0,0,0,,0,0,0,0,1,1,0
1966,Adam Ounas,dz,FW,Crotone,it Serie A,23,1996,13.3,9,4,4,4,1,0,7,0.0,7,12,1,11,3,12,4
1967,Adam Ounas,dz,MF,Cagliari,it Serie A,23,1996,3.4,3,2,3,0,0,0,11,0.0,11,5,0,5,3,6,0
1968,Thomas Ouwejan,nl,DF,Udinese,it Serie A,23,1996,4.6,4,1,0,3,1,2,9,22.2,7,4,0,4,5,9,6
1969,Reece Oxford,eng,DF,Augsburg,Bundesliga,21,1998,15.1,26,18,15,11,0,10,17,58.8,7,28,22,6,29,55,89
1970,Alex Oxlade-Chamberlain,eng,MF,Liverpool,Premier League,26,1993,2.8,4,0,0,3,1,0,2,0.0,2,1,0,1,2,6,0
1971,Mikel Oyarzabal,es,FW,Real Sociedad,La Liga,23,1997,26.8,30,17,14,12,4,10,31,32.3,21,30,5,25,15,45,17
1972,Ambroise Oyongo,cm,DF,Montpellier,Ligue 1,29,1991,6.2,13,6,10,3,0,9,15,60.0,6,3,2,1,8,21,26
1973,Salih Özcan,tr,MF,Köln,Bundesliga,22,1998,15.2,21,13,11,10,0,12,33,36.4,21,11,2,9,20,41,14
1974,Levin Öztunalı,de,DF,Mainz 05,Bundesliga,24,1996,8.4,24,18,14,8,2,8,17,47.1,9,15,0,15,15,39,16
1975,Pablo,br,DF,Bordeaux,Ligue 1,29,1991,12.0,17,11,13,4,0,8,14,57.1,6,17,12,5,25,42,46
1976,Fernando Pacheco,es,GK,Alavés,La Liga,28,1992,37.2,2,0,2,0,0,2,4,50.0,2,0,0,0,2,4,19
1977,Jon Pacheco,es,DF,Real Sociedad,La Liga,19,2001,0.4,0,0,0,0,0,0,0,,0,0,0,0,1,1,0
1978,Gonçalo Paciência,pt,FW,Schalke 04,Bundesliga,25,1994,8.3,8,3,4,1,3,4,16,25.0,12,4,1,3,1,9,3
1979,Daniele Padelli,it,GK,Inter,it Serie A,34,1985,0.5,0,0,0,0,0,0,0,,0,0,0,0,0,0,0
1980,Mattia Pagliuca,it,MF,Bologna,it Serie A,18,2002,0.1,0,0,0,0,0,0,0,,0,0,0,0,1,1,0
1981,Vincent Pajot,fr,MF,Metz,Ligue 1,29,1990,10.2,35,20,19,11,5,10,18,55.6,8,9,2,7,42,77,11
1982,Rodrigo Palacio,ar,FW,Bologna,it Serie A,38,1982,27.8,13,6,2,3,8,1,15,6.7,14,18,0,18,7,20,29
1983,Exequiel Palacios,ar,MF,Leverkusen,Bundesliga,21,1998,6.4,31,17,12,16,3,17,30,56.7,13,13,0,13,12,43,7
1984,Helibelton Palacios,co,DF,Elche,La Liga,27,1993,8.3,20,10,16,3,1,8,13,61.5,5,9,1,8,5,25,21
1985,Ante Palaversa,hr,MF,Getafe,La Liga,20,2000,0.1,0,0,0,0,0,0,1,0.0,1,0,0,0,0,0,0
1986,Alberto Paleari,it,GK,Genoa,it Serie A,27,1992,2.3,0,0,0,0,0,0,0,,0,0,0,0,0,0,1
1987,Nicolas Pallois,fr,DF,Nantes,Ligue 1,32,1987,30.8,58,36,42,14,2,38,72,52.8,34,44,20,24,37,95,155
1988,Emerson Palmieri,it,DF,Chelsea,Premier League,25,1994,1.0,3,3,2,0,1,1,3,33.3,2,0,0,0,1,4,6
1989,Antonio Palumbo,it,MF,Sampdoria,it Serie A,23,1996,0.1,0,0,0,0,0,0,1,0.0,1,0,0,0,0,0,0
1990,Martin Palumbo,no,MF,Udinese,it Serie A,18,2002,0.7,0,0,0,0,0,0,0,,0,5,0,5,1,1,0
1991,Goran Pandev,mk,FW,Genoa,it Serie A,37,1983,15.6,9,5,1,6,2,4,10,40.0,6,6,0,6,2,11,7
1992,Ivor Pandur,hr,GK,Hellas Verona,it Serie A,20,2000,3.7,0,0,0,0,0,0,0,,0,0,0,0,0,0,0
1993,Jonathan Panzo,eng,DF,Dijon,Ligue 1,19,2000,20.0,17,12,13,4,0,8,11,72.7,3,27,13,14,59,76,91
1994,Merveille Papela,de,DF,Mainz 05,Bundesliga,19,2001,0.0,0,0,0,0,0,0,1,0.0,1,0,0,0,0,0,0
1995,Lucas Paquetá,br,MF,Lyon,Ligue 1,22,1997,25.3,70,36,30,28,12,23,66,34.8,43,28,3,25,20,90,16
1996,Gaëtan Paquiez,fr,DF,Nîmes,Ligue 1,26,1994,11.6,21,12,12,7,2,12,29,41.4,17,10,3,7,16,37,28
1997,Rubén Pardo,es,MF,Bordeaux,Ligue 1,27,1992,0.3,0,0,0,0,0,0,0,,0,0,0,0,1,1,0
1998,Leandro Paredes,ar,MF,Paris S-G,Ligue 1,26,1994,14.5,30,18,12,15,3,19,39,48.7,20,17,5,12,17,47,13
1999,Daniel Parejo,es,MF,Villarreal,La Liga,31,1989,34.6,65,40,32,23,10,33,81,40.7,48,35,8,27,45,110,21
2000,Vittorio Parigini,it,MF,Genoa,it Serie A,24,1996,0.6,5,2,4,0,1,0,1,0.0,1,0,0,0,0,5,0
2001,Marco Parolo,it,DF,Lazio,it Serie A,35,1985,7.3,21,8,8,11,2,8,20,40.0,12,20,6,14,14,35,31
2002,Thomas Partey,gh,MF,Arsenal,Premier League,27,1993,17.0,44,21,16,24,4,24,56,42.9,32,17,5,12,23,67,18
2003,Thomas Partey,gh,MF,Atlético Madrid,La Liga,27,1993,2.2,7,4,4,3,0,5,8,62.5,3,4,1,3,2,9,1
2004,Mario Pašalić,hr,MF,Atalanta,it Serie A,25,1995,12.5,26,15,5,17,4,12,19,63.2,7,12,1,11,8,34,6
2005,Felix Passlack,de,DF,Dortmund,Bundesliga,22,1998,4.0,9,6,4,2,3,4,8,50.0,4,11,1,10,3,12,2
2006,Christian Pastina,it,DF,Benevento,it Serie A,19,2001,1.3,0,0,0,0,0,0,1,0.0,1,1,0,1,1,1,8
2007,Javier Pastore,ar,MF,Roma,it Serie A,31,1989,0.9,2,2,2,0,0,2,2,100.0,0,0,0,0,0,2,0
2008,Patric,es,DF,Lazio,it Serie A,27,1993,17.7,30,16,15,11,4,13,24,54.2,11,13,3,10,18,48,51
2009,Rui Patrício,pt,GK,Wolves,Premier League,32,1988,37.0,0,0,0,0,0,0,1,0.0,1,0,0,0,1,1,3
2010,Paulinho,br,FW,Leverkusen,Bundesliga,20,2000,0.7,0,0,0,0,0,0,0,,0,0,0,0,0,0,0
2011,Gabriel Paulista,br,DF,Valencia,La Liga,29,1990,30.2,17,11,9,5,3,6,17,35.3,11,32,27,5,59,76,132
2012,Benjamin Pavard,fr,DF,Bayern Munich,Bundesliga,24,1996,21.6,44,27,20,16,8,23,40,57.5,17,29,5,24,48,92,31
2013,Jiří Pavlenka,cz,GK,Werder Bremen,Bundesliga,28,1992,34.0,2,0,2,0,0,2,2,100.0,0,0,0,0,1,3,17
2014,Vasileios Pavlidis,gr,FW,Schalke 04,Bundesliga,17,2002,0.0,0,0,0,0,0,0,0,,0,0,0,0,0,0,0
2015,Mateo Pavlović,ba,DF,Angers,Ligue 1,30,1990,12.3,11,6,8,3,0,8,23,34.8,15,13,11,2,21,32,40
2016,Strahinja Pavlović,rs,DF,Monaco,Ligue 1,19,2001,0.0,0,0,0,0,0,0,0,,0,0,0,0,0,0,0
2017,Leonardo Pavoletti,it,FW,Cagliari,it Serie A,31,1988,17.6,7,3,2,5,0,1,20,5.0,19,4,2,2,4,11,32
2018,Dimitri Payet,fr,FW,Marseille,Ligue 1,33,1987,26.9,27,17,4,16,7,17,40,42.5,23,19,2,17,8,35,10
2019,Nehuén Paz,ar,DF,Bologna,it Serie A,27,1993,4.0,9,4,4,5,0,6,7,85.7,1,4,2,2,11,20,16
2020,Bailey Peacock-Farrell,nir,GK,Burnley,Premier League,23,1996,4.0,0,0,0,0,0,0,0,,0,0,0,0,0,0,0
2021,Mads Pedersen,dk,DF,Augsburg,Bundesliga,23,1996,9.9,25,16,20,3,2,10,22,45.5,12,13,3,10,15,40,32
2022,Alfonso Pedraza,es,DF,Villarreal,La Liga,24,1996,23.3,35,19,16,11,8,11,31,35.5,20,21,5,16,34,69,47
2023,Pedri,es,MF,Barcelona,La Liga,17,2002,26.8,44,27,16,16,12,17,71,23.9,54,46,1,45,33,77,7
2024,Pedro,es,MF,Roma,it Serie A,33,1987,17.7,22,14,6,11,5,7,35,20.0,28,10,0,10,9,31,2
2025,João Pedro,it,FW,Cagliari,it Serie A,28,1992,36.1,13,6,2,6,5,2,27,7.4,25,32,6,26,13,26,28
2026,Gianluca Pegolo,it,GK,Sassuolo,it Serie A,39,1981,1.0,0,0,0,0,0,0,0,,0,0,0,0,0,0,1
2027,Peter Pekarík,sk,DF,Hertha BSC,Bundesliga,33,1986,18.8,24,18,17,7,0,17,31,54.8,14,19,8,11,27,51,41
2028,Yohann Pelé,fr,GK,Marseille,Ligue 1,37,1982,1.0,0,0,0,0,0,0,0,,0,0,0,0,0,0,0
2029,Graziano Pellè,it,FW,Parma,it Serie A,35,1985,6.8,2,2,0,1,1,1,8,12.5,7,3,0,3,2,4,8
2030,Pietro Pellegri,it,FW,Monaco,Ligue 1,19,2001,2.6,2,1,0,2,0,0,0,,0,1,0,1,0,2,0
2031,Lorenzo Pellegrini,it,MF,Roma,it Serie A,24,1996,28.9,40,24,13,20,7,21,60,35.0,39,37,2,35,42,82,23
2032,Luca Pellegrini,it,DF,Genoa,it Serie A,21,1999,7.1,9,6,6,2,1,4,10,40.0,6,11,2,9,8,17,13
2033,Facundo Pellistri,uy,MF,Alavés,La Liga,18,2001,6.0,8,5,2,4,2,3,13,23.1,10,0,0,0,4,12,3
2034,Andy Pelmard,fr,DF,Nice,Ligue 1,20,2000,13.4,18,12,12,5,1,9,12,75.0,3,11,3,8,20,38,35
2035,Lee Peltier,eng,DF,West Brom,Premier League,33,1986,2.5,9,4,8,1,0,4,4,100.0,0,1,1,0,1,10,11
2036,Federico Peluso,it,DF,Sassuolo,it Serie A,36,1984,2.3,1,1,1,0,0,1,2,50.0,1,2,2,0,3,4,12
2037,Timothee Pembele,fr,DF,Paris S-G,Ligue 1,17,2002,4.3,8,7,4,4,0,5,14,35.7,9,4,0,4,5,13,8
2038,Rubén Peña,es,DF,Villarreal,La Liga,29,1991,12.4,25,14,8,15,2,19,33,57.6,14,20,1,19,13,38,19
2039,Philipp Pentke,de,GK,Hoffenheim,Bundesliga,35,1985,3.0,0,0,0,0,0,0,0,,0,0,0,0,0,0,0
2040,Nicolas Pépé,ci,FW,Arsenal,Premier League,25,1995,18.0,20,15,8,6,6,8,23,34.8,15,16,1,15,12,32,19
2041,Alberto Perea,es,MF,Cádiz,La Liga,29,1990,17.2,28,17,12,10,6,9,35,25.7,26,26,1,25,21,49,9
2042,Andreas Pereira,br,FW,Lazio,it Serie A,24,1996,6.0,5,0,1,3,1,2,12,16.7,10,6,0,6,1,6,4
2043,Danilo Pereira,pt,MF,Paris S-G,Ligue 1,28,1991,15.9,21,11,6,11,4,6,14,42.9,8,14,6,8,29,50,33
2044,Mathias Pereira Lage,pt,FW,Angers,Ligue 1,23,1996,16.3,29,17,12,15,2,10,40,25.0,30,21,4,17,15,44,16
2045,Matheus Pereira,br,MF,West Brom,Premier League,24,1996,28.6,26,15,14,10,2,12,54,22.2,42,18,0,18,29,55,16
2046,Pedro Pereira,pt,DF,Crotone,it Serie A,22,1998,28.3,50,32,29,17,4,21,40,52.5,19,33,11,22,19,69,61
2047,Ricardo Pereira,pt,DF,Leicester City,Premier League,26,1993,10.7,31,22,16,8,7,14,35,40.0,21,24,1,23,15,46,23
2048,Gastón Pereiro,uy,MF,Cagliari,it Serie A,25,1995,3.0,3,1,2,1,0,1,2,50.0,1,2,0,2,1,4,2
2049,Bruno Peres,br,DF,Roma,it Serie A,30,1990,15.9,21,11,11,7,3,13,24,54.2,11,18,4,14,27,48,11
2050,Roberto Pereyra,ar,MF,Udinese,it Serie A,29,1991,32.5,18,11,7,8,3,7,23,30.4,16,24,5,19,27,45,24
2051,Ayoze Pérez,es,MF,Leicester City,Premier League,27,1993,14.8,32,15,6,20,6,13,48,27.1,35,28,0,28,10,42,7
2052,Carles Pérez,es,MF,Roma,it Serie A,22,1998,8.6,9,4,3,6,0,6,31,19.4,25,9,0,9,6,15,1
2053,Iñigo Pérez,es,MF,Osasuna,La Liga,32,1988,15.0,20,10,9,6,5,10,16,62.5,6,12,0,12,15,35,8
2054,Juan Pérez,es,GK,Osasuna,La Liga,24,1996,3.0,0,0,0,0,0,0,0,,0,0,0,0,0,0,1
2055,Kike Pérez,es,MF,Valladolid,La Liga,23,1997,12.9,26,19,8,14,4,7,33,21.2,26,10,1,9,17,43,18
2056,Lucas Pérez,es,FW,Alavés,La Liga,31,1988,19.5,6,2,3,3,0,2,10,20.0,8,6,1,5,2,8,5
2057,Luis Pérez,es,DF,Valladolid,La Liga,25,1995,14.4,33,17,16,17,0,18,30,60.0,12,26,8,18,14,47,54
2058,Manuel Perez,fr,MF,Lens,Ligue 1,29,1991,1.4,1,0,1,0,0,0,8,0.0,8,2,0,2,2,3,2
2059,Nehuén Pérez,ar,DF,Granada,La Liga,20,2000,8.2,6,3,6,0,0,4,6,66.7,2,5,4,1,12,18,33
2060,Mattia Perin,it,GK,Genoa,it Serie A,27,1992,32.0,0,0,0,0,0,0,0,,0,0,0,0,1,1,6
2061,Ivan Perišić,hr,DF,Inter,it Serie A,31,1989,19.9,22,13,11,6,5,12,33,36.4,21,33,4,29,19,41,36
2062,Romain Perraud,fr,DF,Brest,Ligue 1,22,1997,34.9,60,34,42,16,2,24,45,53.3,21,36,3,33,45,105,76
2063,Lucas Perrin,fr,DF,Marseille,Ligue 1,21,1998,3.4,7,4,4,3,0,5,12,41.7,7,5,4,1,8,15,16
2064,Pavao Pervan,at,GK,Wolfsburg,Bundesliga,32,1987,2.0,0,0,0,0,0,0,0,,0,0,0,0,0,0,1
2065,Matteo Pessina,it,MF,Atalanta,it Serie A,23,1997,18.3,14,7,4,6,4,7,24,29.2,17,17,2,15,17,31,7
2066,Andrea Petagna,it,FW,Napoli,it Serie A,25,1995,10.7,2,0,0,2,0,2,7,28.6,5,4,0,4,1,3,7
2067,Nils Petersen,de,FW,Freiburg,Bundesliga,31,1988,14.5,11,7,2,6,3,3,21,14.3,18,25,1,24,9,20,28
2068,Lukas Petkov,bg,MF,Augsburg,Bundesliga,19,2000,0.0,0,0,0,0,0,0,0,,0,0,0,0,0,0,0
2069,Jacopo Petriccione,it,MF,Crotone,it Serie A,25,1995,10.6,14,8,6,7,1,9,24,37.5,15,11,2,9,8,22,11
2070,Jens Petter Hauge,no,FW,Milan,it Serie A,20,1999,5.9,7,4,3,3,1,6,10,60.0,4,4,0,4,1,8,3
2071,Germán Pezzella,ar,DF,Fiorentina,it Serie A,29,1991,30.5,34,20,22,12,0,18,32,56.3,14,26,14,12,36,70,109
2072,Giuseppe Pezzella,it,DF,Parma,it Serie A,22,1997,20.3,34,19,23,9,2,22,41,53.7,19,22,9,13,12,46,52
2073,Maximilian Philipp,de,MF,Wolfsburg,Bundesliga,26,1994,12.3,15,6,3,6,6,5,21,23.8,16,17,0,17,6,21,3
2074,Rayan Philippe,fr,FW,Dijon,Ligue 1,19,2000,1.0,3,1,1,1,1,2,2,100.0,0,0,0,0,0,3,0
2075,Romain Philippoteaux,fr,FW,Nîmes,Ligue 1,32,1988,2.4,1,1,1,0,0,1,5,20.0,4,2,0,2,2,3,1
2076,Romain Philippoteaux,fr,MF,Brest,Ligue 1,32,1988,6.5,11,6,6,3,2,6,9,66.7,3,4,0,4,10,21,2
2077,Kalvin Phillips,eng,MF,Leeds United,Premier League,24,1995,27.0,74,38,38,29,7,26,62,41.9,36,49,14,35,45,119,53
2078,Matt Phillips,sct,MF,West Brom,Premier League,29,1991,20.3,15,8,4,11,0,7,23,30.4,16,32,4,28,10,25,32
2079,Nathaniel Phillips,eng,DF,Liverpool,Premier League,23,1997,16.2,22,14,15,7,0,11,24,45.8,13,17,14,3,20,42,81
2080,Jaden Philogene Bidace,eng,FW,Aston Villa,Premier League,18,2002,0.0,0,0,0,0,0,0,0,,0,0,0,0,0,0,0
2081,Krzysztof Piątek,pl,FW,Hertha BSC,Bundesliga,25,1995,18.1,9,4,1,7,1,3,22,13.6,19,11,0,11,6,15,14
2082,Pablo Piatti,ar,MF,Elche,La Liga,31,1989,4.0,8,6,3,3,2,3,12,25.0,9,5,0,5,2,10,1
2083,Cristiano Piccini,it,DF,Atalanta,it Serie A,27,1992,0.7,1,1,1,0,0,0,1,0.0,1,1,0,1,0,1,0
2084,Cristiano Piccini,it,DF,Valencia,La Liga,27,1992,0.7,1,1,1,0,0,1,2,50.0,1,0,0,0,0,1,3
2085,Roberto Piccoli,it,FW,Spezia,it Serie A,19,2001,7.8,7,3,0,4,3,2,4,50.0,2,4,0,4,2,9,5
2086,Jordan Pickford,eng,GK,Everton,Premier League,26,1994,30.5,0,0,0,0,0,0,2,0.0,2,2,0,2,3,3,16
2087,Jérémy Pied,fr,DF,Lille,Ligue 1,31,1989,3.5,7,0,3,3,1,4,9,44.4,5,3,1,2,6,13,8
2088,Amos Pieper,de,DF,Arminia,Bundesliga,22,1998,29.8,58,32,39,17,2,20,33,60.6,13,48,35,13,66,124,160
2089,Ronaël Pierre-Gabriel,fr,DF,Brest,Ligue 1,22,1998,25.6,60,40,42,16,2,35,52,67.3,17,17,7,10,30,90,57
2090,Erik Pieters,nl,DF,Burnley,Premier League,31,1988,14.1,30,21,18,9,3,19,39,48.7,20,30,9,21,12,42,34
2091,Tomás Pina Isla,es,MF,Alavés,La Liga,32,1987,28.6,39,18,18,16,5,16,42,38.1,26,28,8,20,37,76,42
2092,Andrea Pinamonti,it,FW,Inter,it Serie A,21,1999,1.9,0,0,0,0,0,0,0,,0,1,0,1,1,1,2
2093,Yeremi Pino,es,FW,Villarreal,La Liga,17,2002,8.9,19,11,10,7,2,8,28,28.6,20,20,1,19,9,28,8
2094,Carlo Pinsoglio,it,GK,Juventus,it Serie A,30,1990,0.3,0,0,0,0,0,0,0,,0,0,0,0,0,0,0
2095,Gerard Piqué,es,DF,Barcelona,La Liga,33,1987,16.5,16,11,11,5,0,9,12,75.0,3,9,4,5,26,42,46
2096,Fabio Pisacane,it,DF,Cagliari,it Serie A,34,1986,2.5,3,2,2,1,0,3,7,42.9,4,8,5,3,1,4,9
2097,Łukasz Piszczek,pl,DF,Dortmund,Bundesliga,35,1985,5.1,10,7,6,4,0,5,12,41.7,7,5,1,4,5,15,12
2098,Marko Pjaca,hr,FW,Genoa,it Serie A,25,1995,15.8,13,6,6,3,4,4,16,25.0,12,7,2,5,7,20,12
2099,Miralem Pjanić,ba,MF,Barcelona,La Liga,30,1990,7.0,13,8,7,4,2,7,13,53.8,6,5,1,4,11,24,5
2100,Óscar Plano,es,MF,Valladolid,La Liga,29,1991,28.0,42,24,24,12,6,14,46,30.4,32,35,6,29,34,76,43
2101,Marvin Plattenhardt,de,DF,Hertha BSC,Bundesliga,28,1992,11.9,15,10,6,7,2,5,9,55.6,4,9,1,8,1,16,19
2102,Alassane Pléa,fr,FW,Gladbach,Bundesliga,27,1993,20.0,19,9,4,10,5,5,20,25.0,15,1,0,1,5,24,7
2103,Dani Plomer,es,FW,Granada,La Liga,21,1998,0.5,0,0,0,0,0,0,1,0.0,1,0,0,0,0,0,1
2104,Tommaso Pobega,it,MF,Spezia,it Serie A,21,1999,13.7,24,13,7,13,4,11,31,35.5,20,10,2,8,9,33,22
2105,Daniel Podence,pt,MF,Wolves,Premier League,24,1995,18.5,12,6,5,5,2,2,19,10.5,17,5,1,4,13,25,2
2106,Paul Pogba,fr,MF,Manchester Utd,Premier League,27,1993,21.1,36,26,15,16,5,11,33,33.3,22,24,2,22,26,62,37
2107,Joel Pohjanpalo,fi,FW,Union Berlin,Bundesliga,25,1994,9.5,5,1,0,3,2,1,6,16.7,5,1,0,1,1,6,12
2108,Joel Pohjanpalo,fi,MF,Leverkusen,Bundesliga,25,1994,0.1,0,0,0,0,0,0,0,,0,0,0,0,0,0,0
2109,Andrea Poli,it,MF,Bologna,it Serie A,30,1989,4.3,9,7,4,2,3,6,12,50.0,6,7,1,6,7,16,7
2110,Matteo Politano,it,FW,Napoli,it Serie A,26,1993,21.2,24,16,13,9,2,11,47,23.4,36,14,1,13,14,38,18
2111,Jorge Pombo,es,FW,Cádiz,La Liga,26,1994,5.8,7,3,3,2,2,1,8,12.5,7,2,0,2,2,9,3
2112,Marin Pongračić,hr,DF,Wolfsburg,Bundesliga,22,1997,6.4,13,9,9,3,1,6,8,75.0,2,12,5,7,11,24,27
2113,Pere Pons,es,MF,Alavés,La Liga,27,1993,13.2,20,10,8,8,4,5,16,31.3,11,15,2,13,7,27,10
2114,Nick Pope,eng,GK,Burnley,Premier League,28,1992,32.0,1,1,1,0,0,0,1,0.0,1,0,0,0,2,3,29
2115,Manolo Portanova,it,MF,Genoa,it Serie A,20,2000,0.7,3,3,1,1,1,0,2,0.0,2,3,1,2,1,4,2
2116,Manolo Portanova,it,MF,Juventus,it Serie A,20,2000,0.8,2,0,2,0,0,0,2,0.0,2,4,1,3,0,2,1
2117,Francisco Portillo,es,MF,Getafe,La Liga,30,1990,4.6,5,3,1,4,0,2,14,14.3,12,3,0,3,5,10,1
2118,Portu,es,FW,Real Sociedad,La Liga,28,1992,24.3,18,8,4,10,4,7,36,19.4,29,24,2,22,8,26,5
2119,Stefan Posch,at,DF,Hoffenheim,Bundesliga,23,1997,23.5,52,24,29,17,6,27,47,57.4,20,27,8,19,37,89,73
2120,Sergio Postigo,es,DF,Levante,La Liga,31,1988,18.0,16,12,12,3,1,7,18,38.9,11,21,10,11,33,49,84
2121,Yussuf Poulsen,dk,FW,RB Leipzig,Bundesliga,26,1994,15.0,10,6,1,6,3,1,17,5.9,16,16,0,16,6,16,13
2122,Maxime Poundjé,fr,DF,Bordeaux,Ligue 1,27,1992,5.5,10,7,9,1,0,2,6,33.3,4,7,3,4,11,21,5
2123,Darío Poveda,es,FW,Getafe,La Liga,23,1997,0.1,0,0,0,0,0,0,0,,0,1,0,1,0,0,0
2124,Ian Poveda,eng,MF,Leeds United,Premier League,20,2000,3.9,5,4,3,0,2,1,7,14.3,6,5,1,4,1,6,2
2125,Alejandro Pozo Pozo,es,DF,Eibar,La Liga,21,1999,24.3,38,22,17,15,6,17,38,44.7,21,35,2,33,27,65,40
2126,Dennis Praet,be,MF,Leicester City,Premier League,26,1994,8.0,14,7,4,7,3,6,15,40.0,9,12,2,10,7,21,3
2127,Sanjin Prcić,ba,MF,Strasbourg,Ligue 1,26,1993,3.9,3,2,0,3,0,2,5,40.0,3,4,3,1,4,7,2
2128,Nicolas de Préville,fr,FW,Bordeaux,Ligue 1,29,1991,17.9,19,14,7,6,6,9,42,21.4,33,15,0,15,13,32,7
2129,Manuel Prietl,at,MF,Arminia,Bundesliga,28,1991,28.0,65,44,33,28,4,12,73,16.4,61,34,7,27,45,110,24
2130,Grischa Prömel,de,MF,Union Berlin,Bundesliga,25,1995,20.2,39,23,14,23,2,18,34,52.9,16,20,2,18,24,63,22
2131,Davy Pröpper,nl,MF,Brighton,Premier League,28,1991,2.4,6,5,0,6,0,2,5,40.0,3,3,0,3,1,7,0
2132,Ivan Provedel,it,GK,Spezia,it Serie A,26,1994,29.0,2,0,2,0,0,2,6,33.3,4,0,0,0,2,4,20
2133,Antonio Puertas,es,FW,Granada,La Liga,28,1992,24.1,27,13,9,12,6,10,32,31.3,22,24,5,19,12,39,25
2134,Riqui Puig,es,MF,Barcelona,La Liga,20,1999,3.2,5,3,1,3,1,4,8,50.0,4,0,0,0,1,6,0
2135,Erick Pulgar,cl,MF,Fiorentina,it Serie A,26,1994,22.2,41,18,17,23,1,22,49,44.9,27,24,10,14,41,82,45
2136,Jorge Pulido,es,DF,Huesca,La Liga,29,1991,32.1,39,24,31,8,0,17,29,58.6,12,32,18,14,52,91,98
2137,Christian Pulisic,us,FW,Chelsea,Premier League,21,1998,19.3,19,11,8,10,1,8,21,38.1,13,25,2,23,12,31,9
2138,Ignacio Pussetto,ar,FW,Udinese,it Serie A,24,1995,8.4,16,8,5,6,5,6,17,35.3,11,14,0,14,13,29,6
2139,Fabio Quagliarella,it,FW,Sampdoria,it Serie A,37,1983,24.5,12,8,4,4,4,2,19,10.5,17,14,1,13,7,19,10
2140,Robin Quaison,se,FW,Mainz 05,Bundesliga,26,1993,16.4,14,6,3,6,5,7,14,50.0,7,10,0,10,13,27,10
2141,Domingos Quina,pt,MF,Granada,La Liga,20,1999,3.8,5,5,1,3,1,3,6,50.0,3,8,0,8,2,7,0
2142,Quini,es,DF,Granada,La Liga,30,1989,13.2,33,22,23,7,3,19,36,52.8,17,15,6,9,15,48,39
2143,Quique,es,FW,Eibar,La Liga,30,1990,1.9,0,0,0,0,0,0,1,0.0,1,2,0,2,0,0,0
2144,Dani Raba,es,MF,Villarreal,La Liga,24,1995,1.7,2,1,0,1,1,2,8,25.0,6,1,0,1,0,2,0
2145,Simone Rabbi,it,FW,Bologna,it Serie A,18,2001,0.4,0,0,0,0,0,0,1,0.0,1,0,0,0,0,0,0
2146,Adrien Rabiot,fr,MF,Juventus,it Serie A,25,1995,25.7,72,42,24,41,7,28,60,46.7,32,32,11,21,43,115,29
2147,Uroš Račić,rs,MF,Valencia,La Liga,22,1998,24.3,38,22,16,16,6,16,54,29.6,38,33,11,22,26,64,54
2148,Anthony Racioppi,ch,GK,Dijon,Ligue 1,21,1998,21.0,0,0,0,0,0,0,2,0.0,2,0,0,0,2,2,12
2149,Nemanja Radoja,rs,MF,Levante,La Liga,27,1993,12.5,23,15,12,10,1,5,19,26.3,14,9,3,6,19,42,12
2150,Nemanja Radonjić,rs,FW,Marseille,Ligue 1,24,1996,4.4,6,5,1,2,3,2,12,16.7,10,8,0,8,3,9,1
2151,Nemanja Radonjić,rs,FW,Hertha BSC,Bundesliga,24,1996,6.8,5,3,2,2,1,1,5,20.0,4,1,0,1,2,7,1
2152,Aleksandar Radovanović,rs,DF,Lens,Ligue 1,26,1993,1.0,1,1,0,1,0,0,0,,0,2,1,1,0,1,2
2153,Ivan Radovanović,rs,DF,Genoa,it Serie A,31,1988,24.8,18,15,13,5,0,12,31,38.7,19,39,21,18,37,55,114
2154,Ionuț Radu,ro,GK,Inter,it Serie A,23,1997,1.5,0,0,0,0,0,0,0,,0,0,0,0,0,0,1
2155,Ștefan Radu,ro,DF,Lazio,it Serie A,33,1986,27.3,43,24,20,19,4,25,40,62.5,15,27,14,13,45,88,73
2156,Rafael,br,GK,Spezia,it Serie A,38,1982,2.3,0,0,0,0,0,0,0,,0,0,0,0,0,0,0
2157,Rafinha,br,MF,Paris S-G,Ligue 1,27,1993,15.1,54,26,18,28,8,28,49,57.1,21,18,3,15,13,67,6
2158,Antonio Raimondo,it,FW,Bologna,it Serie A,16,2004,0.0,0,0,0,0,0,0,0,,0,0,0,0,0,0,0
2159,Predrag Rajković,rs,GK,Reims,Ligue 1,24,1995,36.5,2,1,2,0,0,2,5,40.0,3,1,0,1,2,4,17
2160,Ivan Rakitić,hr,MF,Sevilla,La Liga,32,1988,24.8,32,18,18,10,4,12,41,29.3,29,19,4,15,26,58,29
2161,Jonás Ramalho,es,DF,Osasuna,La Liga,27,1993,3.4,5,4,4,0,1,1,3,33.3,2,3,0,3,2,7,7
2162,Benito Raman,be,FW,Schalke 04,Bundesliga,25,1994,13.8,19,13,11,6,2,6,29,20.7,23,11,0,11,5,24,5
2163,Gastón Ramírez,uy,FW,Sampdoria,it Serie A,29,1990,10.8,31,15,10,17,4,8,27,29.6,19,19,3,16,4,35,13
2164,Sandro Ramírez,es,FW,Huesca,La Liga,25,1995,14.3,13,9,3,8,2,4,11,36.4,7,11,1,10,10,23,2
2165,Sergio Ramos,es,DF,Real Madrid,La Liga,34,1986,14.2,15,12,8,6,1,6,10,60.0,4,9,5,4,19,34,39
2166,Aaron Ramsdale,eng,GK,Sheffield Utd,Premier League,22,1998,38.0,1,1,1,0,0,1,1,100.0,0,0,0,0,2,3,22
2167,Aaron Ramsey,wls,MF,Juventus,it Serie A,29,1990,12.1,22,14,8,13,1,8,25,32.0,17,13,2,11,7,29,8
2168,Jacob Ramsey,eng,MF,Aston Villa,Premier League,19,2001,7.0,10,5,3,4,3,2,12,16.7,10,13,6,7,4,14,5
2169,Kayne Ramsey,eng,DF,Southampton,Premier League,19,2000,1.0,5,2,4,1,0,3,3,100.0,0,0,0,0,0,5,3
2170,Darren Randolph,ie,GK,West Ham,Premier League,33,1987,3.0,0,0,0,0,0,0,0,,0,0,0,0,0,0,1
2171,Andrea Ranocchia,it,DF,Inter,it Serie A,32,1988,7.8,13,10,6,6,1,7,8,87.5,1,5,3,2,12,25,19
2172,Raphinha,br,MF,Leeds United,Premier League,23,1996,26.2,34,17,13,16,5,12,58,20.7,46,31,1,30,29,63,27
2173,Raphinha,br,FW,Rennes,Ligue 1,23,1996,4.5,5,2,1,3,1,1,4,25.0,3,5,0,5,3,8,4
2174,Marcus Rashford,eng,FW,Manchester Utd,Premier League,22,1997,32.4,18,9,2,8,8,7,27,25.9,20,22,2,20,8,26,10
2175,Milot Rashica,xk,FW,Werder Bremen,Bundesliga,24,1996,16.2,24,12,11,11,2,12,23,52.2,11,7,0,7,4,28,6
2176,Giacomo Raspadori,it,FW,Sassuolo,it Serie A,20,2000,13.7,5,3,1,1,3,0,4,0.0,4,13,5,8,2,7,9
2177,Federico Ravaglia,it,GK,Bologna,it Serie A,20,1999,4.0,0,0,0,0,0,0,1,0.0,1,0,0,0,0,0,2
2178,Tim Ream,us,DF,Fulham,Premier League,32,1987,7.0,12,5,9,3,0,8,11,72.7,3,8,5,3,6,18,26
2179,Ante Rebić,hr,FW,Milan,it Serie A,26,1993,19.7,26,9,4,8,14,8,37,21.6,29,21,1,20,7,33,17
2180,Arkadiusz Reca,pl,DF,Crotone,it Serie A,25,1995,25.7,34,16,15,11,8,10,45,22.2,35,30,3,27,50,84,64
2181,Recio,es,MF,Eibar,La Liga,29,1991,8.2,17,5,4,8,5,8,18,44.4,10,6,0,6,4,21,1
2182,Daishawn Redan,nl,FW,Hertha BSC,Bundesliga,19,2001,1.1,0,0,0,0,0,0,0,,0,1,0,1,0,0,0
2183,Nathan Redmond,eng,MF,Southampton,Premier League,26,1994,19.3,30,17,14,12,4,8,24,33.3,16,24,2,22,11,41,9
2184,Harrison Reed,eng,MF,Fulham,Premier League,25,1995,25.0,63,38,28,28,7,29,73,39.7,44,34,11,23,50,113,31
2185,Vasco Regini,it,DF,Sampdoria,it Serie A,29,1990,1.0,2,2,2,0,0,2,2,100.0,0,1,1,0,1,3,5
2186,Sergio Reguilón,es,DF,Tottenham,Premier League,23,1996,24.9,47,25,30,13,4,23,48,47.9,25,39,7,32,32,79,50
2187,Bobby Reid,jm,MF,Fulham,Premier League,27,1993,26.4,31,15,17,10,4,18,39,46.2,21,19,5,14,21,52,39
2188,Pepe Reina,es,GK,Lazio,it Serie A,37,1982,29.0,0,0,0,0,0,0,1,0.0,1,0,0,0,1,1,6
2189,Jeff Reine-Adélaïde,fr,MF,Nice,Ligue 1,22,1998,11.8,7,4,1,4,2,2,9,22.2,7,10,1,9,4,11,6
2190,Jeff Reine-Adélaïde,fr,FW,Lyon,Ligue 1,22,1998,0.3,0,0,0,0,0,0,0,,0,0,0,0,0,0,0
2191,Reinier,br,MF,Dortmund,Bundesliga,18,2002,2.9,9,4,6,1,2,2,4,50.0,2,4,1,3,2,11,0
2192,Francisco Reis Ferreira,pt,DF,Valencia,La Liga,23,1997,2.0,1,1,1,0,0,0,3,0.0,3,0,0,0,0,1,6
2193,Rocco Reitz,de,MF,Gladbach,Bundesliga,18,2002,0.7,3,2,0,3,0,2,2,100.0,0,3,1,2,1,4,1
2194,Karim Rekik,nl,DF,Sevilla,La Liga,25,1994,7.3,7,5,2,5,0,1,4,25.0,3,8,3,5,6,13,17
2195,Álex Remiro,es,GK,Real Sociedad,La Liga,25,1995,38.0,0,0,0,0,0,0,1,0.0,1,0,0,0,3,3,14
2196,Panagiotis Retsos,gr,DF,Saint-Étienne,Ligue 1,21,1998,3.0,5,3,5,0,0,3,7,42.9,4,1,1,0,3,8,12
2197,Marco Reus,de,MF,Dortmund,Bundesliga,31,1989,25.3,33,16,9,16,8,9,33,27.3,24,22,2,20,14,47,13
2198,Elvis Rexhbeçaj,xk,MF,Köln,Bundesliga,22,1997,20.4,53,32,17,27,9,19,53,35.8,34,32,7,25,26,79,18
2199,Oriol Rey,es,MF,Valladolid,La Liga,22,1998,0.2,0,0,0,0,0,0,0,,0,0,0,0,1,1,0
2200,Gio Reyna,us,MF,Dortmund,Bundesliga,17,2002,22.0,24,13,9,8,7,9,25,36.0,16,14,1,13,10,34,11
2201,Baptiste Reynet,fr,GK,Nîmes,Ligue 1,29,1990,38.0,2,1,2,0,0,2,4,50.0,2,1,0,1,1,3,9
2202,Bryan Reynolds,us,DF,Roma,it Serie A,19,2001,3.1,4,2,1,1,2,1,5,20.0,4,4,0,4,6,10,4
2203,Franck Ribéry,fr,FW,Fiorentina,it Serie A,37,1983,23.9,24,11,4,9,11,5,29,17.2,24,11,2,9,3,27,1
2204,Federico Ricci,it,FW,Sassuolo,it Serie A,26,1994,0.0,0,0,0,0,0,0,0,,0,0,0,0,0,0,0
2205,Giacomo Ricci,it,DF,Parma,it Serie A,23,1996,0.7,3,1,1,2,0,0,0,,0,2,2,0,1,4,4
2206,Matteo Ricci,it,MF,Spezia,it Serie A,26,1994,24.8,40,23,14,24,2,27,52,51.9,25,24,4,20,34,74,13
2207,Declan Rice,eng,MF,West Ham,Premier League,21,1999,32.0,59,35,33,25,1,21,51,41.2,30,39,11,28,59,118,41
2208,Chris Richards,us,DF,Hoffenheim,Bundesliga,20,2000,10.5,19,8,12,6,1,10,16,62.5,6,13,4,9,21,40,40
2209,Chris Richards,us,DF,Bayern Munich,Bundesliga,20,2000,1.0,0,0,0,0,0,0,0,,0,0,0,0,1,1,1
2210,Lewis Richardson,eng,FW,Burnley,Premier League,17,2003,0.0,0,0,0,0,0,0,0,,0,0,0,0,0,0,0
2211,Richarlison,br,FW,Everton,Premier League,23,1997,31.8,50,32,21,22,7,16,51,31.4,35,28,3,25,14,64,36
2212,Marco Richter,de,FW,Augsburg,Bundesliga,22,1997,15.7,17,9,3,12,2,7,23,30.4,16,10,0,10,6,23,9
2213,Mikel Rico,es,MF,Huesca,La Liga,35,1984,24.3,24,12,14,8,2,11,34,32.4,23,20,3,17,23,47,22
2214,Sergio Rico,es,GK,Paris S-G,Ligue 1,26,1993,9.0,0,0,0,0,0,0,0,,0,0,0,0,0,0,1
2215,Jaïro Riedewald,nl,MF,Crystal Palace,Premier League,23,1996,20.2,34,15,13,17,4,16,36,44.4,20,39,7,32,29,63,25
2216,Emiliano Rigoni,ar,MF,Elche,La Liga,27,1993,12.7,12,7,3,8,1,3,15,20.0,12,16,1,15,6,18,9
2217,Tomás Rincón,ve,MF,Torino,it Serie A,32,1988,31.6,68,38,27,33,8,36,71,50.7,35,32,7,25,31,99,44
2218,Luis Rioja,es,MF,Alavés,La Liga,26,1993,23.2,21,14,11,7,3,7,39,17.9,32,23,1,22,20,41,30
2219,Renaud Ripart,fr,MF,Nîmes,Ligue 1,27,1993,33.9,52,30,25,19,8,26,84,31.0,58,58,12,46,36,88,53
2220,Andrea Rispoli,it,DF,Crotone,it Serie A,31,1988,7.2,6,3,2,3,1,2,7,28.6,5,12,3,9,5,11,15
2221,Mihailo Ristić,rs,DF,Montpellier,Ligue 1,24,1995,24.8,45,22,25,13,7,28,44,63.6,16,30,9,21,26,71,57
2222,Matt Ritchie,sct,DF,Newcastle Utd,Premier League,30,1989,15.0,10,3,5,3,2,3,17,17.6,14,17,2,15,12,22,47
2223,Maxence Rivera,fr,MF,Saint-Étienne,Ligue 1,18,2002,2.7,12,10,6,4,2,4,10,40.0,6,5,0,5,1,13,0
2224,Emmanuel Rivière,fr,FW,Crotone,it Serie A,30,1990,7.1,2,1,2,0,0,0,3,0.0,3,5,1,4,1,3,0
2225,Rober,es,DF,Levante,La Liga,25,1995,15.8,14,7,8,3,3,8,18,44.4,10,24,16,8,35,49,52
2226,Roberto,es,GK,Valladolid,La Liga,34,1986,13.0,0,0,0,0,0,0,1,0.0,1,0,0,0,0,0,7
2227,Sergi Roberto,es,DF,Barcelona,La Liga,28,1992,10.5,9,6,5,2,2,7,13,53.8,6,12,6,6,10,19,20
2228,Tyler Roberts,wls,MF,Leeds United,Premier League,21,1999,14.9,15,13,1,11,3,5,22,22.7,17,17,2,15,9,24,12
2229,Andrew Robertson,sct,DF,Liverpool,Premier League,26,1994,37.6,46,34,23,18,5,28,57,49.1,29,39,9,30,21,67,79
2230,Antonee Robinson,us,DF,Fulham,Premier League,22,1997,24.0,45,28,24,16,5,27,44,61.4,17,21,4,17,37,82,68
2231,Callum Robinson,ie,FW,West Brom,Premier League,25,1995,17.3,7,5,5,1,1,3,19,15.8,16,9,0,9,7,14,8
2232,Jack Robinson,eng,DF,Sheffield Utd,Premier League,26,1993,9.7,14,6,8,5,1,6,11,54.5,5,10,4,6,9,23,42
2233,Joel Robles,es,GK,Betis,La Liga,30,1990,18.0,0,0,0,0,0,0,1,0.0,1,1,0,1,0,0,11
2234,Hal Robson-Kanu,wls,FW,West Brom,Premier League,31,1989,6.2,2,1,1,0,1,0,1,0.0,1,2,0,2,2,4,7
2235,Marc Roca,es,MF,Bayern Munich,Bundesliga,23,1996,2.0,2,2,0,0,2,0,4,0.0,4,4,1,3,2,4,1
2236,Christopher Rocchia,fr,DF,Marseille,Ligue 1,22,1998,0.2,1,0,1,0,0,0,2,0.0,2,0,0,0,0,1,1
2237,Rubén Rochina,es,MF,Levante,La Liga,29,1991,15.6,38,28,12,23,3,12,35,34.3,23,22,2,20,22,60,7
2238,Marek Rodák,sk,GK,Fulham,Premier League,23,1996,2.0,0,0,0,0,0,0,0,,0,0,0,0,0,0,0
2239,Sebastian Rode,de,MF,Eint Frankfurt,Bundesliga,29,1990,18.1,44,25,21,16,7,14,46,30.4,32,30,3,27,47,91,18
2240,Joe Rodon,wls,DF,Tottenham,Premier League,22,1997,8.1,14,9,11,2,1,3,4,75.0,1,10,8,2,21,35,36
2241,Rodri,es,MF,Manchester City,Premier League,24,1996,30.5,72,40,24,40,8,33,66,50.0,33,23,9,14,36,108,54
2242,Rodri,es,FW,Betis,La Liga,20,2000,6.0,3,3,1,2,0,1,6,16.7,5,7,0,7,2,5,0
2243,Rodrigo,es,MF,Leeds United,Premier League,29,1991,14.3,14,7,8,3,3,4,22,18.2,18,7,0,7,5,19,16
2244,Kévin Rodrigues,pt,DF,Eibar,La Liga,26,1994,12.2,16,8,8,5,3,7,23,30.4,16,10,1,9,20,36,15
2245,Ángel Rodríguez,es,FW,Getafe,La Liga,33,1987,15.3,7,4,1,4,2,1,16,6.3,15,7,0,7,2,9,8
2246,Óscar Rodríguez Arnaiz,es,MF,Sevilla,La Liga,22,1998,5.7,15,9,3,8,4,6,13,46.2,7,2,0,2,10,25,1
2247,Guido Rodríguez,ar,MF,Betis,La Liga,26,1994,31.8,98,56,52,40,6,40,85,47.1,45,52,14,38,68,166,58
2248,James Rodríguez,co,FW,Everton,Premier League,29,1991,19.6,28,17,8,15,5,11,46,23.9,35,17,0,17,15,43,3
2249,Jay Rodriguez,eng,FW,Burnley,Premier League,31,1989,14.1,25,16,5,15,5,13,28,46.4,15,25,4,21,2,27,7
2250,Miguel Rodríguez,es,FW,Celta Vigo,La Liga,17,2003,0.3,1,1,0,1,0,0,0,,0,0,0,0,0,1,0
2251,Ricardo Rodríguez,ch,DF,Torino,it Serie A,27,1992,13.8,21,14,11,8,2,13,22,59.1,9,16,5,11,20,41,43
2252,Víctor Rodríguez,es,MF,Elche,La Liga,31,1989,4.7,4,3,3,1,0,0,9,0.0,9,5,1,4,5,9,4
2253,Rodrygo,br,FW,Real Madrid,La Liga,19,2001,10.9,15,6,10,4,1,2,17,11.8,15,15,0,15,7,22,4
2254,Marko Rog,hr,MF,Cagliari,it Serie A,25,1995,12.9,40,24,15,22,3,16,37,43.2,21,17,6,11,19,59,15
2255,Rogério,br,DF,Sassuolo,it Serie A,22,1998,20.9,26,13,19,5,2,19,27,70.4,8,26,5,21,31,57,53
2256,Luis Rojas,cl,MF,Crotone,it Serie A,18,2002,1.2,1,0,0,1,0,1,2,50.0,1,2,0,2,1,2,0
2257,Alessio Romagnoli,it,DF,Milan,it Serie A,25,1995,21.2,17,7,8,7,2,8,19,42.1,11,29,22,7,24,41,80
2258,Cristian Romero,ar,DF,Atalanta,it Serie A,22,1998,28.3,63,32,41,19,3,27,49,55.1,22,31,13,18,96,159,71
2259,Oriol Romeu,es,MF,Southampton,Premier League,28,1991,19.6,69,35,25,39,5,26,68,38.2,42,28,7,21,30,99,18
2260,Cristiano Ronaldo,pt,FW,Juventus,it Serie A,35,1985,31.1,6,3,1,3,2,3,15,20.0,12,11,3,8,5,11,15
2261,Facundo Roncaglia,ar,DF,Osasuna,La Liga,33,1987,13.7,25,14,14,11,0,11,20,55.0,9,11,6,5,25,50,26
2262,Valentin Rongier,fr,MF,Marseille,Ligue 1,25,1994,21.0,93,59,31,55,7,43,85,50.6,42,32,2,30,28,121,21
2263,Marten de Roon,nl,MF,Atalanta,it Serie A,29,1991,33.6,80,48,30,36,14,36,84,42.9,48,44,9,35,69,149,40
2264,Jérôme Roussillon,fr,DF,Wolfsburg,Bundesliga,27,1993,13.7,24,12,14,8,2,11,20,55.0,9,10,1,9,19,43,28
2265,Nolan Roux,fr,FW,Nîmes,Ligue 1,32,1988,7.2,7,3,1,4,2,3,8,37.5,5,6,0,6,5,12,4
2266,Nicolò Rovella,it,MF,Genoa,it Serie A,18,2001,13.2,29,16,15,11,3,9,32,28.1,23,11,0,11,20,49,19
2267,Amir Rrahmani,xk,DF,Napoli,it Serie A,26,1994,12.2,13,8,7,6,0,6,9,66.7,3,17,14,3,8,21,39
2268,Rubén,es,GK,Osasuna,La Liga,36,1984,2.1,0,0,0,0,0,0,0,,0,0,0,0,0,0,1
2269,Waldo Rubio,es,FW,Valladolid,La Liga,24,1995,4.2,6,4,2,2,2,1,14,7.1,13,6,0,6,3,9,3
2270,John Ruddy,eng,GK,Wolves,Premier League,33,1986,1.0,0,0,0,0,0,0,0,,0,0,0,0,0,0,0
2271,Antonio Rüdiger,de,DF,Chelsea,Premier League,27,1993,19.0,31,23,16,14,1,12,15,80.0,3,17,10,7,18,49,51
2272,Sebastian Rudy,de,MF,Hoffenheim,Bundesliga,30,1990,18.6,35,26,15,15,5,16,45,35.6,29,24,4,20,13,48,21
2273,Sebastian Rudy,de,DF,Schalke 04,Bundesliga,30,1990,2.0,4,2,2,0,2,4,7,57.1,3,6,4,2,1,5,4
2274,Kevin Rüegg,ch,DF,Hellas Verona,it Serie A,21,1998,2.3,0,0,0,0,0,0,0,,0,3,0,3,2,2,3
2275,Daniele Rugani,it,DF,Cagliari,it Serie A,26,1994,11.1,24,11,10,12,2,10,20,50.0,10,15,10,5,15,39,46
2276,Daniele Rugani,it,DF,Rennes,Ligue 1,26,1994,1.0,0,0,0,0,0,0,1,0.0,1,1,1,0,1,1,1
2277,Matteo Ruggeri,it,DF,Atalanta,it Serie A,18,2002,2.3,3,0,1,2,0,2,3,66.7,1,2,0,2,4,7,2
2278,Mário Rui,pt,DF,Napoli,it Serie A,29,1991,18.5,24,13,17,6,1,17,33,51.5,16,17,4,13,28,52,29
2279,Aitor Ruibal,es,FW,Betis,La Liga,24,1996,17.7,32,18,14,14,4,10,35,28.6,25,26,0,26,11,43,8
2280,Isma Ruiz,es,MF,Granada,La Liga,19,2001,0.7,1,0,0,1,0,0,1,0.0,1,0,0,0,0,1,3
2281,Kays Ruiz,fr,FW,Paris S-G,Ligue 1,17,2002,2.1,1,1,0,1,0,0,4,0.0,4,1,0,1,3,4,2
2282,Fabián Ruiz Peña,es,MF,Napoli,it Serie A,24,1996,28.5,58,31,26,21,11,25,70,35.7,45,33,3,30,36,94,32
2283,Víctor Ruiz,es,DF,Betis,La Liga,31,1989,24.0,11,7,7,4,0,4,13,30.8,9,17,13,4,44,55,85
2284,Gerónimo Rulli,ar,GK,Villarreal,La Liga,28,1992,2.0,0,0,0,0,0,0,0,,0,0,0,0,0,0,0
2285,Georginio Rutter,fr,FW,Rennes,Ligue 1,18,2002,0.5,2,2,0,1,1,1,3,33.3,2,2,0,2,0,2,0
2286,Georginio Rutter,fr,FW,Hoffenheim,Bundesliga,18,2002,2.7,4,4,2,2,0,1,2,50.0,1,2,0,2,0,4,2
2287,Mathew Ryan,au,GK,Arsenal,Premier League,28,1992,3.0,0,0,0,0,0,0,0,,0,0,0,0,0,0,1
2288,Mathew Ryan,au,GK,Brighton,Premier League,28,1992,11.0,1,0,1,0,0,0,0,,0,0,0,0,0,1,4
2289,Julian Ryerson,no,DF,Union Berlin,Bundesliga,22,1997,11.9,22,15,4,14,4,12,15,80.0,3,13,0,13,11,33,17
2290,Frederik Rønnow,dk,GK,Schalke 04,Bundesliga,27,1992,10.5,0,0,0,0,0,0,0,,0,0,0,0,1,1,9
2291,Roli Pereira de Sa,fr,FW,Nantes,Ligue 1,23,1996,0.6,4,3,1,3,0,3,4,75.0,1,2,0,2,0,4,0
2292,Victor Sá,br,FW,Wolfsburg,Bundesliga,26,1994,5.2,9,6,2,6,1,6,11,54.5,5,11,0,11,8,17,2
2293,Idriss Saadi,dz,MF,Strasbourg,Ligue 1,28,1992,1.4,0,0,0,0,0,0,2,0.0,2,0,0,0,0,0,0
2294,Youssouf Sabaly,sn,DF,Bordeaux,Ligue 1,27,1993,32.3,47,33,24,17,6,27,45,60.0,18,31,8,23,49,96,57
2295,Mathys Saban,fr,FW,Saint-Étienne,Ligue 1,18,2002,0.1,0,0,0,0,0,0,0,,0,0,0,0,0,0,0
2296,Marcel Sabitzer,at,MF,RB Leipzig,Bundesliga,26,1994,22.5,29,21,12,16,1,12,37,32.4,25,7,2,5,35,64,27
2297,Alexis Saelemaekers,be,FW,Milan,it Serie A,21,1999,22.4,43,26,20,18,5,19,60,31.7,41,29,1,28,25,68,6
2298,Modibo Sagnan,ml,DF,Real Sociedad,La Liga,21,1999,6.9,12,7,6,6,0,4,6,66.7,2,7,2,5,6,18,25
2299,Allan Saint-Maximin,fr,FW,Newcastle Utd,Premier League,23,1997,17.3,16,9,6,9,1,4,9,44.4,5,10,0,10,4,20,2
2300,Borja Sainz,es,MF,Alavés,La Liga,19,2001,5.0,7,3,3,2,2,4,16,25.0,12,4,0,4,6,13,1
2301,Romain Saïss,ma,DF,Wolves,Premier League,30,1990,26.7,35,24,23,12,0,19,33,57.6,14,28,13,15,52,87,115
2302,Bukayo Saka,eng,FW,Arsenal,Premier League,18,2001,28.4,25,16,10,13,2,11,40,27.5,29,21,2,19,25,50,24
2303,Hiroki Sakai,jp,DF,Marseille,Ligue 1,30,1990,26.5,81,48,34,35,12,39,51,76.5,12,21,5,16,54,135,65
2304,Moïse Sakava,cm,MF,Reims,Ligue 1,19,2000,0.1,0,0,0,0,0,0,0,,0,0,0,0,0,0,0
2305,Mamadou Sakho,fr,DF,Crystal Palace,Premier League,30,1990,3.1,3,2,1,2,0,3,3,100.0,0,3,2,1,3,6,11
2306,Jacopo Sala,it,DF,Spezia,it Serie A,28,1991,4.2,17,9,14,1,2,8,22,36.4,14,5,2,3,5,22,6
2307,Mohamed Salah,eg,FW,Liverpool,Premier League,28,1992,34.2,18,9,4,4,10,7,16,43.8,9,10,0,10,1,19,10
2308,Eddie Salcedo,it,MF,Hellas Verona,it Serie A,18,2001,8.4,6,2,3,2,1,3,3,100.0,0,6,0,6,6,12,6
2309,William Saliba,fr,DF,Nice,Ligue 1,19,2001,20.0,15,9,8,5,2,5,6,83.3,1,17,16,1,26,41,80
2310,Romain Salin,fr,GK,Rennes,Ligue 1,36,1984,15.0,0,0,0,0,0,0,1,0.0,1,0,0,0,1,1,6
2311,Mohammed Salisu,gh,DF,Southampton,Premier League,21,1999,9.4,38,21,20,16,2,25,34,73.5,9,22,5,17,17,55,30
2312,Roland Sallai,hu,MF,Freiburg,Bundesliga,23,1997,18.5,18,14,7,9,2,5,13,38.5,8,11,1,10,11,29,8
2313,Salvi,es,MF,Cádiz,La Liga,29,1991,21.5,18,10,14,3,1,8,26,30.8,18,14,1,13,20,38,24
2314,Lazar Samardzic,rs,MF,RB Leipzig,Bundesliga,18,2002,2.2,10,7,4,6,0,5,13,38.5,8,6,0,6,2,12,1
2315,Diadie Samassékou,ml,MF,Hoffenheim,Bundesliga,24,1996,28.5,71,41,22,42,7,33,90,36.7,57,41,12,29,78,149,50
2316,Mama Samba Baldé,gw,FW,Dijon,Ligue 1,24,1995,24.0,23,9,4,13,6,9,22,40.9,13,16,1,15,4,27,26
2317,Junior Sambia,fr,DF,Montpellier,Ligue 1,23,1996,27.2,41,29,20,14,7,26,38,68.4,12,27,14,13,39,80,46
2318,Frédéric Sammaritano,fr,FW,Dijon,Ligue 1,34,1986,12.6,15,10,9,5,1,9,26,34.6,17,6,0,6,9,24,3
2319,Fede San Emeterio,es,MF,Valladolid,La Liga,23,1997,16.2,25,14,15,7,3,11,31,35.5,20,23,8,15,28,53,33
2320,Antonio Sanabria,py,FW,Torino,it Serie A,24,1996,10.9,8,3,0,4,4,2,9,22.2,7,5,0,5,5,13,8
2321,Antonio Sanabria,py,FW,Betis,La Liga,24,1996,10.4,5,5,0,4,1,0,2,0.0,2,8,1,7,3,8,9
2322,Oihan Sancet,es,FW,Athletic Club,La Liga,20,2000,11.5,8,2,3,4,1,2,7,28.6,5,4,0,4,5,13,7
2323,Renato Sanches,pt,MF,Lille,Ligue 1,22,1997,14.1,13,7,4,8,1,5,25,20.0,20,13,2,11,13,26,8
2324,Ricard Sánchez,es,DF,Atlético Madrid,La Liga,20,2000,0.3,1,1,0,0,1,0,0,,0,1,0,1,0,1,1
2325,Alexis Sánchez,cl,FW,Inter,it Serie A,31,1988,12.7,14,8,4,4,6,5,18,27.8,13,11,0,11,7,21,1
2326,Davinson Sánchez,co,DF,Tottenham,Premier League,24,1996,16.5,40,20,31,9,0,21,32,65.6,11,18,13,5,14,54,85
2327,Germán Sánchez,es,DF,Granada,La Liga,33,1986,29.3,24,11,13,9,2,11,23,47.8,12,28,26,2,38,62,130
2328,Javi Sánchez,es,DF,Valladolid,La Liga,23,1997,10.2,15,10,10,4,1,9,10,90.0,1,15,7,8,15,30,37
2329,Manu Sánchez,es,DF,Osasuna,La Liga,19,2000,10.8,27,15,10,10,7,11,25,44.0,14,8,0,8,8,35,14
2330,Manu Sánchez,es,DF,Atlético Madrid,La Liga,19,2000,0.5,0,0,0,0,0,0,1,0.0,1,1,0,1,0,0,1
2331,Juan Sánchez Miño,ar,DF,Elche,La Liga,30,1990,5.5,8,5,5,3,0,6,14,42.9,8,4,0,4,4,12,7
2332,Pepe Sánchez,es,DF,Granada,La Liga,20,2000,2.8,4,2,2,2,0,3,4,75.0,1,5,2,3,4,8,9
2333,Robert Sánchez,es,GK,Brighton,Premier League,22,1997,27.0,1,0,1,0,0,1,1,100.0,0,1,0,1,1,2,11
2334,Jadon Sancho,eng,FW,Dortmund,Bundesliga,20,2000,22.9,18,11,4,10,4,7,16,43.8,9,20,1,19,16,34,9
2335,Alex Sandro,br,DF,Juventus,it Serie A,29,1991,20.6,37,23,19,13,5,13,25,52.0,12,20,4,16,31,68,57
2336,Leroy Sané,de,FW,Bayern Munich,Bundesliga,24,1996,20.1,18,10,2,10,6,13,30,43.3,17,23,1,22,9,27,8
2337,Salif Sané,sn,DF,Schalke 04,Bundesliga,29,1990,11.9,17,9,9,7,1,13,23,56.5,10,25,13,12,25,42,66
2338,Oier Sanjurjo,es,MF,Osasuna,La Liga,34,1986,23.2,39,16,8,27,4,17,60,28.3,43,24,6,18,29,68,41
2339,Mohamed Sankoh,nl,MF,Stuttgart,Bundesliga,16,2003,0.2,0,0,0,0,0,0,0,,0,1,0,1,0,0,0
2340,Siriki Sanogo,ci,MF,Benevento,it Serie A,18,2001,0.1,0,0,0,0,0,0,0,,0,0,0,0,0,0,0
2341,Morgan Sanson,fr,MF,Aston Villa,Premier League,25,1994,3.3,7,4,4,2,1,1,4,25.0,3,5,0,5,4,11,1
2342,Morgan Sanson,fr,MF,Marseille,Ligue 1,25,1994,9.2,21,12,6,12,3,9,28,32.1,19,12,0,12,9,30,5
2343,Nicola Sansone,it,FW,Bologna,it Serie A,28,1991,13.0,22,11,7,12,3,10,31,32.3,21,15,0,15,9,31,7
2344,Baptiste Santamaria,fr,MF,Angers,Ligue 1,25,1995,3.0,9,6,3,5,1,2,7,28.6,5,4,0,4,7,16,8
2345,Baptiste Santamaria,fr,MF,Freiburg,Bundesliga,25,1995,24.5,51,38,19,24,8,20,54,37.0,34,36,7,29,52,103,34
2346,Federico Santander,py,FW,Bologna,it Serie A,29,1991,0.4,0,0,0,0,0,0,0,,0,0,0,0,0,0,0
2347,Davide Santon,it,DF,Roma,it Serie A,29,1991,6.5,4,3,2,2,0,3,7,42.9,4,10,1,9,4,8,12
2348,Samir Santos,br,DF,Udinese,it Serie A,25,1994,24.6,40,23,26,12,2,13,29,44.8,16,33,17,16,58,98,60
2349,Riccardo Saponara,it,MF,Fiorentina,it Serie A,28,1991,0.6,2,1,0,2,0,1,3,33.3,2,0,0,0,1,3,0
2350,Riccardo Saponara,it,FW,Spezia,it Serie A,28,1991,4.3,4,1,1,0,3,1,3,33.3,2,1,0,1,1,5,4
2351,Ivan Šaponjić,rs,FW,Cádiz,La Liga,22,1997,4.3,1,0,0,1,0,0,2,0.0,2,2,0,2,1,2,4
2352,Pablo Sarabia,es,FW,Paris S-G,Ligue 1,28,1992,14.7,15,11,6,6,3,10,38,26.3,28,9,1,8,5,20,8
2353,Josh Sargent,us,FW,Werder Bremen,Bundesliga,20,2000,27.8,32,19,13,13,6,13,27,48.1,14,39,4,35,17,49,36
2354,Bouna Sarr,sn,DF,Marseille,Ligue 1,28,1992,0.8,1,1,0,0,1,1,1,100.0,0,1,1,0,1,2,1
2355,Bouna Sarr,sn,DF,Bayern Munich,Bundesliga,28,1992,5.0,9,8,4,3,2,3,6,50.0,3,7,0,7,10,19,7
2356,Sidy Sarr,sn,MF,Nîmes,Ligue 1,24,1996,5.1,10,6,4,6,0,2,5,40.0,3,1,1,0,7,17,4
2357,Marco Sau,it,MF,Benevento,it Serie A,32,1987,8.7,6,2,0,6,0,1,16,6.3,15,7,0,7,5,11,3
2358,Téji Savanier,fr,MF,Montpellier,Ligue 1,28,1991,24.1,49,33,16,25,8,22,73,30.1,51,28,6,22,38,87,15
2359,Stefan Savić,me,DF,Atlético Madrid,La Liga,29,1991,32.8,40,25,32,7,1,21,34,61.8,13,33,19,14,42,82,110
2360,Romaine Sawyers,kn,MF,West Brom,Premier League,28,1991,16.5,30,18,16,12,2,14,43,32.6,29,20,4,16,18,48,12
2361,Gianluca Scamacca,it,FW,Genoa,it Serie A,21,1999,15.0,19,10,6,7,6,7,19,36.8,12,21,4,17,9,28,12
2362,Dane Scarlett,eng,FW,Tottenham,Premier League,16,2004,0.0,0,0,0,0,0,0,0,,0,0,0,0,0,0,0
2363,Fabian Schär,ch,DF,Newcastle Utd,Premier League,28,1991,13.8,13,4,8,5,0,7,19,36.8,12,19,12,7,27,40,52
2364,Aurélien Scheidler,fr,FW,Dijon,Ligue 1,22,1998,3.8,2,0,0,2,0,0,2,0.0,2,0,0,0,1,3,5
2365,Nicolás Schiappacasse,uy,MF,Sassuolo,it Serie A,21,1999,0.2,0,0,0,0,0,0,0,,0,0,0,0,0,0,0
2366,Pasquale Schiattarella,it,MF,Benevento,it Serie A,33,1987,25.0,37,22,25,12,0,19,47,40.4,28,19,5,14,32,69,29
2367,Patrik Schick,cz,FW,Leverkusen,Bundesliga,24,1996,20.7,7,2,0,5,2,1,4,25.0,3,5,2,3,3,10,20
2368,Sven Schipplock,de,FW,Arminia,Bundesliga,31,1988,8.3,15,8,7,6,2,6,27,22.2,21,13,2,11,6,21,8
2369,Xaver Schlager,at,MF,Wolfsburg,Bundesliga,22,1997,29.2,66,40,20,38,8,22,68,32.4,46,50,6,44,54,120,38
2370,Keven Schlotterbeck,de,DF,Freiburg,Bundesliga,23,1997,18.4,31,10,16,15,0,10,23,43.5,13,26,18,8,36,67,89
2371,Nico Schlotterbeck,de,DF,Union Berlin,Bundesliga,20,1999,14.3,34,19,14,19,1,18,28,64.3,10,13,6,7,31,65,29
2372,Jeffrey Schlupp,gh,MF,Crystal Palace,Premier League,27,1992,15.9,29,16,14,12,3,6,23,26.1,17,24,8,16,22,51,16
2373,Kasper Schmeichel,dk,GK,Leicester City,Premier League,33,1986,38.0,0,0,0,0,0,0,0,,0,0,0,0,0,0,10
2374,Jonathan Schmid,fr,MF,Freiburg,Bundesliga,30,1990,26.6,37,19,17,13,7,16,30,53.3,14,26,10,16,28,65,38
2375,Romano Schmid,at,MF,Werder Bremen,Bundesliga,20,2000,13.1,22,16,8,10,4,8,35,22.9,27,21,0,21,8,30,6
2376,Benno Schmitz,de,DF,Köln,Bundesliga,25,1994,4.6,14,7,6,7,1,7,13,53.8,6,8,2,6,6,20,7
2377,Morgan Schneiderlin,fr,MF,Nice,Ligue 1,30,1989,24.4,51,31,21,24,6,20,54,37.0,34,21,11,10,53,104,46
2378,Alessandro Schöpf,at,FW,Schalke 04,Bundesliga,26,1994,10.5,11,9,3,7,1,1,6,16.7,5,15,1,14,6,17,6
2379,Jerdy Schouten,nl,MF,Bologna,it Serie A,23,1997,27.9,50,25,23,25,2,16,37,43.2,21,36,13,23,79,129,37
2380,Nico Schulz,de,DF,Dortmund,Bundesliga,27,1993,6.8,9,6,4,3,2,2,11,18.2,9,12,4,8,6,15,10
2381,Alexander Schwolow,de,GK,Hertha BSC,Bundesliga,28,1992,26.0,0,0,0,0,0,0,0,,0,1,0,1,0,0,6
2382,Christopher Scott,de,MF,Bayern Munich,Bundesliga,18,2002,0.4,2,1,0,1,1,2,2,100.0,0,0,0,0,0,2,1
2383,Matteo Scozzarella,it,MF,Parma,it Serie A,32,1988,1.7,4,0,3,1,0,2,3,66.7,1,3,1,2,6,10,0
2384,Simone Scuffet,it,GK,Udinese,it Serie A,24,1996,1.0,0,0,0,0,0,0,0,,0,0,0,0,0,0,0
2385,Jacopo Segre,it,MF,Torino,it Serie A,23,1997,2.1,5,2,2,1,2,2,5,40.0,3,0,0,0,0,5,1
2386,Davie Selke,de,FW,Werder Bremen,Bundesliga,25,1995,9.0,3,2,1,1,1,0,6,0.0,6,3,2,1,1,4,7
2387,Malik Sellouki,fr,FW,Nice,Ligue 1,20,2000,0.7,0,0,0,0,0,0,1,0.0,1,2,0,2,2,2,0
2388,Matz Sels,be,GK,Strasbourg,Ligue 1,28,1992,6.0,0,0,0,0,0,0,0,,0,0,0,0,0,0,4
2389,Nélson Semedo,pt,DF,Wolves,Premier League,26,1993,33.1,85,48,53,23,9,42,72,58.3,30,30,10,20,41,126,78
2390,Léo Sena,br,MF,Spezia,it Serie A,24,1995,9.8,22,12,7,10,5,12,26,46.2,14,19,4,15,11,33,5
2391,Stefano Sensi,it,MF,Inter,it Serie A,24,1995,6.7,9,6,3,5,1,4,11,36.4,7,6,1,5,7,16,1
2392,Jaime Seoane,es,MF,Huesca,La Liga,23,1997,22.9,50,30,20,23,7,24,65,36.9,41,27,6,21,17,67,14
2393,Luigi Sepe,it,GK,Parma,it Serie A,29,1991,36.0,0,0,0,0,0,0,2,0.0,2,0,0,0,2,2,13
2394,Suat Serdar,de,MF,Schalke 04,Bundesliga,23,1997,21.7,55,35,18,33,4,17,52,32.7,35,29,4,25,23,78,21
2395,Jean Seri,ci,MF,Bordeaux,Ligue 1,29,1991,7.9,17,9,3,12,2,4,15,26.7,11,8,2,6,12,29,7
2396,Femi Seriki,eng,MF,Sheffield Utd,Premier League,18,2002,0.0,0,0,0,0,0,0,0,,0,0,0,0,0,0,0
2397,Ryan Sessegnon,eng,DF,Hoffenheim,Bundesliga,20,2000,17.5,47,25,26,13,8,15,34,44.1,19,26,3,23,30,77,46
2398,Nils Seufert,de,MF,Arminia,Bundesliga,23,1997,3.8,12,9,2,5,5,2,8,25.0,6,3,1,2,5,17,6
2399,Edgar Sevikyan,am,MF,Levante,La Liga,18,2001,0.1,0,0,0,0,0,0,0,,0,0,0,0,0,0,0
2400,Stephan El Shaarawy,it,MF,Roma,it Serie A,27,1992,6.4,4,3,0,3,1,2,9,22.2,7,3,1,2,3,7,2
2401,Jamie Shackleton,eng,MF,Leeds United,Premier League,20,1999,5.1,10,6,6,4,0,4,11,36.4,7,3,1,2,9,19,3
2402,Xherdan Shaqiri,ch,MF,Liverpool,Premier League,28,1991,6.2,7,4,3,1,3,2,7,28.6,5,4,0,4,2,9,0
2403,Billy Sharp,eng,FW,Sheffield Utd,Premier League,34,1986,8.2,5,1,0,3,2,2,9,22.2,7,2,0,2,0,5,2
2404,Luke Shaw,eng,DF,Manchester Utd,Premier League,25,1995,29.5,44,28,21,16,7,21,36,58.3,15,34,9,25,20,64,44
2405,Jonjo Shelvey,eng,MF,Newcastle Utd,Premier League,28,1992,29.1,39,14,18,19,2,10,37,27.0,27,26,14,12,36,75,42
2406,Eldor Shomurodov,uz,FW,Genoa,it Serie A,25,1995,18.6,28,14,7,13,8,9,37,24.3,28,17,2,15,6,34,11
2407,Shola Shoretire,eng,FW,Manchester Utd,Premier League,16,2004,0.1,0,0,0,0,0,0,0,,0,0,0,0,0,0,0
2408,Mahame Siby,ml,MF,Strasbourg,Ligue 1,24,1996,0.2,0,0,0,0,0,0,1,0.0,1,0,0,0,0,0,1
2409,Abdoulaye Sidibé,fr,MF,Saint-Étienne,Ligue 1,18,2002,0.1,1,1,1,0,0,1,2,50.0,1,0,0,0,0,1,0
2410,Djibril Sidibé,fr,DF,Monaco,Ligue 1,28,1992,22.0,58,34,26,29,3,37,52,71.2,15,20,5,15,50,108,37
2411,Sidnei,br,DF,Betis,La Liga,30,1989,7.7,9,3,6,3,0,4,9,44.4,5,6,4,2,16,25,28
2412,Kaj Sierhuis,nl,FW,Reims,Ligue 1,22,1998,7.2,7,2,1,2,4,2,9,22.2,7,2,1,1,2,9,5
2413,Tim Siersleben,de,DF,Wolfsburg,Bundesliga,20,2000,0.4,2,2,2,0,0,1,1,100.0,0,1,0,1,0,2,0
2414,Gylfi Sigurðsson,is,MF,Everton,Premier League,30,1989,25.0,30,20,9,14,7,13,44,29.5,31,31,2,29,34,64,21
2415,Luca Siligardi,it,MF,Crotone,it Serie A,32,1988,0.5,4,2,0,3,1,1,5,20.0,4,0,0,0,0,4,0
2416,Luca Siligardi,it,FW,Parma,it Serie A,32,1988,0.4,0,0,0,0,0,0,2,0.0,2,0,0,0,0,0,0
2417,Adrien Silva,pt,MF,Sampdoria,it Serie A,31,1989,17.8,49,22,21,22,6,18,54,33.3,36,34,1,33,30,79,10
2418,André Silva,pt,FW,Eint Frankfurt,Bundesliga,24,1995,30.7,11,2,0,7,4,6,13,46.2,7,11,1,10,3,14,15
2419,Bernardo Silva,pt,MF,Manchester City,Premier League,25,1994,22.9,26,14,7,12,7,11,52,21.2,41,17,1,16,17,43,8
2420,Caio Henrique Oliveira Silva,br,DF,Monaco,Ligue 1,23,1997,26.3,50,34,25,20,5,31,51,60.8,20,20,3,17,16,66,37
2421,David Silva,es,MF,Real Sociedad,La Liga,34,1986,15.5,19,12,2,14,3,8,21,38.1,13,14,1,13,13,32,8
2422,Fábio Silva,pt,FW,Wolves,Premier League,18,2002,15.2,6,4,1,4,1,4,12,33.3,8,12,1,11,4,10,5
2423,Florent da Silva,fr,FW,Lyon,Ligue 1,17,2003,0.0,0,0,0,0,0,0,0,,0,0,0,0,0,0,0
2424,Gabriel Silva,br,DF,Saint-Étienne,Ligue 1,29,1991,3.9,7,6,7,0,0,1,2,50.0,1,4,1,3,6,13,8
2425,Gastón Silva,uy,DF,Huesca,La Liga,26,1994,6.7,16,12,11,5,0,8,14,57.1,6,10,4,6,11,27,16
2426,Rui Silva,pt,GK,Granada,La Liga,26,1994,32.0,1,0,1,0,0,1,3,33.3,2,0,0,0,2,3,14
2427,Thiago Silva,br,DF,Chelsea,Premier League,35,1984,21.5,20,12,11,8,1,14,21,66.7,7,21,13,8,33,53,86
2428,Marco Silvestri,it,GK,Hellas Verona,it Serie A,29,1991,34.0,0,0,0,0,0,0,0,,0,0,0,0,0,0,14
2429,Mohamed Simakan,fr,DF,Strasbourg,Ligue 1,20,2000,17.9,32,22,21,6,5,9,18,50.0,9,17,11,6,31,63,41
2430,Giovanni Simeone,ar,FW,Cagliari,it Serie A,25,1995,19.3,24,11,2,15,7,7,31,22.6,24,23,1,22,10,34,18
2431,Moses Simon,ng,FW,Nantes,Ligue 1,25,1995,25.8,27,14,11,9,7,17,36,47.2,19,24,1,23,15,42,15
2432,Unai Simón,es,GK,Athletic Club,La Liga,23,1997,37.0,1,0,1,0,0,1,2,50.0,1,0,0,0,0,1,7
2433,Xavi Simons,nl,MF,Paris S-G,Ligue 1,17,2003,0.0,0,0,0,0,0,0,0,,0,0,0,0,0,0,0
2434,Jóan Símun Edmundsson,fo,FW,Arminia,Bundesliga,29,1991,0.6,0,0,0,0,0,0,0,,0,1,0,1,1,1,0
2435,Wilfried Singo,ci,DF,Torino,it Serie A,19,2000,20.6,29,14,16,6,7,17,33,51.5,16,13,3,10,29,58,40
2436,Daley Sinkgraven,nl,DF,Leverkusen,Bundesliga,25,1995,17.4,32,17,13,16,3,18,35,51.4,17,22,5,17,23,55,23
2437,Dimitris Siovas,gr,DF,Huesca,La Liga,31,1988,34.1,46,24,34,10,2,20,30,66.7,10,38,17,21,62,108,125
2438,Tobias Sippel,de,GK,Gladbach,Bundesliga,32,1988,3.8,0,0,0,0,0,0,0,,0,0,0,0,1,1,4
2439,Salvatore Sirigu,it,GK,Torino,it Serie A,33,1987,32.0,1,0,1,0,0,1,2,50.0,1,0,0,0,0,1,6
2440,Issouf Sissokho,ml,MF,Bordeaux,Ligue 1,18,2002,0.9,6,4,4,2,0,3,6,50.0,3,2,0,2,1,7,0
2441,Ibrahima Sissoko,ml,MF,Strasbourg,Ligue 1,22,1997,28.7,68,48,25,35,8,28,68,41.2,40,22,5,17,48,116,44
2442,Moussa Sissoko,fr,MF,Tottenham,Premier League,30,1989,17.6,22,16,19,3,0,8,20,40.0,12,11,4,7,23,45,25
2443,Nelson Sissoko,fr,DF,Saint-Étienne,Ligue 1,23,1997,5.3,12,6,6,3,3,7,12,58.3,5,2,1,1,12,24,16
2444,Antonio Sivera,es,GK,Alavés,La Liga,23,1996,0.8,0,0,0,0,0,0,0,,0,0,0,0,0,0,0
2445,Jacques Siwe,fr,FW,Dijon,Ligue 1,19,2001,1.9,4,1,1,1,2,0,1,0.0,1,1,0,1,1,5,1
2446,Ellyes Skhiri,tn,MF,Köln,Bundesliga,25,1995,30.9,83,48,44,31,8,33,65,50.8,32,49,13,36,82,165,38
2447,Łukasz Skorupski,pl,GK,Bologna,it Serie A,29,1991,28.0,1,1,1,0,0,1,4,25.0,3,0,0,0,0,1,23
2448,Andreas Skov Olsen,dk,FW,Bologna,it Serie A,20,1999,13.1,19,10,11,4,4,11,21,52.4,10,15,0,15,3,22,25
2449,Robert Skov,dk,FW,Hoffenheim,Bundesliga,24,1996,12.9,19,10,9,7,3,7,16,43.8,9,9,2,7,15,34,10
2450,Milan Škriniar,sk,DF,Inter,it Serie A,25,1995,30.9,48,32,29,16,3,23,34,67.6,11,30,19,11,30,78,89
2451,Steven Skrzybski,de,FW,Schalke 04,Bundesliga,27,1992,4.7,5,4,0,5,0,1,7,14.3,6,13,1,12,5,10,1
2452,Petar Škuletić,rs,FW,Montpellier,Ligue 1,30,1990,2.6,3,2,1,2,0,0,5,0.0,5,4,2,2,0,3,4
2453,Islam Slimani,dz,FW,Leicester City,Premier League,32,1988,0.2,0,0,0,0,0,0,0,,0,0,0,0,0,0,0
2454,Islam Slimani,dz,FW,Lyon,Ligue 1,32,1988,6.4,7,5,3,1,3,3,12,25.0,9,4,1,3,1,8,6
2455,William Smallbone,ie,MF,Southampton,Premier League,20,2000,1.9,6,3,2,4,0,1,3,33.3,2,5,0,5,2,8,1
2456,Chris Smalling,eng,DF,Roma,it Serie A,30,1989,12.3,14,8,5,7,2,6,10,60.0,4,17,11,6,28,42,46
2457,Emile Smith Rowe,eng,MF,Arsenal,Premier League,20,2000,16.0,14,7,5,5,4,6,17,35.3,11,15,1,14,10,24,12
2458,Robert Snodgrass,sct,MF,West Brom,Premier League,32,1987,5.8,17,12,12,4,1,10,16,62.5,6,11,2,9,1,18,12
2459,Robert Snodgrass,sct,FW,West Ham,Premier League,32,1987,0.1,0,0,0,0,0,0,0,,0,0,0,0,0,0,0
2460,Cédric Soares,pt,DF,Arsenal,Premier League,28,1991,8.3,12,8,6,4,2,6,21,28.6,15,6,1,5,8,20,16
2461,Rafa Soares,pt,DF,Eibar,La Liga,25,1995,12.6,28,17,16,8,4,15,21,71.4,6,14,4,10,20,48,32
2462,Rubén Sobrino,es,MF,Valencia,La Liga,28,1992,0.5,1,1,1,0,0,0,1,0.0,1,0,0,0,0,1,1
2463,Rubén Sobrino,es,FW,Cádiz,La Liga,28,1992,12.4,29,13,8,16,5,8,18,44.4,10,19,0,19,15,44,11
2464,Simon Sohm,ch,MF,Parma,it Serie A,19,2001,10.0,18,12,11,6,1,11,26,42.3,15,8,0,8,5,23,7
2465,Augusto Solari,ar,MF,Celta Vigo,La Liga,28,1992,5.4,18,13,9,8,1,6,26,23.1,20,13,1,12,6,24,5
2466,Roberto Soldado,es,FW,Granada,La Liga,35,1985,16.0,7,4,1,4,2,2,11,18.2,9,8,0,8,4,11,13
2467,Carlos Soler,es,MF,Valencia,La Liga,23,1997,30.4,41,24,14,24,3,19,52,36.5,33,35,11,24,23,64,41
2468,Yann Sommer,ch,GK,Gladbach,Bundesliga,31,1988,30.1,1,1,1,0,0,1,1,100.0,0,0,0,0,2,3,9
2469,Son,es,DF,Levante,La Liga,26,1994,12.3,18,10,11,6,1,9,19,47.4,10,11,2,9,12,30,20
2470,Brandon Soppy,fr,DF,Rennes,Ligue 1,18,2002,6.2,21,15,16,5,0,10,16,62.5,6,3,0,3,6,27,12
2471,David Soria,es,GK,Getafe,La Liga,27,1993,28.0,2,2,2,0,0,1,3,33.3,2,0,0,0,1,3,12
2472,Roberto Soriano,it,MF,Bologna,it Serie A,29,1991,36.1,48,26,15,20,13,15,64,23.4,49,31,8,23,18,66,43
2473,Alberto Soro,es,FW,Granada,La Liga,21,1999,4.4,7,2,2,4,1,4,10,40.0,6,7,0,7,1,8,2
2474,Borna Sosa,hr,DF,Stuttgart,Bundesliga,22,1998,22.7,14,10,6,6,2,8,25,32.0,17,23,4,19,31,45,74
2475,Hugo Sotelo,es,MF,Celta Vigo,La Liga,16,2003,0.0,0,0,0,0,0,0,0,,0,0,0,0,0,0,0
2476,Florian Sotoca,fr,FW,Lens,Ligue 1,29,1990,26.8,31,20,3,20,8,6,22,27.3,16,27,0,27,9,40,24
2477,Riccardo Sottil,it,FW,Cagliari,it Serie A,21,1999,13.2,7,3,2,3,2,0,7,0.0,7,4,0,4,5,12,3
2478,Cheick Souaré,fr,MF,Marseille,Ligue 1,17,2002,0.1,0,0,0,0,0,0,0,,0,1,1,0,1,1,0
2479,Tomáš Souček,cz,MF,West Ham,Premier League,25,1995,38.0,78,41,37,36,5,28,77,36.4,49,43,18,25,62,140,107
2480,Rayan Souici,fr,DF,Saint-Étienne,Ligue 1,22,1998,0.1,0,0,0,0,0,0,0,,0,0,0,0,0,0,0
2481,Cebio Soukou,bj,FW,Arminia,Bundesliga,27,1992,5.1,12,8,5,5,2,6,11,54.5,5,3,0,3,3,15,4
2482,Adama Soumaoro,fr,DF,Bologna,it Serie A,28,1992,19.5,24,14,17,7,0,6,12,50.0,6,28,23,5,20,44,72
2483,Adama Soumaoro,fr,DF,Lille,Ligue 1,28,1992,1.6,1,0,0,0,1,0,0,,0,1,1,0,2,3,2
2484,Boubakary Soumaré,fr,MF,Lille,Ligue 1,21,1999,21.3,44,29,16,25,3,14,29,48.3,15,14,6,8,39,83,21
2485,Yaya Soumaré,fr,FW,Lyon,Ligue 1,20,2000,0.0,1,1,1,0,0,1,2,50.0,1,0,0,0,2,3,0
2486,Arnaud Souquet,fr,DF,Montpellier,Ligue 1,28,1992,13.6,50,33,35,13,2,27,48,56.3,21,15,6,9,17,67,34
2487,Ansou Sow,sn,MF,Lens,Ligue 1,20,2000,0.1,0,0,0,0,0,0,0,,0,1,0,1,0,0,0
2488,Djibril Sow,ch,MF,Eint Frankfurt,Bundesliga,23,1997,24.2,58,33,19,32,7,18,41,43.9,23,31,8,23,51,109,17
2489,Saidou Sow,gn,DF,Saint-Étienne,Ligue 1,18,2002,11.1,23,12,17,6,0,13,19,68.4,6,12,8,4,14,37,39
2490,Çağlar Söyüncü,tr,DF,Leicester City,Premier League,24,1996,20.2,27,17,13,14,0,17,30,56.7,13,12,9,3,28,55,80
2491,Leonardo Spinazzola,it,DF,Roma,it Serie A,27,1993,23.6,12,6,3,9,0,8,20,40.0,12,16,1,15,25,37,31
2492,Marco Sportiello,it,GK,Atalanta,it Serie A,28,1992,14.0,2,2,2,0,0,1,3,33.3,2,0,0,0,2,4,5
2493,Mattia Sprocati,it,MF,Parma,it Serie A,27,1993,0.2,1,0,0,1,0,1,1,100.0,0,0,0,0,1,2,0
2494,Jerry St. Juste,nl,DF,Mainz 05,Bundesliga,23,1996,32.0,65,38,37,26,2,20,36,55.6,16,46,27,19,64,129,82
2495,Benjamin Stambouli,fr,DF,Schalke 04,Bundesliga,29,1990,21.7,45,29,24,18,3,15,37,40.5,22,42,14,28,49,94,45
2496,Josip Stanišić,hr,DF,Bayern Munich,Bundesliga,20,2000,1.0,2,2,1,1,0,1,1,100.0,0,3,0,3,2,4,2
2497,Niklas Stark,de,DF,Hertha BSC,Bundesliga,25,1995,31.0,49,28,20,27,2,13,31,41.9,18,43,16,27,42,91,101
2498,Renato Steffen,ch,FW,Wolfsburg,Bundesliga,28,1991,17.4,24,15,6,12,6,13,24,54.2,11,21,2,19,22,46,15
2499,Zack Steffen,us,GK,Manchester City,Premier League,25,1995,1.0,0,0,0,0,0,0,0,,0,0,0,0,0,0,0
2500,Pascal Stenzel,de,DF,Stuttgart,Bundesliga,24,1996,14.2,33,14,15,17,1,22,50,44.0,28,19,4,15,26,59,39
2501,Dale Stephens,eng,MF,Burnley,Premier League,31,1989,2.9,11,6,2,7,2,3,6,50.0,3,3,0,3,8,19,2
2502,Jack Stephens,eng,DF,Southampton,Premier League,26,1994,17.1,34,19,19,15,0,17,38,44.7,21,25,14,11,28,62,64
2503,Raheem Sterling,eng,FW,Manchester City,Premier League,25,1994,28.2,21,10,5,12,4,5,12,41.7,7,15,0,15,15,36,4
2504,Enda Stevens,ie,DF,Sheffield Utd,Premier League,30,1990,30.0,59,26,32,19,8,33,58,56.9,25,41,12,29,22,81,81
2505,Lars Stindl,de,MF,Gladbach,Bundesliga,31,1988,21.8,24,17,3,16,5,7,32,21.9,25,26,3,23,13,37,14
2506,Kevin Stöger,at,MF,Mainz 05,Bundesliga,26,1993,6.0,12,6,2,9,1,5,16,31.3,11,5,0,5,6,18,4
2507,John Stones,eng,DF,Manchester City,Premier League,26,1994,21.5,21,10,13,5,3,9,14,64.3,5,23,15,8,18,39,56
2508,Thomas Strakosha,al,GK,Lazio,it Serie A,25,1995,9.0,1,1,1,0,0,0,0,,0,0,0,0,1,2,4
2509,Tobias Strobl,de,MF,Augsburg,Bundesliga,30,1990,20.5,21,10,12,9,0,10,30,33.3,20,21,8,13,28,49,27
2510,Kevin Strootman,nl,MF,Genoa,it Serie A,30,1990,14.6,30,18,13,15,2,14,32,43.8,18,35,3,32,25,55,18
2511,Kevin Strootman,nl,MF,Marseille,Ligue 1,30,1990,2.6,9,6,5,4,0,4,8,50.0,4,5,2,3,5,14,7
2512,Pascal Struijk,nl,DF,Leeds United,Premier League,20,1999,23.1,49,30,28,19,2,17,28,60.7,11,35,21,14,47,96,92
2513,Jens Stryger Larsen,dk,DF,Udinese,it Serie A,29,1991,29.3,17,11,14,3,0,8,25,32.0,17,26,11,15,24,41,65
2514,Stefano Sturaro,it,MF,Hellas Verona,it Serie A,27,1993,4.7,4,3,3,0,1,2,8,25.0,6,5,1,4,5,9,10
2515,Stefano Sturaro,it,MF,Genoa,it Serie A,27,1993,4.9,11,5,3,6,2,3,15,20.0,12,5,0,5,7,18,2
2516,Damián Suárez,uy,DF,Getafe,La Liga,32,1988,27.0,59,39,29,23,7,30,81,37.0,51,43,2,41,31,90,42
2517,Denis Suárez,es,MF,Celta Vigo,La Liga,26,1994,31.7,64,32,22,30,12,21,94,22.3,73,30,2,28,22,86,15
2518,Luis Suárez,uy,FW,Atlético Madrid,La Liga,33,1987,27.9,11,7,0,4,7,3,12,25.0,9,7,0,7,5,16,13
2519,Marek Suchý,cz,DF,Augsburg,Bundesliga,32,1988,3.4,4,2,1,3,0,1,2,50.0,1,3,3,0,4,8,9
2520,Niklas Süle,de,DF,Bayern Munich,Bundesliga,24,1995,16.7,32,21,15,14,3,13,21,61.9,8,24,12,12,21,53,36
2521,Suso,es,FW,Sevilla,La Liga,26,1993,24.6,20,10,8,6,6,10,41,24.4,31,12,0,12,8,28,8
2522,Bosko Sutalo,hr,DF,Atalanta,it Serie A,20,2000,2.6,5,5,0,3,2,4,5,80.0,1,2,1,1,2,7,7
2523,Mattias Svanberg,se,MF,Bologna,it Serie A,21,1999,20.6,38,17,21,9,8,16,45,35.6,29,25,4,21,30,68,25
2524,Abdoulaye Sylla,gn,DF,Nantes,Ligue 1,20,2000,0.1,2,1,2,0,0,1,1,100.0,0,1,0,1,0,2,1
2525,Issiaga Sylla,gn,DF,Lens,Ligue 1,26,1994,12.4,28,20,11,17,0,11,21,52.4,10,13,3,10,16,44,21
2526,Eddy Sylvestre,fr,FW,Nice,Ligue 1,20,1999,1.1,1,1,1,0,0,0,1,0.0,1,1,0,1,1,2,0
2527,Ádám Szalai,hu,FW,Mainz 05,Bundesliga,32,1987,8.1,7,6,3,2,2,2,8,25.0,6,4,1,3,2,9,4
2528,Wojciech Szczęsny,pl,GK,Juventus,it Serie A,30,1990,29.7,0,0,0,0,0,0,0,,0,2,0,2,3,3,5
2529,Frederik Sørensen,dk,DF,Köln,Bundesliga,28,1992,1.1,2,1,0,2,0,1,1,100.0,0,2,0,2,0,2,0
2530,Alexander Sørloth,no,FW,RB Leipzig,Bundesliga,24,1995,16.0,7,5,0,5,2,2,14,14.3,12,13,2,11,3,10,13
2531,Tachi,es,DF,Alavés,La Liga,22,1997,9.4,11,9,9,2,0,6,14,42.9,8,9,6,3,11,22,32
2532,Jonathan Tah,de,DF,Leverkusen,Bundesliga,24,1996,24.7,30,17,19,9,2,11,21,52.4,10,19,12,7,33,63,89
2533,Waniss Taibi,fr,MF,Angers,Ligue 1,18,2002,0.4,0,0,0,0,0,0,2,0.0,2,1,0,1,0,0,0
2534,Flavien Tait,fr,MF,Rennes,Ligue 1,27,1993,15.2,26,11,11,12,3,10,32,31.3,22,17,3,14,13,39,2
2535,Adrien Tameze,cm,MF,Hellas Verona,it Serie A,26,1994,25.6,39,25,23,15,1,11,27,40.7,16,31,8,23,32,71,46
2536,Japhet Tanganga,eng,DF,Tottenham,Premier League,21,1999,5.4,5,4,3,2,0,1,3,33.3,2,6,5,1,3,8,15
2537,Renato Tapia,pe,MF,Celta Vigo,La Liga,25,1995,30.0,93,44,50,34,9,32,83,38.6,51,56,13,43,53,146,75
2538,Edmond Tapsoba,bf,DF,Leverkusen,Bundesliga,21,1999,29.5,54,28,35,18,1,21,45,46.7,24,55,29,26,48,102,96
2539,Matt Targett,eng,DF,Aston Villa,Premier League,24,1995,37.8,83,39,52,20,11,56,88,63.6,32,40,14,26,55,138,102
2540,James Tarkowski,eng,DF,Burnley,Premier League,27,1992,36.0,66,39,52,11,3,25,49,51.0,24,54,42,12,44,110,163
2541,Ciprian Tătărușanu,ro,GK,Milan,it Serie A,34,1986,1.0,0,0,0,0,0,0,0,,0,0,0,0,0,0,0
2542,Percy Tau,za,FW,Brighton,Premier League,26,1994,1.1,1,1,1,0,0,0,2,0.0,2,1,0,1,0,1,1
2543,Niklas Tauer,de,MF,Mainz 05,Bundesliga,19,2001,0.8,1,1,0,1,0,1,2,50.0,1,3,1,2,3,4,1
2544,Heriberto Tavares,pt,FW,Brest,Ligue 1,23,1997,0.5,2,0,0,0,2,1,3,33.3,2,0,0,0,1,3,1
2545,Sidnei Tavares,pt,MF,Leicester City,Premier League,18,2001,0.9,1,1,0,1,0,0,0,,0,1,1,0,0,1,0
2546,Tomás Tavares,pt,MF,Alavés,La Liga,19,2001,0.7,2,1,2,0,0,2,2,100.0,0,1,0,1,0,2,1
2547,Charlie Taylor,eng,DF,Burnley,Premier League,26,1993,27.0,48,28,30,15,3,25,46,54.3,21,36,19,17,29,77,87
2548,Neil Taylor,wls,DF,Aston Villa,Premier League,31,1989,0.2,1,1,1,0,0,0,0,,0,1,0,1,0,1,0
2549,Allan Tchaptchet,fr,DF,Southampton,Premier League,18,2001,0.1,0,0,0,0,0,0,0,,0,0,0,0,0,0,0
2550,Warren Tchimbembé,cg,MF,Metz,Ligue 1,22,1998,5.5,7,4,4,3,0,3,9,33.3,6,6,1,5,2,9,3
2551,Aurélien Tchouaméni,fr,MF,Monaco,Ligue 1,20,2000,34.0,127,68,47,62,18,48,92,52.2,44,39,11,28,60,187,47
2552,Álvaro Tejero,es,DF,Eibar,La Liga,24,1996,1.2,1,1,0,0,1,1,3,33.3,2,1,0,1,3,4,6
2553,Nathan Tella,ng,FW,Southampton,Premier League,21,1999,8.3,8,5,1,4,3,6,15,40.0,9,13,0,13,3,11,2
2554,Alex Telles,br,DF,Manchester Utd,Premier League,27,1992,7.7,14,7,10,3,1,8,17,47.1,9,7,2,5,16,30,20
2555,Andrés Tello,co,DF,Benevento,it Serie A,23,1996,4.6,9,6,8,0,1,5,20,25.0,15,8,1,7,6,15,6
2556,Cristian Tello,es,FW,Betis,La Liga,28,1991,14.3,16,10,5,9,2,4,22,18.2,18,14,0,14,11,27,8
2557,Lino Tempelmann,de,MF,Freiburg,Bundesliga,21,1999,3.0,5,3,2,2,1,0,4,0.0,4,6,1,5,2,7,6
2558,Hidde ter Avest,nl,DF,Udinese,it Serie A,23,1997,3.9,5,2,3,2,0,2,5,40.0,3,3,1,2,2,7,5
2559,Marc-André ter Stegen,de,GK,Barcelona,La Liga,28,1992,31.0,0,0,0,0,0,0,2,0.0,2,0,0,0,0,0,12
2560,Pietro Terracciano,it,GK,Fiorentina,it Serie A,30,1990,3.0,0,0,0,0,0,0,0,,0,0,0,0,0,0,1
2561,Martin Terrier,fr,FW,Rennes,Ligue 1,23,1997,27.1,33,15,5,15,13,10,36,27.8,26,23,0,23,16,49,7
2562,Claudio Terzi,it,DF,Spezia,it Serie A,36,1984,20.8,34,21,19,14,1,19,28,67.9,9,23,12,11,35,69,55
2563,Kenny Tete,nl,DF,Fulham,Premier League,24,1995,16.5,48,30,27,16,5,10,18,55.6,8,14,5,9,27,75,49
2564,Kenny Tete,nl,DF,Lyon,Ligue 1,24,1995,0.2,2,0,1,1,0,0,0,,0,0,0,0,2,4,0
2565,Cedric Teuchert,de,FW,Union Berlin,Bundesliga,23,1997,8.4,7,5,2,4,1,3,16,18.8,13,12,0,12,5,12,6
2566,Florian Thauvin,fr,FW,Marseille,Ligue 1,27,1993,30.4,40,22,14,21,5,20,54,37.0,34,26,2,24,14,54,11
2567,Malick Thiaw,de,DF,Schalke 04,Bundesliga,18,2001,16.1,42,27,24,17,1,15,26,57.7,11,17,12,5,33,75,70
2568,Jan Thielmann,de,FW,Köln,Bundesliga,18,2002,11.4,11,6,1,8,2,5,9,55.6,4,10,1,9,9,20,2
2569,Sada Thioub,sn,FW,Angers,Ligue 1,25,1995,14.0,17,14,7,6,4,7,23,30.4,16,10,0,10,9,26,3
2570,Luke Thomas,eng,DF,Leicester City,Premier League,19,2001,10.8,23,14,11,5,7,14,21,66.7,7,15,2,13,17,40,21
2571,Romain Thomas,fr,DF,Angers,Ligue 1,32,1988,33.6,47,25,34,11,2,20,35,57.1,15,35,20,15,50,97,138
2572,Adrien Thomasson,fr,MF,Strasbourg,Ligue 1,26,1993,29.2,36,17,8,16,12,12,58,20.7,46,44,5,39,22,58,2
2573,Erik Thommy,de,MF,Stuttgart,Bundesliga,25,1994,3.5,3,1,0,3,0,0,3,0.0,3,3,0,3,3,6,4
2574,Morten Thorsby,no,MF,Sampdoria,it Serie A,24,1996,29.4,76,42,32,36,8,20,60,33.3,40,51,16,35,25,101,30
2575,Khéphren Thuram,fr,MF,Nice,Ligue 1,19,2001,16.6,32,16,5,21,6,9,27,33.3,18,21,9,12,18,50,22
2576,Marcus Thuram,fr,FW,Gladbach,Bundesliga,22,1997,19.2,24,14,9,10,5,10,23,43.5,13,27,4,23,15,39,13
2577,Cheikh Tidiane Sabaly,sn,FW,Metz,Ligue 1,21,1999,0.1,0,0,0,0,0,0,0,,0,0,0,0,0,0,0
2578,Youri Tielemans,be,MF,Leicester City,Premier League,23,1997,37.3,86,45,32,38,16,45,108,41.7,63,35,8,27,46,132,20
2579,Kieran Tierney,sct,DF,Arsenal,Premier League,23,1997,25.5,27,15,5,14,8,11,31,35.5,20,31,10,21,16,43,63
2580,Steffen Tigges,de,FW,Dortmund,Bundesliga,22,1998,0.6,4,4,0,1,3,2,3,66.7,1,1,0,1,0,4,1
2581,Guus Til,nl,FW,Freiburg,Bundesliga,22,1997,1.4,4,3,2,1,1,2,3,66.7,1,2,0,2,2,6,2
2582,David Timor,es,MF,Getafe,La Liga,30,1989,15.5,13,9,5,6,2,9,21,42.9,12,5,1,4,19,32,32
2583,Jean-Clair Todibo,fr,DF,Nice,Ligue 1,20,1999,14.8,25,15,16,9,0,16,31,51.6,15,13,7,6,19,44,48
2584,Karl Toko Ekambi,cm,FW,Lyon,Ligue 1,27,1992,31.2,16,10,5,3,8,8,32,25.0,24,20,1,19,26,42,8
2585,Corentin Tolisso,fr,MF,Bayern Munich,Bundesliga,25,1994,8.7,19,19,4,11,4,9,29,31.0,20,15,2,13,6,25,8
2586,Jeremy Toljan,de,DF,Sassuolo,it Serie A,25,1994,16.6,21,12,16,3,2,12,27,44.4,15,15,7,8,13,34,28
2587,Rafael Tolói,it,DF,Atalanta,it Serie A,29,1990,28.2,51,23,21,26,4,26,48,54.2,22,37,7,30,33,84,66
2588,Takehiro Tomiyasu,jp,DF,Bologna,it Serie A,21,1998,30.2,47,31,27,14,6,21,34,61.8,13,37,19,18,54,101,106
2589,James Tomkins,eng,DF,Crystal Palace,Premier League,31,1989,6.1,4,2,4,0,0,3,4,75.0,1,4,3,1,4,8,45
2590,Fikayo Tomori,eng,DF,Chelsea,Premier League,22,1997,0.5,2,1,2,0,0,0,0,,0,1,1,0,2,4,8
2591,Fikayo Tomori,eng,DF,Milan,it Serie A,22,1997,16.3,28,18,17,9,2,8,14,57.1,6,32,20,12,18,46,61
2592,Sandro Tonali,it,MF,Milan,it Serie A,20,2000,14.8,28,19,14,13,1,13,28,46.4,15,18,5,13,22,50,18
2593,Lorenzo Tonelli,it,DF,Sampdoria,it Serie A,30,1990,19.8,33,18,20,11,2,10,21,47.6,11,21,14,7,25,58,94
2594,Toño,es,DF,Levante,La Liga,30,1989,8.1,4,0,4,0,0,0,2,0.0,2,10,1,9,7,11,12
2595,Ömer Toprak,tr,DF,Werder Bremen,Bundesliga,31,1989,21.6,23,16,15,6,2,12,24,50.0,12,27,16,11,36,59,115
2596,Tyron Tormin,fr,FW,Saint-Étienne,Ligue 1,19,2001,0.2,0,0,0,0,0,0,0,,0,0,0,0,0,0,0
2597,Ernesto Torregrossa,ve,FW,Sampdoria,it Serie A,28,1992,1.9,1,1,0,0,1,0,2,0.0,2,4,0,4,1,2,1
2598,Lucas Torreira,uy,MF,Atlético Madrid,La Liga,24,1996,5.8,8,4,2,3,3,0,3,0.0,3,5,3,2,12,20,8
2599,Ferrán Torres,es,FW,Manchester City,Premier League,20,2000,14.5,12,5,4,6,2,5,16,31.3,11,16,0,16,3,15,8
2600,Óliver Torres,es,MF,Sevilla,La Liga,25,1994,15.6,34,22,13,15,6,19,53,35.8,34,15,0,15,15,49,9
2601,Pau Torres,es,DF,Villarreal,La Liga,23,1997,33.0,17,11,10,5,2,11,18,61.1,7,33,25,8,23,40,111
2602,Roberto Torres,es,MF,Osasuna,La Liga,31,1989,21.0,15,8,6,5,4,8,29,27.6,21,12,0,12,16,31,13
2603,Lucas Torró,es,MF,Osasuna,La Liga,26,1994,17.2,32,15,11,19,2,21,34,61.8,13,16,7,9,27,59,43
2604,Jordan Torunarigha,de,DF,Hertha BSC,Bundesliga,22,1997,10.8,7,4,7,0,0,5,8,62.5,3,8,2,6,15,22,54
2605,Cenk Tosun,tr,FW,Everton,Premier League,29,1991,0.5,0,0,0,0,0,0,1,0.0,1,0,0,0,0,0,0
2606,Abdoulaye Touré,gn,MF,Nantes,Ligue 1,26,1994,18.7,28,12,10,16,2,14,31,45.2,17,17,2,15,22,50,19
2607,Almamy Touré,ml,DF,Eint Frankfurt,Bundesliga,24,1996,7.8,18,12,8,7,3,10,14,71.4,4,5,1,4,8,26,22
2608,Lucas Tousart,fr,MF,Hertha BSC,Bundesliga,23,1997,23.2,33,18,16,15,2,13,27,48.1,14,33,6,27,40,73,52
2609,Andros Townsend,eng,MF,Crystal Palace,Premier League,29,1991,25.1,78,41,45,20,13,30,79,38.0,49,48,2,46,41,119,19
2610,Conor Townsend,eng,DF,West Brom,Premier League,27,1993,24.8,44,28,32,9,3,30,49,61.2,19,38,15,23,36,80,55
2611,Mattéo Tramoni,fr,MF,Cagliari,it Serie A,20,2000,0.8,4,2,2,1,1,1,2,50.0,1,5,0,5,1,5,2
2612,Adama Traoré,es,FW,Wolves,Premier League,24,1996,29.4,28,16,11,13,4,13,21,61.9,8,23,1,22,7,35,12
2613,Amadou Traore,fr,FW,Bordeaux,Ligue 1,18,2002,3.4,6,1,2,2,2,2,9,22.2,7,9,0,9,1,7,2
2614,Bertrand Traoré,bf,FW,Aston Villa,Premier League,24,1995,25.7,26,10,8,10,8,10,34,29.4,24,23,1,22,15,41,14
2615,Boubacar Traoré,ml,MF,Metz,Ligue 1,18,2001,0.6,3,2,1,2,0,1,1,100.0,0,1,0,1,0,3,0
2616,Chaka Traorè,ci,FW,Parma,it Serie A,15,2004,0.2,0,0,0,0,0,0,0,,0,0,0,0,0,0,1
2617,Charles Traore,ml,DF,Nantes,Ligue 1,28,1992,18.9,53,34,30,17,6,27,54,50.0,27,26,5,21,36,89,65
2618,Cheick Traoré,ml,DF,Lens,Ligue 1,25,1995,0.4,2,2,1,1,0,2,4,50.0,2,1,0,1,2,4,1
2619,Hamari Traoré,ml,DF,Rennes,Ligue 1,28,1992,33.3,56,38,23,27,6,22,59,37.3,37,31,5,26,76,132,50
2620,Ibrahima Traoré,gn,FW,Gladbach,Bundesliga,32,1988,1.1,4,1,1,2,1,0,0,,0,2,0,2,0,4,0
2621,Ismaël Traoré,ci,DF,Angers,Ligue 1,33,1986,33.3,32,14,23,9,0,20,37,54.1,17,27,13,14,40,72,107
2622,Kevin Trapp,de,GK,Eint Frankfurt,Bundesliga,30,1990,33.0,0,0,0,0,0,0,1,0.0,1,1,0,1,3,3,11
2623,Miguel Trauco,pe,DF,Saint-Étienne,Ligue 1,27,1992,22.6,47,29,25,14,8,23,43,53.5,20,19,4,15,30,77,34
2624,Trézéguet,eg,FW,Aston Villa,Premier League,25,1994,13.0,33,18,14,15,4,13,45,28.9,32,13,1,12,19,52,17
2625,Manu Trigueros,es,MF,Villarreal,La Liga,28,1991,28.1,51,30,25,21,5,21,77,27.3,56,32,2,30,17,68,19
2626,Christopher Trimmel,at,DF,Union Berlin,Bundesliga,33,1987,28.6,50,25,28,18,4,28,54,51.9,26,32,7,25,50,100,99
2627,Francisco Trincão,pt,FW,Barcelona,La Liga,20,1999,7.8,4,2,0,3,1,2,5,40.0,3,4,0,4,1,5,2
2628,Alessandro Tripaldelli,it,DF,Cagliari,it Serie A,21,1999,3.3,13,6,5,6,2,5,6,83.3,1,6,1,5,3,16,15
2629,Kieran Trippier,eng,DF,Atlético Madrid,La Liga,29,1990,27.5,61,39,30,25,6,26,52,50.0,26,22,4,18,40,101,58
2630,Leandro Trossard,be,MF,Brighton,Premier League,25,1994,29.0,33,14,11,16,6,10,36,27.8,26,34,2,32,26,59,7
2631,Alexis Trouillet,fr,MF,Nice,Ligue 1,19,2000,1.2,5,4,1,4,0,4,5,80.0,1,0,0,0,3,8,0
2632,Adrien Truffert,fr,DF,Rennes,Ligue 1,18,2001,21.7,38,18,18,12,8,13,24,54.2,11,26,5,21,18,56,38
2633,Marvin Tshibuabua,fr,DF,Saint-Étienne,Ligue 1,18,2002,0.5,1,0,1,0,0,0,0,,0,0,0,0,1,2,1
2634,Kostas Tsimikas,gr,DF,Liverpool,Premier League,24,1996,0.1,0,0,0,0,0,0,0,,0,0,0,0,0,0,0
2635,Axel Tuanzebe,cd,DF,Manchester Utd,Premier League,22,1997,4.5,13,7,5,7,1,8,9,88.9,1,7,5,2,3,16,18
2636,Alessandro Tuia,it,DF,Benevento,it Serie A,30,1990,19.6,39,17,34,4,1,15,25,60.0,10,22,10,12,36,75,91
2637,Ľubomír Tupta,sk,FW,Hellas Verona,it Serie A,22,1998,0.6,0,0,0,0,0,0,0,,0,0,0,0,0,0,0
2638,Tuta,br,DF,Eint Frankfurt,Bundesliga,21,1999,16.2,35,20,22,13,0,24,43,55.8,19,19,2,17,29,64,53
2639,Destiny Udogie,it,DF,Hellas Verona,it Serie A,17,2002,1.9,6,4,2,2,2,2,2,100.0,0,3,0,3,2,8,4
2640,Matthieu Udol,fr,DF,Metz,Ligue 1,24,1996,19.2,34,21,18,12,4,17,39,43.6,22,25,5,20,39,73,30
2641,Naomichi Ueda,jp,DF,Nîmes,Ligue 1,25,1994,7.9,4,2,3,1,0,4,6,66.7,2,5,4,1,6,10,30
2642,Lesley Ugochukwu,fr,MF,Rennes,Ligue 1,16,2004,0.7,3,1,0,3,0,2,3,66.7,1,1,0,1,0,3,0
2643,Hwang Ui-jo,kr,FW,Bordeaux,Ligue 1,27,1992,27.8,14,6,5,8,1,6,25,24.0,19,17,2,15,8,22,14
2644,Samir Ujkani,xk,GK,Torino,it Serie A,32,1988,1.0,0,0,0,0,0,0,0,,0,0,0,0,0,0,1
2645,Samuel Umtiti,fr,DF,Barcelona,La Liga,26,1993,7.2,5,1,3,2,0,1,2,50.0,1,11,6,5,9,14,15
2646,Enes Ünal,tr,FW,Getafe,La Liga,23,1997,14.6,11,3,0,8,3,4,15,26.7,11,11,0,11,2,13,14
2647,Cengiz Ünder,tr,FW,Leicester City,Premier League,23,1997,3.1,4,1,0,3,1,3,5,60.0,2,3,0,3,2,6,0
2648,Dayot Upamecano,fr,DF,RB Leipzig,Bundesliga,21,1998,25.9,37,30,18,19,0,14,20,70.0,6,25,14,11,33,70,74
2649,Kacper Urbanski,pl,FW,Bologna,it Serie A,15,2004,0.0,0,0,0,0,0,0,0,,0,0,0,0,0,0,0
2650,Mark Uth,de,FW,Schalke 04,Bundesliga,28,1991,16.6,25,13,13,10,2,5,23,21.7,18,21,0,21,5,30,10
2651,Tomáš Vaclík,cz,GK,Sevilla,La Liga,31,1989,5.0,0,0,0,0,0,0,1,0.0,1,0,0,0,0,0,0
2652,Eugeni Valderrama,es,MF,Huesca,La Liga,26,1994,1.3,2,2,1,0,1,0,1,0.0,1,0,0,0,5,7,3
2653,Lautaro Valenti,ar,DF,Parma,it Serie A,21,1999,5.5,10,4,7,2,1,6,15,40.0,9,11,3,8,11,21,30
2654,Antoine Valerio,fr,MF,Nîmes,Ligue 1,20,1999,0.8,0,0,0,0,0,0,1,0.0,1,1,0,1,2,2,0
2655,Borja Valero,es,MF,Fiorentina,it Serie A,35,1985,5.5,13,9,7,4,2,3,15,20.0,12,6,1,5,6,19,2
2656,Yan Valery,tn,DF,Southampton,Premier League,21,1999,1.1,5,3,2,3,0,1,5,20.0,4,2,0,2,2,7,5
2657,Jesús Vallejo,es,DF,Granada,La Liga,23,1997,15.0,11,6,7,3,1,7,18,38.9,11,21,11,10,13,24,55
2658,Manu Vallejo,es,FW,Valencia,La Liga,23,1997,10.6,18,8,5,8,5,5,26,19.2,21,8,0,8,3,21,3
2659,Federico Valverde,uy,MF,Real Madrid,La Liga,22,1998,14.8,25,16,9,8,8,10,26,38.5,16,16,2,14,22,47,4
2660,Virgil van Dijk,nl,DF,Liverpool,Premier League,29,1991,4.1,3,2,1,2,0,0,0,,0,1,1,0,5,8,8
2661,Raphaël Varane,fr,DF,Real Madrid,La Liga,27,1993,30.2,22,14,16,5,1,10,19,52.6,9,26,18,8,36,58,114
2662,Jamie Vardy,eng,FW,Leicester City,Premier League,33,1987,31.6,18,12,1,8,9,2,15,13.3,13,14,5,9,4,22,32
2663,Ruben Vargas,ch,MF,Augsburg,Bundesliga,21,1998,17.9,18,12,6,9,3,1,16,6.3,15,26,2,24,18,36,27
2664,Denis Vavro,sk,DF,Lazio,it Serie A,24,1996,0.4,0,0,0,0,0,0,1,0.0,1,0,0,0,1,1,3
2665,Denis Vavro,sk,DF,Huesca,La Liga,24,1996,6.8,7,4,2,4,1,2,5,40.0,3,2,0,2,11,18,21
2666,Franco Vázquez,ar,FW,Sevilla,La Liga,31,1989,1.8,5,1,0,3,2,1,5,20.0,4,2,1,1,1,6,1
2667,Kevin Vázquez,es,DF,Celta Vigo,La Liga,27,1993,6.2,11,5,9,2,0,3,9,33.3,6,8,0,8,9,20,18
2668,Lucas Vázquez,es,DF,Real Madrid,La Liga,29,1991,20.5,61,37,30,22,9,22,52,42.3,30,14,1,13,19,80,31
2669,Matías Vecino,uy,MF,Inter,it Serie A,28,1991,3.1,1,1,0,0,1,0,5,0.0,5,7,1,6,4,5,3
2670,Koke Vegas,es,GK,Levante,La Liga,24,1995,1.0,0,0,0,0,0,0,0,,0,0,0,0,0,0,1
2671,Gabriel Veiga,es,MF,Celta Vigo,La Liga,18,2002,1.3,3,0,3,0,0,1,4,25.0,3,3,0,3,3,6,0
2672,Miloš Veljković,rs,DF,Werder Bremen,Bundesliga,24,1995,19.1,24,14,17,6,1,15,31,48.4,16,22,9,13,29,53,94
2673,Miguel Veloso,pt,MF,Hellas Verona,it Serie A,34,1986,14.6,24,17,10,10,4,12,34,35.3,22,12,1,11,12,36,25
2674,Joël Veltman,nl,DF,Brighton,Premier League,28,1992,25.3,67,33,34,25,8,29,57,50.9,28,24,5,19,33,100,64
2675,Unai Vencedor Paris,es,MF,Athletic Club,La Liga,19,2000,18.9,31,21,10,15,6,11,42,26.2,31,17,6,11,18,49,14
2676,Lorenzo Venuti,it,DF,Fiorentina,it Serie A,25,1995,19.5,24,11,14,7,3,14,28,50.0,14,18,3,15,17,41,24
2677,Daniele Verde,it,FW,Spezia,it Serie A,24,1996,10.9,5,4,2,2,1,4,10,40.0,6,5,0,5,9,14,7
2678,Simone Verdi,it,MF,Torino,it Serie A,28,1992,18.0,19,12,10,6,3,6,19,31.6,13,8,0,8,8,27,2
2679,Gonzalo Verdú,es,DF,Elche,La Liga,31,1988,32.7,34,19,26,8,0,16,28,57.1,12,40,30,10,52,86,113
2680,Jordan Veretout,fr,MF,Roma,it Serie A,27,1993,22.8,20,12,8,12,0,9,33,27.3,24,14,3,11,14,34,21
2681,Edoardo Vergani,it,FW,Bologna,it Serie A,19,2001,0.1,0,0,0,0,0,0,0,,0,0,0,0,0,0,0
2682,Marco Verratti,it,MF,Paris S-G,Ligue 1,27,1992,16.6,53,30,17,25,11,24,72,33.3,48,22,5,17,26,79,4
2683,Valerio Verre,it,FW,Sampdoria,it Serie A,26,1994,11.1,11,7,2,7,2,4,19,21.1,15,14,2,12,9,20,3
2684,Mikel Vesga,es,MF,Athletic Club,La Liga,27,1993,19.1,28,14,8,16,4,12,50,24.0,38,28,8,20,27,55,35
2685,Jannik Vestergaard,dk,DF,Southampton,Premier League,27,1992,28.6,50,31,31,15,4,35,52,67.3,17,29,16,13,42,92,122
2686,Rúben Vezo,pt,DF,Levante,La Liga,26,1994,25.7,34,19,26,7,1,12,29,41.4,17,22,11,11,46,80,106
2687,Guglielmo Vicario,it,GK,Cagliari,it Serie A,23,1996,4.0,0,0,0,0,0,0,0,,0,0,0,0,0,0,1
2688,Iñigo Vicente,es,FW,Athletic Club,La Liga,22,1998,0.6,1,1,1,0,0,1,1,100.0,0,0,0,0,0,1,0
2689,Fede Vico,es,MF,Granada,La Liga,26,1994,8.5,10,6,5,5,0,3,10,30.0,7,15,1,14,12,22,5
2690,Aleix Vidal,es,DF,Sevilla,La Liga,30,1989,6.6,9,5,5,3,1,5,12,41.7,7,10,1,9,12,21,9
2691,Arturo Vidal,cl,MF,Inter,it Serie A,33,1987,12.6,27,14,8,13,6,12,41,29.3,29,23,3,20,29,56,11
2692,Clément Vidal,fr,DF,Montpellier,Ligue 1,20,2000,1.0,2,1,1,1,0,2,4,50.0,2,4,4,0,1,3,6
2693,Nacho Vidal,es,DF,Osasuna,La Liga,25,1995,26.1,56,28,27,22,7,22,31,71.0,9,39,10,29,43,99,68
2694,Ronaldo Vieira,eng,MF,Hellas Verona,it Serie A,22,1998,2.5,5,3,1,3,1,0,2,0.0,2,4,3,1,0,5,2
2695,Luca Vignali,it,DF,Spezia,it Serie A,24,1996,17.7,19,9,10,6,3,7,25,28.0,18,13,5,8,22,41,25
2696,Emanuel Vignato,it,FW,Bologna,it Serie A,19,2000,13.4,18,9,9,6,3,3,15,20.0,12,6,1,5,10,28,7
2697,Toni Villa,es,MF,Valladolid,La Liga,25,1995,10.8,31,16,11,14,6,15,42,35.7,27,15,1,14,5,36,3
2698,Asier Villalibre,es,FW,Athletic Club,La Liga,22,1997,17.7,3,2,0,2,1,2,8,25.0,6,4,0,4,2,5,16
2699,Gonzalo Villar,es,MF,Roma,it Serie A,22,1998,20.7,44,18,14,24,6,18,61,29.5,43,25,3,22,22,66,14
2700,Iván Villar,es,GK,Celta Vigo,La Liga,23,1997,19.8,0,0,0,0,0,0,1,0.0,1,0,0,0,0,0,18
2701,Rúben Vinagre,pt,MF,Wolves,Premier League,21,1999,1.9,7,5,5,2,0,3,4,75.0,1,3,0,3,2,9,4
2702,Carlos Vinícius,br,FW,Tottenham,Premier League,25,1995,3.4,3,1,2,1,0,1,1,100.0,0,0,0,0,2,5,5
2703,Nicolas Viola,it,MF,Benevento,it Serie A,30,1989,11.5,16,9,2,11,3,6,28,21.4,22,10,3,7,9,25,7
2704,João Virgínia,pt,GK,Everton,Premier League,20,1999,0.5,0,0,0,0,0,0,0,,0,0,0,0,0,0,0
2705,Vitinha,pt,MF,Wolves,Premier League,20,2000,5.8,7,3,2,5,0,3,8,37.5,5,3,0,3,3,10,1
2706,Vitolo,es,MF,Atlético Madrid,La Liga,30,1989,3.3,4,1,2,0,2,1,6,16.7,5,3,0,3,3,7,2
2707,Dušan Vlahović,rs,FW,Fiorentina,it Serie A,20,2000,32.5,13,4,3,4,6,5,16,31.3,11,16,2,14,4,17,15
2708,Michel Vlap,nl,MF,Arminia,Bundesliga,23,1997,4.1,1,1,0,1,0,0,8,0.0,8,4,0,4,5,6,3
2709,Andreas Voglsammer,de,FW,Arminia,Bundesliga,28,1992,11.1,12,8,6,6,0,8,17,47.1,9,11,0,11,3,15,11
2710,Kevin Vogt,de,DF,Hoffenheim,Bundesliga,28,1991,20.5,18,12,11,6,1,12,21,57.1,9,21,12,9,16,34,71
2711,Mërgim Vojvoda,xk,DF,Torino,it Serie A,25,1995,15.1,24,14,18,5,1,12,22,54.5,10,19,4,15,18,42,35
2712,Jake Vokins,eng,DF,Southampton,Premier League,20,2000,0.7,0,0,0,0,0,0,1,0.0,1,0,0,0,0,0,0
2713,Kevin Volland,de,FW,Monaco,Ligue 1,28,1992,30.8,33,16,11,19,3,8,34,23.5,26,23,0,23,4,37,4
2714,Stefan de Vrij,nl,DF,Inter,it Serie A,28,1992,30.4,28,16,15,12,1,15,24,62.5,9,24,18,6,41,69,95
2715,Giacomo Vrioni,al,FW,Juventus,it Serie A,21,1998,0.0,0,0,0,0,0,0,0,,0,0,0,0,0,0,0
2716,Šime Vrsaljko,hr,FW,Atlético Madrid,La Liga,28,1992,5.8,18,12,13,5,0,8,12,66.7,4,5,0,5,8,26,14
2717,Nikola Vukčević,me,MF,Levante,La Liga,28,1991,9.0,14,7,5,8,1,9,18,50.0,9,8,5,3,8,22,12
2718,Miloš Vulić,rs,MF,Crotone,it Serie A,23,1996,14.5,15,8,9,1,5,8,21,38.1,13,10,1,9,8,23,8
2719,Matěj Vydra,cz,FW,Burnley,Premier League,28,1992,15.2,9,5,2,4,3,1,8,12.5,7,8,1,7,6,15,5
2720,Franklin Wadja,cm,MF,Lorient,Ligue 1,25,1995,0.4,4,2,0,2,2,2,2,100.0,0,0,0,0,2,6,1
2721,Elye Wahi,fr,FW,Montpellier,Ligue 1,17,2003,6.2,4,3,2,1,1,1,6,16.7,5,4,0,4,2,6,5
2722,Walace,br,MF,Udinese,it Serie A,25,1995,22.8,50,23,28,19,3,21,60,35.0,39,36,3,33,34,84,23
2723,Theo Walcott,eng,MF,Southampton,Premier League,31,1989,18.0,23,11,8,9,6,11,32,34.4,21,16,0,16,14,37,5
2724,Theo Walcott,eng,FW,Everton,Premier League,31,1989,0.1,0,0,0,0,0,0,0,,0,0,0,0,0,0,0
2725,Kyle Walker,eng,DF,Manchester City,Premier League,30,1990,21.6,29,19,15,12,2,16,24,66.7,8,19,7,12,14,43,28
2726,Kyle Walker-Peters,eng,DF,Southampton,Premier League,23,1997,29.4,83,53,56,25,2,34,57,59.6,23,41,10,31,38,121,66
2727,Sebastian Walukiewicz,pl,DF,Cagliari,it Serie A,20,2000,18.0,27,19,11,13,3,12,30,40.0,18,22,14,8,36,63,60
2728,Aaron Wan-Bissaka,eng,DF,Manchester Utd,Premier League,22,1997,34.0,88,54,53,29,6,32,45,71.1,13,65,17,48,62,150,84
2729,Joel Ward,eng,DF,Crystal Palace,Premier League,30,1989,25.1,43,25,29,14,0,24,42,57.1,18,27,8,19,41,84,87
2730,James Ward-Prowse,eng,MF,Southampton,Premier League,25,1994,38.0,75,49,30,41,4,29,70,41.4,41,36,4,32,42,117,60
2731,Daniel Wass,dk,MF,Valencia,La Liga,31,1989,33.1,52,31,21,29,2,22,55,40.0,33,33,13,20,47,99,69
2732,Ollie Watkins,eng,FW,Aston Villa,Premier League,24,1995,37.0,29,17,5,16,8,10,33,30.3,23,21,2,19,7,36,24
2733,Caleb Watts,au,MF,Southampton,Premier League,18,2002,0.4,2,1,2,0,0,1,2,50.0,1,0,0,0,0,2,0
2734,Timothy Weah,us,FW,Lille,Ligue 1,20,2000,9.8,15,7,3,9,3,7,14,50.0,7,7,0,7,4,19,5
2735,Adam Webster,eng,DF,Brighton,Premier League,25,1995,28.8,29,16,15,10,4,12,25,48.0,13,29,16,13,47,76,92
2736,Wout Weghorst,nl,FW,Wolfsburg,Bundesliga,27,1992,32.7,13,8,2,8,3,4,20,20.0,16,17,3,14,4,17,26
2737,Mitchell Weiser,de,DF,Leverkusen,Bundesliga,26,1994,2.5,4,1,1,2,1,2,4,50.0,2,1,0,1,3,7,4
2738,Shon Weissman,il,FW,Valladolid,La Liga,24,1996,23.7,12,9,4,5,3,2,23,8.7,21,17,3,14,8,20,7
2739,Danny Welbeck,eng,FW,Brighton,Premier League,29,1990,17.2,12,6,2,6,4,7,19,36.8,12,17,0,17,7,19,13
2740,Wendell,br,DF,Leverkusen,Bundesliga,27,1993,16.2,53,35,27,18,8,23,49,46.9,26,26,3,23,25,78,39
2741,Oscar Wendt,se,DF,Gladbach,Bundesliga,34,1985,13.9,12,6,2,9,1,4,12,33.3,8,18,4,14,14,26,23
2742,Timo Werner,de,FW,Chelsea,Premier League,24,1996,28.9,20,9,6,11,3,7,43,16.3,36,23,1,22,8,28,8
2743,Ashley Westwood,eng,MF,Burnley,Premier League,30,1990,37.9,23,15,6,12,5,10,42,23.8,32,26,9,17,44,67,33
2744,Ben White,eng,DF,Brighton,Premier League,22,1997,35.5,49,26,21,24,4,24,57,42.1,33,46,22,24,62,111,56
2745,Georginio Wijnaldum,nl,MF,Liverpool,Premier League,29,1990,32.7,23,7,6,14,3,7,31,22.6,24,18,3,15,26,49,18
2746,William,br,MF,Wolfsburg,Bundesliga,25,1995,0.0,0,0,0,0,0,0,0,,0,0,0,0,0,0,0
2747,William,br,DF,Schalke 04,Bundesliga,25,1995,5.3,14,10,10,4,0,5,15,33.3,10,16,5,11,11,25,15
2748,Brandon Williams,eng,DF,Manchester Utd,Premier League,19,2000,2.1,0,0,0,0,0,0,1,0.0,1,1,0,1,1,1,7
2749,Iñaki Williams,gh,FW,Athletic Club,La Liga,26,1994,26.5,11,7,0,4,7,2,14,14.3,12,13,1,12,5,16,22
2750,Neco Williams,wls,DF,Liverpool,Premier League,19,2001,2.8,6,5,4,2,0,5,9,55.6,4,3,1,2,6,12,6
2751,Nico Williams,es,MF,Athletic Club,La Liga,18,2002,0.6,1,0,1,0,0,0,2,0.0,2,0,0,0,1,2,0
2752,Rhys Williams,eng,DF,Liverpool,Premier League,19,2001,7.3,6,4,3,3,0,3,3,100.0,0,4,3,1,6,12,27
2753,Willian,br,FW,Arsenal,Premier League,31,1988,15.6,13,7,6,6,1,6,16,37.5,10,13,0,13,8,21,8
2754,Joe Willock,eng,MF,Arsenal,Premier League,20,1999,2.6,6,3,1,4,1,3,7,42.9,4,6,1,5,3,9,0
2755,Joe Willock,eng,MF,Newcastle Utd,Premier League,20,1999,10.9,26,13,16,7,3,9,42,21.4,33,21,3,18,17,43,15
2756,Callum Wilson,eng,FW,Newcastle Utd,Premier League,28,1992,23.2,12,5,1,6,5,2,12,16.7,10,10,3,7,7,19,14
2757,Marten Winkler,de,FW,Hertha BSC,Bundesliga,17,2002,0.0,0,0,0,0,0,0,0,,0,0,0,0,0,0,0
2758,Harry Winks,eng,MF,Tottenham,Premier League,24,1996,9.6,16,9,11,5,0,5,20,25.0,15,16,4,12,11,27,12
2759,Florian Wirtz,de,MF,Leverkusen,Bundesliga,17,2003,24.7,35,18,8,22,5,11,37,29.7,26,27,1,26,9,44,8
2760,Yoane Wissa,cd,MF,Lorient,Ligue 1,23,1996,29.7,35,20,12,14,9,11,34,32.4,23,25,3,22,20,55,14
2761,Axel Witsel,be,MF,Dortmund,Bundesliga,31,1989,12.6,18,12,6,11,1,8,16,50.0,8,13,3,10,22,40,13
2762,Hannes Wolf,at,MF,Gladbach,Bundesliga,21,1999,15.3,26,13,8,10,8,8,36,22.2,28,18,1,17,9,35,4
2763,Marius Wolf,de,MF,Köln,Bundesliga,25,1995,28.3,35,19,19,13,3,13,38,34.2,25,29,3,26,28,63,47
2764,Nick Woltemade,de,MF,Werder Bremen,Bundesliga,18,2002,1.6,3,2,1,1,1,2,4,50.0,2,1,0,1,0,3,0
2765,Jeong Woo-yeong,kr,FW,Freiburg,Bundesliga,20,1999,9.1,9,5,1,6,2,2,11,18.2,9,8,1,7,11,20,11
2766,Chris Wood,nz,FW,Burnley,Premier League,28,1991,30.5,12,7,2,4,6,5,18,27.8,13,14,3,11,1,13,21
2767,Joscha Wosz,de,DF,RB Leipzig,Bundesliga,18,2002,0.4,1,1,1,0,0,0,0,,0,1,0,1,1,2,0
2768,Xeka,pt,MF,Lille,Ligue 1,25,1994,13.3,33,17,14,15,4,16,43,37.2,27,14,2,12,20,53,18
2769,Granit Xhaka,ch,MF,Arsenal,Premier League,27,1992,28.0,50,26,18,17,15,30,58,51.7,28,23,7,16,24,74,38
2770,Reinhold Yabo,de,MF,Arminia,Bundesliga,28,1992,7.2,5,2,2,2,1,2,9,22.2,7,6,1,5,4,9,1
2771,Jawad El Yamiq,ma,DF,Valladolid,La Liga,28,1992,15.3,21,14,14,7,0,8,11,72.7,3,15,10,5,46,67,100
2772,Rubén Yáñez,es,GK,Getafe,La Liga,26,1993,10.0,0,0,0,0,0,0,1,0.0,1,0,0,0,2,2,2
2773,Andriy Yarmolenko,ua,FW,West Ham,Premier League,30,1989,4.2,5,4,2,2,1,2,8,25.0,6,1,0,1,1,6,2
2774,Yusuf Yazıcı,tr,FW,Lille,Ligue 1,23,1997,12.1,12,5,6,2,4,1,24,4.2,23,5,1,4,2,14,2
2775,DeAndre Yedlin,us,DF,Newcastle Utd,Premier League,27,1993,4.8,9,4,8,1,0,4,10,40.0,6,5,1,4,7,16,17
2776,Burak Yılmaz,tr,FW,Lille,Ligue 1,35,1985,22.8,13,6,3,7,3,4,30,13.3,26,7,0,7,5,18,22
2777,Yoel,es,GK,Eibar,La Liga,31,1988,3.3,0,0,0,0,0,0,0,,0,0,0,0,0,0,2
2778,Okay Yokuşlu,tr,MF,West Brom,Premier League,26,1994,14.6,38,25,21,13,4,17,35,48.6,18,15,3,12,35,73,33
2779,Okay Yokuşlu,tr,MF,Celta Vigo,La Liga,26,1994,5.1,14,8,8,4,2,5,9,55.6,4,5,2,3,10,24,9
2780,Maya Yoshida,jp,DF,Sampdoria,it Serie A,31,1988,25.3,17,4,10,7,0,7,13,53.8,6,45,34,11,57,74,93
2781,Amin Younes,de,MF,Eint Frankfurt,Bundesliga,26,1993,15.5,25,14,8,10,7,6,32,18.8,26,19,1,18,13,38,4
2782,Ashley Young,eng,DF,Inter,it Serie A,35,1985,15.8,15,7,8,4,3,3,13,23.1,10,13,0,13,6,21,31
2783,Wilitty Younoussa,cm,MF,Dijon,Ligue 1,18,2001,0.9,6,3,3,3,0,3,7,42.9,4,3,0,3,2,8,0
2784,Zaydou Youssouf,km,MF,Saint-Étienne,Ligue 1,21,1999,13.7,30,15,19,10,1,16,40,40.0,24,15,0,15,25,55,12
2785,Mattia Zaccagni,it,MF,Hellas Verona,it Serie A,25,1995,29.0,27,13,8,11,8,8,25,32.0,17,28,4,24,27,54,13
2786,Dan-Axel Zagadou,fr,DF,Dortmund,Bundesliga,21,1999,3.1,2,2,2,0,0,0,0,,0,3,2,1,6,8,13
2787,Vasilios Zagaritis,gr,DF,Parma,it Serie A,19,2001,0.7,0,0,0,0,0,0,0,,0,1,0,1,0,0,0
2788,Arthur Zagre,fr,DF,Dijon,Ligue 1,18,2001,1.4,3,1,2,1,0,2,2,100.0,0,1,1,0,3,6,1
2789,Wilfried Zaha,ci,FW,Crystal Palace,Premier League,27,1992,29.0,26,18,8,15,3,11,30,36.7,19,21,0,21,9,35,4
2790,Miha Zajc,si,MF,Genoa,it Serie A,26,1994,20.7,22,14,9,10,3,13,39,33.3,26,30,4,26,27,49,19
2791,Denis Zakaria,ch,MF,Gladbach,Bundesliga,23,1996,15.8,30,15,12,15,3,11,20,55.0,9,20,7,13,23,53,29
2792,Joseba Zaldúa,es,DF,Real Sociedad,La Liga,28,1992,7.1,15,12,7,5,3,6,18,33.3,12,6,2,4,6,21,13
2793,Nicola Zalewski,pl,MF,Roma,it Serie A,18,2002,0.1,1,1,0,1,0,1,1,100.0,0,0,0,0,0,1,0
2794,Andre-Frank Zambo Anguissa,cm,MF,Fulham,Premier League,24,1995,28.7,78,37,27,38,13,27,68,39.7,41,35,6,29,56,134,17
2795,Niccolò Zanellato,it,MF,Crotone,it Serie A,22,1998,18.2,24,14,16,6,2,13,36,36.1,23,19,5,14,16,40,12
2796,Cristián Zapata,co,DF,Genoa,it Serie A,33,1986,10.8,18,12,11,7,0,10,14,71.4,4,15,11,4,15,33,56
2797,Duván Zapata,co,FW,Atalanta,it Serie A,29,1991,26.4,12,5,2,3,7,4,13,30.8,9,19,5,14,6,18,19
2798,Gabriele Zappa,it,DF,Cagliari,it Serie A,20,1999,26.6,34,17,16,15,3,22,49,44.9,27,36,4,32,24,58,50
2799,Davide Zappacosta,it,DF,Genoa,it Serie A,28,1992,22.7,33,16,15,13,5,15,30,50.0,15,17,1,16,18,51,41
2800,Oier Zarraga,es,MF,Athletic Club,La Liga,21,1999,1.1,1,1,0,1,0,1,2,50.0,1,1,0,1,0,1,0
2801,Simone Zaza,it,FW,Torino,it Serie A,29,1991,16.6,15,9,4,6,5,6,20,30.0,14,14,0,14,3,18,5
2802,Deyovaisio Zeefuik,nl,DF,Hertha BSC,Bundesliga,22,1998,10.1,13,9,8,3,2,8,19,42.1,11,15,3,12,12,25,36
2803,Marvin Zeegelaar,nl,DF,Udinese,it Serie A,29,1990,19.3,40,18,23,16,1,20,39,51.3,19,21,9,12,24,64,43
2804,Arber Zeneli,xk,MF,Reims,Ligue 1,25,1995,14.3,20,10,11,1,8,8,22,36.4,14,12,1,11,3,23,8
2805,Robin Zentner,de,GK,Mainz 05,Bundesliga,25,1994,31.0,1,1,1,0,0,1,3,33.3,2,0,0,0,3,4,9
2806,Andi Zeqiri,ch,FW,Brighton,Premier League,21,1999,1.9,3,2,0,2,1,1,2,50.0,1,1,0,1,0,3,2
2807,Mehdi Zerkane,dz,MF,Bordeaux,Ligue 1,21,1999,13.2,23,15,7,10,6,5,18,27.8,13,15,2,13,9,32,5
2808,Ron-Robert Zieler,de,GK,Köln,Bundesliga,31,1989,0.6,0,0,0,0,0,0,0,,0,0,0,0,0,0,0
2809,Piotr Zieliński,pl,MF,Napoli,it Serie A,26,1994,28.0,18,10,8,7,3,7,20,35.0,13,23,4,19,18,36,12
2810,Oleksandr Zinchenko,ua,DF,Manchester City,Premier League,23,1996,16.4,25,15,12,9,4,14,24,58.3,10,17,4,13,23,48,28
2811,Joshua Zirkzee,nl,FW,Parma,it Serie A,19,2001,1.3,2,2,1,1,0,1,3,33.3,2,1,1,0,0,2,1
2812,Joshua Zirkzee,nl,FW,Bayern Munich,Bundesliga,19,2001,1.0,1,0,0,1,0,1,2,50.0,1,0,0,0,0,1,0
2813,Hakim Ziyech,ma,MF,Chelsea,Premier League,27,1993,13.0,14,10,5,7,2,5,19,26.3,14,9,1,8,10,24,2
2814,Jeroen Zoet,nl,GK,Spezia,it Serie A,29,1991,6.7,0,0,0,0,0,0,1,0.0,1,0,0,0,0,0,4
2815,Kévin Zohi,ml,FW,Strasbourg,Ligue 1,23,1996,4.8,9,5,3,4,2,2,6,33.3,4,6,0,6,6,15,3
2816,Kurt Zouma,fr,DF,Chelsea,Premier League,25,1994,22.5,16,10,8,6,2,4,8,50.0,4,13,9,4,28,44,93
2817,Igor Zubeldia,es,DF,Real Sociedad,La Liga,23,1997,21.8,23,16,15,8,0,8,14,57.1,6,20,13,7,12,35,46
2818,Steven Zuber,ch,DF,Eint Frankfurt,Bundesliga,28,1991,6.5,24,12,8,13,3,8,16,50.0,8,4,1,3,4,28,1
2819,Martín Zubimendi,es,MF,Real Sociedad,La Liga,21,1999,20.9,41,22,18,20,3,20,34,58.8,14,22,10,12,40,81,39
2820,Martin Ødegaard,no,MF,Arsenal,Premier League,21,1998,9.6,9,3,2,6,1,4,14,28.6,10,2,0,2,2,11,5
2821,Martin Ødegaard,no,MF,Real Madrid,La Liga,21,1998,2.6,1,0,0,1,0,1,2,50.0,1,1,0,1,1,2,0
2822,Filip Đuričić,rs,MF,Sassuolo,it Serie A,28,1992,23.1,32,23,6,16,10,12,30,40.0,18,20,2,18,9,41,12
