Rk,Player,Nation,Pos1,Pos2,Squad,Comp,Age,Born,90s,Tkl,TklW,Def 3rd,Mid 3rd,Att 3rd,Tkl Att,Tkl%,Lost,Blocks,Sh,Pass,Int,Tkl+Int,Clr,Err
1,Max Aarons,eng,DF,,Norwich City,Premier League,21,2000,32.0,64,44,49,15,0,37,55,67.3,18,39,19,20,28,92,96
2,Yunis Abdelhamid,ma,DF,,Reims,Ligue 1,33,1987,33.1,48,27,34,14,0,16,32,50.0,16,50,25,25,68,116,104
3,Salis Abdul Samed,gh,MF,,Clermont Foot,Ligue 1,21,2000,27.4,43,23,25,16,2,20,57,35.1,37,18,1,17,42,85,15
4,Laurent Abergel,fr,MF,,Lorient,Ligue 1,28,1993,32.8,110,60,44,53,13,71,166,42.8,95,58,1,57,55,165,13
5,Charles Abi,fr,FW,,Saint-Étienne,Ligue 1,21,2000,0.5,0,0,0,0,0,0,1,0.0,1,2,0,2,0,0,0
6,Dickson Abiama,ng,FW,,Greuther Fürth,Bundesliga,22,1998,8.1,11,7,4,5,2,2,10,20.0,8,12,1,11,4,15,8
7,Matthis Abline,fr,FW,,Rennes,Ligue 1,18,2003,1.1,0,0,0,0,0,0,0,,0,2,0,2,0,0,1
8,Tammy Abraham,eng,FW,,Roma,Serie A,23,1997,34.3,27,13,7,14,6,9,22,40.9,13,17,3,14,5,32,27
9,Luis Abram,pe,DF,,Granada,La Liga,25,1996,6.2,6,3,3,3,0,2,4,50.0,2,6,5,1,5,11,37
10,Francesco Acerbi,it,DF,,Lazio,Serie A,33,1988,28.2,25,12,15,9,1,12,19,63.2,7,37,28,9,34,59,92
11,Ragnar Ache,de,MF,FW,Eint Frankfurt,Bundesliga,23,1998,2.9,2,0,0,1,1,1,4,25.0,3,3,0,3,0,2,1
12,Mohamed Achi,fr,MF,,Nantes,Ligue 1,19,2002,0.1,0,0,0,0,0,0,0,,0,0,0,0,0,0,0
13,Marcos Acuña,ar,DF,,Sevilla,La Liga,29,1991,25.1,50,29,27,14,9,30,46,65.2,16,22,5,17,14,64,25
14,Che Adams,sct,FW,,Southampton,Premier League,25,1996,22.7,13,6,5,5,3,2,16,12.5,14,18,2,16,8,21,18
15,Tyler Adams,us,MF,,RB Leipzig,Bundesliga,22,1999,15.0,23,7,5,16,2,7,25,28.0,18,24,1,23,16,39,19
16,Sargis Adamyan,am,FW,MF,Hoffenheim,Bundesliga,28,1993,3.7,8,6,3,4,1,3,11,27.3,8,4,0,4,1,9,2
17,Martin Adeline,fr,MF,FW,Reims,Ligue 1,17,2003,3.9,15,11,5,8,2,8,16,50.0,8,0,0,0,11,26,6
18,Amine Adli,ma,FW,MF,Leverkusen,Bundesliga,21,2000,14.0,27,14,10,14,3,8,15,53.3,7,26,2,24,11,38,12
19,Yacine Adli,fr,MF,FW,Bordeaux,Ligue 1,21,2000,25.1,43,27,22,14,7,19,68,27.9,49,33,3,30,37,80,11
20,Michel Aebischer,ch,MF,,Bologna,Serie A,24,1997,4.9,14,5,5,8,1,6,11,54.5,5,4,1,3,6,20,3
21,Felix Afena-Gyan,gh,FW,MF,Roma,Serie A,18,2003,7.4,10,3,1,6,3,4,7,57.1,3,4,0,4,3,13,0
22,Martin Agirregabiria,es,DF,,Alavés,La Liga,25,1996,18.0,34,22,17,11,6,18,37,48.6,19,20,3,17,25,59,38
23,Julen Agirrezabala,es,GK,,Athletic Club,La Liga,20,2000,4.0,0,0,0,0,0,0,0,,0,0,0,0,0,0,2
24,Lucien Agoume,fr,MF,,Brest,Ligue 1,19,2002,20.8,51,31,24,20,7,23,45,51.1,22,30,9,21,52,103,27
25,Kevin Agudelo,co,MF,FW,Spezia,Serie A,22,1998,13.7,44,26,13,26,5,7,20,35.0,13,22,0,22,8,52,6
26,Nayef Aguerd,ma,DF,,Rennes,Ligue 1,25,1996,30.4,27,18,16,11,0,14,24,58.3,10,24,14,10,24,51,127
27,Sergio Agüero,ar,FW,,Barcelona,La Liga,33,1988,1.7,1,1,0,0,1,0,2,0.0,2,0,0,0,0,1,0
28,Ruben Aguilar,fr,DF,,Monaco,Ligue 1,28,1993,23.8,78,53,39,32,7,43,68,63.2,25,19,4,15,44,122,57
29,Álvaro Aguirre,es,FW,,Rayo Vallecano,La Liga,21,2000,0.1,0,0,0,0,0,0,0,,0,0,0,0,0,0,0
30,Naouirou Ahamada,fr,MF,DF,Stuttgart,Bundesliga,19,2002,0.7,1,0,1,0,0,1,3,33.3,2,0,0,0,0,1,0
31,Anel Ahmedhodžić,ba,DF,,Bordeaux,Ligue 1,22,1999,15.0,38,26,27,9,2,20,31,64.5,11,16,8,8,22,60,44
32,Jean-Eudes Aholou,ci,MF,,Strasbourg,Ligue 1,27,1994,11.2,16,9,4,9,3,5,19,26.3,14,8,1,7,19,35,7
33,Joseph Aidoo,gh,DF,,Celta Vigo,La Liga,25,1995,29.3,39,26,28,10,1,17,31,54.8,14,23,13,10,38,77,96
34,Ola Aina,ng,DF,,Torino,Serie A,24,1996,16.0,27,19,11,10,6,15,23,65.2,8,17,3,14,28,55,30
35,Rayan Aït-Nouri,dz,DF,MF,Wolves,Premier League,20,2001,20.3,64,36,46,15,3,22,44,50.0,22,24,2,22,22,86,39
36,Kristoffer Ajer,no,DF,,Brentford,Premier League,23,1998,22.2,29,18,21,6,2,13,21,61.9,8,19,11,8,26,55,74
37,Ludovic Ajorque,fr,FW,,Strasbourg,Ligue 1,27,1994,30.4,36,25,5,19,12,7,40,17.5,33,28,3,25,8,44,31
38,Manuel Akanji,ch,DF,,Dortmund,Bundesliga,26,1995,25.1,33,23,20,11,2,22,32,68.8,10,26,15,11,35,68,58
39,Carlos Akapo,gq,DF,,Cádiz,La Liga,28,1993,20.5,43,31,26,15,2,21,37,56.8,16,26,7,19,51,94,61
40,Marley Aké,fr,FW,MF,Juventus,Serie A,20,2001,0.9,0,0,0,0,0,0,2,0.0,2,0,0,0,1,1,0
41,Nathan Aké,nl,DF,,Manchester City,Premier League,26,1995,10.3,16,9,7,8,1,6,8,75.0,2,7,5,2,8,24,23
42,Ilias Akhomach,ma,FW,,Barcelona,La Liga,17,2004,1.4,2,0,0,1,1,0,0,,0,0,0,0,0,2,0
43,Maghnes Akliouche,fr,MF,FW,Monaco,Ligue 1,19,2002,0.6,2,0,0,2,0,0,1,0.0,1,2,0,2,0,2,0
44,Paul Akouokou,ci,MF,,Betis,La Liga,23,1997,5.7,14,9,5,7,2,8,12,66.7,4,6,0,6,11,25,6
45,Jean-Daniel Akpa-Akpro,ci,MF,,Lazio,Serie A,28,1992,3.5,17,10,7,9,1,7,12,58.3,5,4,2,2,2,19,6
46,Kevin Akpoguma,ng,DF,FW,Hoffenheim,Bundesliga,26,1995,17.0,33,19,16,11,6,16,28,57.1,12,32,2,30,20,53,29
47,David Alaba,at,DF,,Real Madrid,La Liga,29,1992,29.4,23,13,15,6,2,9,19,47.4,10,26,15,11,22,45,70
48,Sofiane Alakouch,ma,DF,MF,Metz,Ligue 1,23,1998,1.8,7,4,3,4,0,2,5,40.0,3,4,0,4,1,8,4
49,Tomás Alarcón,cl,MF,,Cádiz,La Liga,22,1999,15.8,31,20,17,10,4,10,31,32.3,21,19,7,12,30,61,31
50,Lucas Alario,ar,FW,,Leverkusen,Bundesliga,28,1992,7.3,6,5,0,2,4,2,5,40.0,3,5,0,5,1,7,6
51,Jordi Alba,es,DF,,Barcelona,La Liga,32,1989,29.4,47,34,12,26,9,27,47,57.4,20,26,6,20,33,80,41
52,Josué Albert,gf,DF,,Clermont Foot,Ligue 1,29,1992,0.2,0,0,0,0,0,0,0,,0,0,0,0,1,1,2
53,Luis Alberto,es,MF,,Lazio,Serie A,28,1992,26.1,29,17,8,11,10,8,52,15.4,44,32,4,28,13,42,7
54,Raúl Albiol,es,DF,,Villarreal,La Liga,35,1985,27.4,26,15,20,5,1,14,18,77.8,4,24,15,9,21,47,126
55,Marc Albrighton,eng,FW,DF,Leicester City,Premier League,31,1989,12.6,31,19,16,9,6,10,47,21.3,37,15,3,12,14,45,20
56,Paco Alcácer,es,FW,,Villarreal,La Liga,27,1993,8.7,9,3,2,4,3,1,5,20.0,4,7,0,7,6,15,1
57,Thiago Alcántara,es,MF,,Liverpool,Premier League,30,1991,17.0,48,29,14,24,10,10,42,23.8,32,22,2,20,26,74,13
58,Rubén Alcaraz,es,MF,,Cádiz,La Liga,30,1991,12.3,41,20,14,24,3,22,45,48.9,23,10,2,8,13,54,14
59,Omar Alderete,py,DF,,Valencia,La Liga,24,1996,26.7,53,34,34,17,2,34,53,64.2,19,30,18,12,35,88,153
60,Iván Alejo,es,MF,FW,Cádiz,La Liga,26,1995,11.8,33,15,21,10,2,15,44,34.1,29,12,0,12,8,41,17
61,Doğan Alemdar,tr,GK,,Rennes,Ligue 1,18,2002,12.0,0,0,0,0,0,0,0,,0,0,0,0,0,0,9
62,Carles Aleñá,es,MF,,Getafe,La Liga,23,1998,25.8,27,19,11,13,3,9,48,18.8,39,21,2,19,15,42,16
63,Trent Alexander-Arnold,eng,DF,,Liverpool,Premier League,22,1998,31.7,40,23,19,13,8,27,60,45.0,33,22,4,18,43,83,40
64,Mohamed Ali Cho,fr,FW,,Angers,Ligue 1,17,2004,20.4,10,5,1,4,5,5,17,29.4,12,17,1,16,8,18,0
65,Alisson,br,GK,,Liverpool,Premier League,28,1992,36.0,3,1,3,0,0,3,5,60.0,2,1,0,1,0,3,28
66,Allan,br,MF,,Everton,Premier League,30,1991,24.3,74,44,28,39,7,34,105,32.4,71,40,9,31,23,97,39
67,Jim Allevinah,ga,FW,,Clermont Foot,Ligue 1,26,1995,16.5,18,13,8,8,2,5,18,27.8,13,11,0,11,6,24,4
68,Dele Alli,eng,MF,,Tottenham,Premier League,25,1996,7.3,14,8,10,3,1,5,17,29.4,12,22,5,17,6,20,16
69,Dele Alli,eng,MF,FW,Everton,Premier League,25,1996,3.8,7,2,3,4,0,0,4,0.0,4,7,2,5,6,13,10
70,Miguel Almirón,py,MF,FW,Newcastle Utd,Premier League,27,1994,19.1,47,29,23,17,7,11,44,25.0,33,14,1,13,20,67,13
71,Marcos Alonso,es,DF,,Chelsea,Premier League,30,1990,24.1,41,29,20,12,9,17,36,47.2,19,29,5,24,43,84,53
72,Giorgio Altare,it,DF,,Cagliari,Serie A,22,1998,16.3,39,28,18,18,3,21,26,80.8,5,17,5,12,30,69,70
73,Hugo Álvarez,es,FW,,Celta Vigo,La Liga,18,2003,0.1,1,0,1,0,0,0,0,,0,0,0,0,0,1,1
74,Yeray Álvarez,es,DF,,Athletic Club,La Liga,26,1995,20.7,24,14,15,8,1,10,18,55.6,8,21,16,5,45,69,97
75,Dani Alves,br,DF,,Barcelona,La Liga,38,1983,12.2,30,19,13,13,4,14,26,53.8,12,10,3,7,11,41,10
76,Steven Alzate,co,MF,,Brighton,Premier League,22,1998,4.5,10,4,4,5,1,4,7,57.1,3,2,1,1,10,20,10
77,Ibrahim Amadou,fr,DF,MF,Metz,Ligue 1,28,1993,9.0,16,8,10,6,0,8,15,53.3,7,4,2,2,14,30,26
78,Emmanuel Amankwaa Akurugu,gh,DF,,Getafe,La Liga,19,2001,0.9,0,0,0,0,0,0,2,0.0,2,1,0,1,0,0,0
79,Daniel Amartey,gh,DF,,Leicester City,Premier League,26,1994,23.6,26,13,19,7,0,19,29,65.5,10,30,22,8,21,47,93
80,Amath,sn,FW,MF,Mallorca,La Liga,25,1996,9.8,21,11,11,6,4,7,17,41.2,10,12,0,12,7,28,7
81,Jordan Amavi,fr,DF,,Nice,Ligue 1,27,1994,4.6,16,10,8,7,1,10,17,58.8,7,3,1,2,15,31,7
82,Jordan Amavi,fr,DF,FW,Marseille,Ligue 1,27,1994,1.4,6,5,3,1,2,5,10,50.0,5,1,0,1,1,7,3
83,Wisdom Amey,it,DF,,Bologna,Serie A,15,2005,0.8,3,2,1,1,1,2,3,66.7,1,2,0,2,3,6,1
84,Kelvin Amian,fr,DF,,Spezia,Serie A,23,1998,29.4,66,42,43,18,5,30,41,73.2,11,39,21,18,32,98,75
85,Nadiem Amiri,de,MF,FW,Genoa,Serie A,24,1996,7.6,6,4,2,2,2,2,9,22.2,7,7,0,7,0,6,0
86,Nadiem Amiri,de,MF,FW,Leverkusen,Bundesliga,24,1996,4.1,8,4,3,2,3,4,8,50.0,4,4,2,2,5,13,0
87,Ethan Ampadu,wls,MF,DF,Venezia,Serie A,20,2000,25.4,67,43,37,27,3,24,58,41.4,34,49,19,30,51,118,76
88,Sofyan Amrabat,ma,MF,,Fiorentina,Serie A,24,1996,10.5,24,13,9,13,2,11,19,57.9,8,25,8,17,5,29,6
89,Joachim Andersen,dk,DF,,Crystal Palace,Premier League,25,1996,32.4,30,23,21,9,0,16,27,59.3,11,29,19,10,37,67,125
90,Felipe Anderson,br,FW,,Lazio,Serie A,28,1993,32.1,71,45,30,33,8,27,99,27.3,72,65,6,59,20,91,16
91,Sebastian Andersson,se,FW,,Köln,Bundesliga,30,1991,14.0,11,7,0,3,8,3,9,33.3,6,8,0,8,3,14,14
92,Florin Andone,ro,FW,,Cádiz,La Liga,28,1993,2.0,1,1,1,0,0,0,1,0.0,1,2,0,2,0,1,1
93,Andrés Andrade Cedeño,pa,DF,,Arminia,Bundesliga,22,1998,11.6,27,16,18,8,1,17,35,48.6,18,16,7,9,19,46,44
94,Benjamin André,fr,MF,,Lille,Ligue 1,30,1990,30.6,123,69,49,65,9,51,113,45.1,62,49,11,38,50,173,56
95,Fredrik André Bjørkan,no,DF,,Hertha BSC,Bundesliga,22,1998,3.9,12,10,7,4,1,7,9,77.8,2,6,2,4,6,18,8
96,Marcos André,br,FW,MF,Valencia,La Liga,24,1996,10.8,15,11,4,6,5,5,16,31.3,11,15,0,15,7,22,13
97,Robert Andrich,de,MF,,Leverkusen,Bundesliga,26,1994,20.2,33,17,18,14,1,14,28,50.0,14,19,7,12,31,64,46
98,José Ángel,es,DF,,Osasuna,La Liga,31,1989,12.0,20,13,9,9,2,9,14,64.3,5,6,1,5,10,30,21
99,Angeliño,es,DF,,RB Leipzig,Bundesliga,24,1997,25.5,28,21,14,13,1,14,30,46.7,16,24,3,21,29,57,40
100,Ebenezer Annan,gh,DF,,Bologna,Serie A,18,2002,0.3,1,1,1,0,0,0,0,,0,0,0,0,1,2,1
101,Cristian Ansaldi,ar,DF,,Torino,Serie A,34,1986,7.7,20,9,11,7,2,10,13,76.9,3,9,1,8,6,26,10
102,Janis Antiste,fr,FW,,Spezia,Serie A,18,2002,8.8,18,11,6,6,6,5,13,38.5,8,7,1,6,4,22,6
103,Waldemar Anton,de,DF,,Stuttgart,Bundesliga,25,1996,28.8,40,26,22,15,3,19,32,59.4,13,27,16,11,32,72,116
104,Josep Antoni Gayá,es,DF,,Mallorca,La Liga,21,2000,0.6,0,0,0,0,0,0,0,,0,1,0,1,1,1,3
105,Michail Antonio,jm,FW,,West Ham,Premier League,31,1990,33.0,23,17,5,9,9,7,18,38.9,11,19,1,18,3,26,13
106,Christopher Antwi-Adjei,gh,FW,MF,Bochum,Bundesliga,27,1994,12.6,21,18,7,8,6,6,26,23.1,20,12,0,12,1,22,8
107,Houssem Aouar,dz,MF,FW,Lyon,Ligue 1,23,1998,27.8,46,30,9,25,12,27,54,50.0,27,26,1,25,20,66,5
108,Adil Aouchiche,fr,MF,FW,Saint-Étienne,Ligue 1,19,2002,12.0,13,6,5,5,3,5,33,15.2,28,18,1,17,17,30,4
109,Dennis Appiah,fr,DF,,Nantes,Ligue 1,29,1992,23.3,55,34,35,18,2,28,48,58.3,20,30,13,17,27,82,74
110,Mauro Arambarri,uy,MF,,Getafe,La Liga,25,1995,29.6,62,37,19,32,11,20,68,29.4,48,35,5,30,32,94,18
111,Mattia Aramu,it,MF,FW,Venezia,Serie A,26,1995,23.3,20,15,5,9,6,8,33,24.2,25,20,2,18,8,28,19
112,Charles Aránguiz,cl,MF,,Leverkusen,Bundesliga,32,1989,17.5,45,25,18,21,6,22,52,42.3,30,24,4,20,33,78,21
113,Néstor Araujo,mx,DF,,Celta Vigo,La Liga,29,1991,29.1,22,14,17,5,0,9,21,42.9,12,17,10,7,27,49,105
114,Ronald Araújo,uy,DF,,Barcelona,La Liga,22,1999,25.2,41,23,29,12,0,21,25,84.0,4,37,20,17,23,64,66
115,Cameron Archer,eng,FW,MF,Aston Villa,Premier League,20,2001,0.3,0,0,0,0,0,0,0,,0,0,0,0,0,0,0
116,Alphonse Areola,fr,GK,,West Ham,Premier League,28,1993,1.0,0,0,0,0,0,0,0,,0,0,0,0,0,0,1
117,Jesús Areso,es,DF,,Osasuna,La Liga,22,1999,2.1,3,3,2,1,0,0,2,0.0,2,0,0,0,0,3,2
118,Matias Arezo,uy,FW,MF,Granada,La Liga,18,2002,1.8,5,3,2,1,2,4,9,44.4,5,1,0,1,1,6,1
119,Santiago Arias,co,DF,,Granada,La Liga,29,1992,4.9,12,5,8,3,1,4,9,44.4,5,8,4,4,5,17,10
120,Adam Armstrong,eng,FW,,Southampton,Premier League,24,1997,15.7,10,4,2,2,6,0,6,0.0,6,13,1,12,3,13,6
121,Stuart Armstrong,sct,MF,,Southampton,Premier League,29,1992,16.4,27,19,15,6,6,9,23,39.1,14,10,1,9,8,35,15
122,Marko Arnautović,at,FW,,Bologna,Serie A,32,1989,29.9,17,9,1,11,5,7,30,23.3,23,13,2,11,7,24,17
123,Maximilian Arnold,de,MF,,Wolfsburg,Bundesliga,27,1994,33.3,37,20,19,16,2,20,50,40.0,30,43,15,28,37,74,55
124,Kepa Arrizabalaga,es,GK,,Chelsea,Premier League,26,1994,4.0,0,0,0,0,0,0,0,,0,0,0,0,0,0,4
125,Tolgay Arslan,de,MF,,Udinese,Serie A,30,1990,18.4,35,20,15,16,4,19,50,38.0,31,17,4,13,13,48,23
126,Santiago Arzamendia,py,MF,,Cádiz,La Liga,23,1998,5.2,14,6,6,5,3,6,13,46.2,7,6,0,6,4,18,7
127,Takuma Asano,jp,FW,MF,Bochum,Bundesliga,26,1994,17.9,11,6,3,6,2,5,19,26.3,14,14,1,13,7,18,7
128,Santiago Ascacíbar,ar,MF,,Hertha BSC,Bundesliga,24,1997,26.4,93,54,50,37,6,38,89,42.7,51,31,6,25,41,134,42
129,Sergio Asenjo,es,GK,,Villarreal,La Liga,32,1989,6.0,0,0,0,0,0,0,1,0.0,1,0,0,0,1,1,6
130,Alejandro Asensio,es,FW,,Rayo Vallecano,La Liga,20,2000,0.1,0,0,0,0,0,0,0,,0,0,0,0,0,0,0
131,Marco Asensio,es,FW,MF,Real Madrid,La Liga,25,1996,19.2,12,8,6,4,2,4,18,22.2,14,8,1,7,12,24,6
132,Harrison Ashby,sct,DF,,West Ham,Premier League,19,2001,0.1,0,0,0,0,0,0,0,,0,1,0,1,1,1,1
133,Kristoffer Askildsen,no,MF,,Sampdoria,Serie A,20,2001,8.4,18,6,7,11,0,9,19,47.4,10,14,7,7,15,33,15
134,Fisnik Asllani,xk,MF,FW,Hoffenheim,Bundesliga,18,2002,0.1,0,0,0,0,0,0,1,0.0,1,0,0,0,0,0,0
135,Kristjan Asllani,al,MF,,Empoli,Serie A,19,2002,15.0,18,9,9,8,1,11,29,37.9,18,16,7,9,19,37,15
136,Iago Aspas,es,FW,,Celta Vigo,La Liga,33,1987,34.3,14,7,1,5,8,4,24,16.7,20,23,2,21,11,25,19
137,Lorenz Assignon,tg,DF,,Rennes,Ligue 1,21,2000,6.8,15,10,11,3,1,5,9,55.6,4,3,1,2,11,26,19
138,Simon Asta,de,DF,,Greuther Fürth,Bundesliga,20,2001,8.7,13,6,4,5,4,4,8,50.0,4,14,2,12,8,21,16
139,Youcef Atal,dz,DF,,Nice,Ligue 1,25,1996,12.7,29,19,17,10,2,14,25,56.0,11,13,2,11,32,61,21
140,Pierre-Emerick Aubameyang,ga,FW,,Arsenal,Premier League,32,1989,11.5,11,5,6,4,1,3,10,30.0,7,12,1,11,0,11,4
141,Pierre-Emerick Aubameyang,ga,FW,,Barcelona,La Liga,32,1989,12.0,2,2,0,1,1,0,5,0.0,5,9,1,8,2,4,4
142,Emil Audero,it,GK,,Sampdoria,Serie A,24,1997,28.4,3,1,3,0,0,3,5,60.0,2,0,0,0,2,5,17
143,Tommaso Augello,it,DF,,Sampdoria,Serie A,26,1994,26.6,36,20,22,8,6,17,29,58.6,12,19,4,15,29,65,68
144,Jean-Kévin Augustin,fr,FW,MF,Nantes,Ligue 1,24,1997,0.9,1,0,0,0,1,0,3,0.0,3,1,0,1,0,1,0
145,Ludwig Augustinsson,se,DF,FW,Sevilla,La Liga,27,1994,8.8,18,14,11,3,4,8,13,61.5,5,10,3,7,5,23,21
146,Serge Aurier,ci,DF,,Villarreal,La Liga,28,1992,11.2,14,9,11,2,1,4,7,57.1,3,14,7,7,11,25,25
147,Ezequiel Ávila,ar,FW,MF,Osasuna,La Liga,27,1994,20.8,17,7,6,7,4,7,21,33.3,14,14,2,12,13,30,15
148,Taiwo Awoniyi,ng,FW,,Union Berlin,Bundesliga,23,1997,24.2,11,7,3,6,2,1,9,11.1,8,11,2,9,2,13,29
149,Ramzi Aya,it,DF,,Salernitana,Serie A,30,1990,1.5,1,1,1,0,0,1,1,100.0,0,0,0,0,0,1,4
150,Jordan Ayew,gh,FW,,Crystal Palace,Premier League,29,1991,22.4,47,30,20,20,7,17,31,54.8,14,33,3,30,15,62,15
151,Kaan Ayhan,tr,DF,,Sassuolo,Serie A,26,1994,15.0,20,12,14,6,0,7,15,46.7,8,20,14,6,13,33,57
152,Luke Ayling,eng,DF,,Leeds United,Premier League,29,1991,25.2,74,42,46,23,5,51,97,52.6,46,46,25,21,28,102,52
153,Karim Azamoum,fr,DF,,Troyes,Ligue 1,31,1990,4.3,6,5,4,2,0,3,5,60.0,2,4,2,2,1,7,10
154,Sardar Azmoun,ir,FW,MF,Leverkusen,Bundesliga,26,1995,4.0,3,1,0,2,1,0,5,0.0,5,2,0,2,0,3,8
155,César Azpilicueta,es,DF,,Chelsea,Premier League,31,1989,23.0,51,28,18,27,6,16,35,45.7,19,32,9,23,23,74,65
156,Iddrisu Baba,gh,MF,,Mallorca,La Liga,25,1996,21.5,57,30,31,23,3,25,43,58.1,18,19,5,14,24,81,34
157,Carlos Bacca,co,FW,,Granada,La Liga,34,1986,5.7,4,4,2,0,2,0,3,0.0,3,5,0,5,1,5,5
158,Daniel Bachmann,at,GK,,Watford,Premier League,27,1994,12.0,0,0,0,0,0,0,0,,0,0,0,0,1,1,5
159,Loïc Bade,fr,DF,,Rennes,Ligue 1,21,2000,10.9,6,5,4,2,0,3,5,60.0,2,12,10,2,12,18,48
160,Milan Badelj,hr,MF,,Genoa,Serie A,32,1989,31.6,64,37,25,30,9,34,80,42.5,46,39,7,32,85,149,43
161,Édgar Badía,es,GK,,Elche,La Liga,29,1992,24.0,0,0,0,0,0,0,0,,0,0,0,0,0,0,16
162,Benoît Badiashile,fr,DF,,Monaco,Ligue 1,20,2001,20.4,36,19,21,15,0,14,23,60.9,9,18,12,6,28,64,68
163,Youssouph Badji,sn,FW,MF,Brest,Ligue 1,19,2001,1.5,1,0,0,1,0,0,1,0.0,1,0,0,0,0,1,0
164,Miguel Baeza,es,DF,,Celta Vigo,La Liga,21,2000,0.0,0,0,0,0,0,0,0,,0,0,0,0,0,0,0
165,Nicola Bagnolini,it,GK,,Bologna,Serie A,17,2004,0.0,0,0,0,0,0,0,0,,0,0,0,0,0,0,0
166,Issa Bah,lu,FW,,Venezia,Serie A,19,2002,0.1,0,0,0,0,0,0,0,,0,0,0,0,0,0,0
167,Stéphane Bahoken,cm,FW,,Angers,Ligue 1,29,1992,12.2,13,8,2,7,4,1,9,11.1,8,15,0,15,3,16,3
168,Leon Bailey,jm,FW,MF,Aston Villa,Premier League,23,1997,8.5,17,11,6,8,3,6,13,46.2,7,10,1,9,1,18,2
169,Eric Bailly,ci,DF,,Manchester Utd,Premier League,27,1994,2.4,5,4,4,0,1,3,4,75.0,1,4,2,2,3,8,11
170,Dénys Bain,fr,DF,,Brest,Ligue 1,28,1993,2.0,3,3,1,2,0,1,1,100.0,0,3,1,2,3,6,5
171,Stefan Bajic,fr,GK,,Saint-Étienne,Ligue 1,19,2001,5.7,0,0,0,0,0,0,0,,0,0,0,0,0,0,4
172,Nedim Bajrami,al,MF,FW,Empoli,Serie A,22,1999,22.8,21,14,5,13,3,4,14,28.6,10,11,0,11,3,24,8
173,Cédric Bakambu,cd,FW,,Marseille,Ligue 1,30,1991,4.0,2,0,1,0,1,0,3,0.0,3,2,0,2,0,2,1
174,Abdoulaye Bakayoko,fr,DF,,Saint-Étienne,Ligue 1,18,2002,3.4,15,9,13,2,0,8,12,66.7,4,5,4,1,12,27,15
175,Tiemoué Bakayoko,fr,MF,,Milan,Serie A,26,1994,5.6,19,13,9,7,3,5,16,31.3,11,8,1,7,9,28,10
176,Mitchel Bakker,nl,DF,,Leverkusen,Bundesliga,21,2000,20.2,33,22,16,12,5,20,34,58.8,14,13,2,11,23,56,42
177,Ridle Baku,de,DF,FW,Wolfsburg,Bundesliga,23,1998,27.2,62,37,30,24,8,25,65,38.5,40,43,1,42,21,83,52
178,Dilane Bakwa,fr,FW,MF,Bordeaux,Ligue 1,18,2002,0.5,1,1,0,1,0,1,2,50.0,1,0,0,0,0,1,1
179,Tommaso Baldanzi,it,FW,,Empoli,Serie A,18,2003,0.2,0,0,0,0,0,0,0,,0,1,0,1,0,0,0
180,Alejandro Balde,es,DF,FW,Barcelona,La Liga,17,2003,2.1,2,1,1,0,1,0,0,,0,2,2,0,1,3,1
181,Ibrahima Baldé,fr,FW,MF,Lens,Ligue 1,18,2003,0.6,0,0,0,0,0,0,0,,0,0,0,0,0,0,0
182,Keita Baldé,sn,FW,,Cagliari,Serie A,26,1995,13.7,8,4,1,5,2,1,10,10.0,9,6,0,6,4,12,6
183,Gareth Bale,wls,FW,,Real Madrid,La Liga,32,1989,3.1,2,1,1,0,1,1,4,25.0,3,2,0,2,2,4,1
184,Mikel Balenziaga,es,DF,,Athletic Club,La Liga,33,1988,22.5,33,24,15,15,3,25,43,58.1,18,27,4,23,21,54,79
185,Leonardo Balerdi,ar,DF,,Marseille,Ligue 1,22,1999,10.6,9,6,9,0,0,5,14,35.7,9,11,4,7,19,28,30
186,Iván Balliu,al,DF,,Rayo Vallecano,La Liga,29,1992,35.0,45,22,25,11,9,19,31,61.3,12,24,5,19,39,84,64
187,Fodé Ballo-Touré,sn,DF,,Milan,Serie A,24,1997,5.0,18,14,5,13,0,4,9,44.4,5,6,2,4,3,21,5
188,Folarin Balogun,us,FW,,Arsenal,Premier League,20,2001,0.8,1,1,0,0,1,0,0,,0,1,0,1,0,1,1
189,Abdoulaye Bamba,ci,DF,FW,Angers,Ligue 1,31,1990,5.1,6,5,6,0,0,4,11,36.4,7,5,1,4,9,15,13
190,Jonathan Bamba,ci,MF,FW,Lille,Ligue 1,25,1996,27.0,30,12,13,9,8,13,36,36.1,23,24,1,23,21,51,10
191,Patrick Bamford,eng,FW,,Leeds United,Premier League,27,1993,6.2,1,0,0,1,0,0,3,0.0,3,8,2,6,2,3,8
192,Filippo Bandinelli,it,MF,,Empoli,Serie A,26,1995,21.7,33,20,10,17,6,15,31,48.4,16,22,5,17,10,43,37
193,Mattia Bani,it,DF,,Genoa,Serie A,27,1993,13.5,23,13,17,6,0,14,18,77.8,4,19,11,8,20,43,76
194,Simon Banza,cd,FW,,Lens,Ligue 1,24,1996,1.4,2,1,0,0,2,0,2,0.0,2,1,0,1,1,3,2
195,Shandon Baptiste,gd,MF,,Brentford,Premier League,23,1998,10.1,14,4,9,4,1,6,15,40.0,9,10,0,10,11,25,12
196,Antonín Barák,cz,MF,FW,Hellas Verona,Serie A,26,1994,26.0,18,8,9,8,1,5,17,29.4,12,32,5,27,6,24,26
197,Barbero,es,FW,MF,Osasuna,La Liga,22,1998,0.2,0,0,0,0,0,0,0,,0,0,0,0,0,0,1
198,Danilo Barbosa,br,DF,,Nice,Ligue 1,25,1996,1.0,0,0,0,0,0,0,0,,0,1,1,0,2,2,10
199,Barcia,es,DF,,Granada,La Liga,20,2000,0.8,0,0,0,0,0,0,0,,0,1,1,0,1,1,0
200,Bradley Barcola,fr,FW,MF,Lyon,Ligue 1,18,2002,2.9,7,4,2,3,2,1,8,12.5,7,7,1,6,2,9,1
201,Melvin Bard,fr,DF,,Nice,Ligue 1,20,2000,28.8,59,37,38,17,4,41,63,65.1,22,33,10,23,51,110,56
202,Enis Bardhi,mk,MF,FW,Levante,La Liga,26,1995,18.9,29,12,12,14,3,12,35,34.3,23,13,2,11,10,39,7
203,Francesco Bardi,it,GK,,Bologna,Serie A,29,1992,2.0,0,0,0,0,0,0,0,,0,0,0,0,0,0,0
204,Keidi Bare,al,MF,,Espanyol,La Liga,23,1997,16.5,27,17,14,12,1,11,31,35.5,20,20,10,10,15,42,26
205,Nicolò Barella,it,MF,,Inter,Serie A,24,1997,32.4,63,42,17,35,11,29,55,52.7,26,26,2,24,21,84,8
206,Kike Barja,es,MF,FW,Osasuna,La Liga,24,1997,9.6,15,11,4,7,4,8,22,36.4,14,10,1,9,9,24,4
207,Ross Barkley,eng,MF,FW,Chelsea,Premier League,27,1993,2.0,0,0,0,0,0,0,1,0.0,1,1,0,1,1,1,0
208,Aymen Barkok,ma,MF,DF,Eint Frankfurt,Bundesliga,23,1998,1.8,6,2,2,3,1,2,7,28.6,5,4,1,3,5,11,6
209,Ashley Barnes,eng,FW,,Burnley,Premier League,31,1989,9.0,11,2,2,7,2,2,9,22.2,7,8,1,7,2,13,5
210,Harvey Barnes,eng,FW,MF,Leicester City,Premier League,23,1997,23.3,31,16,9,11,11,7,23,30.4,16,24,1,23,5,36,7
211,Antonio Barragán,es,DF,,Elche,La Liga,34,1987,11.3,21,14,13,7,1,11,17,64.7,6,5,3,2,17,38,34
212,Leandro Barreiro Martins,lu,MF,,Mainz 05,Bundesliga,21,2000,19.9,63,32,23,27,13,29,50,58.0,21,23,6,17,32,95,23
213,Ander Barrenetxea,es,FW,MF,Real Sociedad,La Liga,19,2001,6.1,15,10,9,6,0,8,18,44.4,10,7,0,7,2,17,2
214,Jacob Barrett Laursen,dk,DF,,Arminia,Bundesliga,26,1994,18.1,16,12,10,6,0,8,21,38.1,13,19,7,12,28,44,43
215,Musa Barrow,gm,FW,MF,Bologna,Serie A,22,1998,23.7,12,4,4,4,4,6,20,30.0,14,20,1,19,6,18,8
216,Abdourahmane Barry,gn,DF,,Greuther Fürth,Bundesliga,21,2000,2.3,6,4,3,3,0,5,7,71.4,2,5,2,3,4,10,1
217,Marc Bartra,es,DF,,Betis,La Liga,30,1991,22.1,39,14,18,17,4,19,35,54.3,16,39,22,17,33,72,105
218,Daniele Baselli,it,MF,FW,Torino,Serie A,29,1992,1.7,3,3,2,0,1,2,6,33.3,4,0,0,0,1,4,2
219,Daniele Baselli,it,MF,,Cagliari,Serie A,29,1992,3.2,6,5,3,1,2,1,5,20.0,4,2,0,2,2,8,5
220,Toma Bašić,hr,MF,,Lazio,Serie A,24,1996,10.9,12,8,3,9,0,5,17,29.4,12,13,4,9,4,16,21
221,Toma Bašić,hr,MF,,Bordeaux,Ligue 1,24,1996,2.3,2,2,1,0,1,0,4,0.0,4,4,1,3,2,4,0
222,Amine Bassi,fr,MF,FW,Metz,Ligue 1,23,1997,2.0,6,3,2,3,1,1,3,33.3,2,5,0,5,0,6,0
223,Álvaro Bastida,es,MF,,Cádiz,La Liga,17,2004,2.2,7,4,2,4,1,4,5,80.0,1,1,0,1,3,10,1
224,Alessandro Bastoni,it,DF,,Inter,Serie A,22,1999,25.7,44,25,28,13,3,17,34,50.0,17,22,12,10,35,79,59
225,Simone Bastoni,it,MF,DF,Spezia,Serie A,24,1996,25.4,52,34,28,17,7,21,65,32.3,44,38,11,27,30,82,31
226,Lewis Bate,eng,MF,,Leeds United,Premier League,18,2002,1.6,1,0,0,0,1,0,8,0.0,8,1,0,1,1,2,1
227,Rodrigo Battaglia,ar,MF,,Mallorca,La Liga,30,1991,13.1,32,16,13,19,0,15,30,50.0,15,21,10,11,10,42,36
228,Maximilian Bauer,de,DF,,Greuther Fürth,Bundesliga,21,2000,18.8,28,15,17,10,1,11,28,39.3,17,24,14,10,29,57,99
229,Oliver Baumann,de,GK,,Hoffenheim,Bundesliga,31,1990,33.0,0,0,0,0,0,0,3,0.0,3,0,0,0,0,0,19
230,Timo Baumgartl,de,DF,,Union Berlin,Bundesliga,25,1996,24.1,59,28,34,21,4,31,47,66.0,16,27,11,16,37,96,58
231,Julian Baumgartlinger,at,MF,FW,Leverkusen,Bundesliga,33,1988,1.0,3,1,2,1,0,1,2,50.0,1,1,0,1,2,5,0
232,Christoph Baumgartner,at,MF,FW,Hoffenheim,Bundesliga,21,1999,21.0,28,15,14,7,7,13,32,40.6,19,24,3,21,8,36,16
233,Jon Bautista,es,MF,,Real Sociedad,La Liga,26,1995,0.5,3,0,0,3,0,0,1,0.0,1,1,0,1,1,4,1
234,Paul Baysse,fr,MF,DF,Bordeaux,Ligue 1,33,1988,0.1,1,1,0,1,0,0,0,,0,0,0,0,0,1,1
235,Noah Joel Sarenren Bazee,ng,MF,FW,Augsburg,Bundesliga,24,1996,2.7,5,2,2,2,1,3,4,75.0,1,8,2,6,1,6,4
236,Bebé,cv,FW,,Rayo Vallecano,La Liga,31,1990,9.6,6,5,1,3,2,4,16,25.0,12,18,0,18,3,9,6
237,Ihlas Bebou,tg,FW,DF,Hoffenheim,Bundesliga,27,1994,23.2,22,14,5,12,5,7,21,33.3,14,20,3,17,12,34,25
238,Rodrigo Becão,br,DF,,Udinese,Serie A,25,1996,34.8,81,46,49,30,2,34,60,56.7,26,45,20,25,42,123,89
239,Mads Bech Sørensen,dk,DF,,Brentford,Premier League,22,1999,9.3,8,7,6,2,0,6,7,85.7,1,9,6,3,6,14,25
240,Sheraldo Becker,sr,FW,MF,Union Berlin,Bundesliga,26,1995,19.5,9,6,3,4,2,6,18,33.3,12,11,0,11,2,11,4
241,Jan Bednarek,pl,DF,,Southampton,Premier League,25,1996,29.2,32,15,18,13,1,19,33,57.6,14,48,27,21,72,104,141
242,Donny van de Beek,nl,MF,,Manchester Utd,Premier League,24,1997,0.8,6,4,4,1,1,1,2,50.0,1,5,1,4,2,8,1
243,Donny van de Beek,nl,MF,,Everton,Premier League,24,1997,5.4,15,7,8,6,1,6,13,46.2,7,6,2,4,6,21,4
244,Asmir Begović,ba,GK,,Everton,Premier League,34,1987,3.0,0,0,0,0,0,0,0,,0,0,0,0,0,0,3
245,Valon Behrami,ch,MF,FW,Genoa,Serie A,36,1985,3.5,3,1,0,2,1,0,7,0.0,7,4,1,3,1,4,4
246,Kevin Behrens,de,FW,,Union Berlin,Bundesliga,30,1991,5.5,3,2,1,1,1,0,4,0.0,4,3,0,3,3,6,7
247,Youcef Belaïli,dz,MF,FW,Brest,Ligue 1,29,1992,9.2,2,1,0,0,2,2,9,22.2,7,5,1,4,7,9,4
248,Vid Belec,si,GK,,Salernitana,Serie A,31,1990,21.5,0,0,0,0,0,0,0,,0,0,0,0,0,0,9
249,Ishak Belfodil,dz,FW,,Hertha BSC,Bundesliga,29,1992,18.2,9,6,4,4,1,4,8,50.0,4,9,1,8,5,14,16
250,Haris Belkebla,dz,MF,,Brest,Ligue 1,27,1994,25.7,46,23,21,21,4,18,39,46.2,21,26,6,20,48,94,30
251,Stefan Bell,de,DF,,Mainz 05,Bundesliga,29,1991,31.8,54,23,37,16,1,30,63,47.6,33,26,15,11,41,95,112
252,Armel Bella Kotchap,de,DF,,Bochum,Bundesliga,19,2001,19.6,34,20,25,9,0,18,28,64.3,10,21,16,5,42,76,84
253,Raoul Bellanova,it,DF,FW,Cagliari,Serie A,21,2000,27.7,29,15,14,12,3,6,27,22.2,21,39,8,31,21,50,51
254,Karim Bellarabi,de,FW,MF,Leverkusen,Bundesliga,31,1990,7.6,9,4,4,4,1,3,13,23.1,10,5,0,5,9,18,4
255,Jean-Ricner Bellegarde,fr,MF,,Strasbourg,Ligue 1,23,1998,25.9,51,32,21,21,9,17,41,41.5,24,29,4,25,27,78,19
256,Héctor Bellerín,es,DF,,Betis,La Liga,26,1995,22.0,52,32,29,20,3,31,44,70.5,13,11,2,9,23,75,57
257,Jude Bellingham,eng,MF,,Dortmund,Bundesliga,18,2003,31.0,52,34,15,31,6,21,53,39.6,32,50,4,46,42,94,32
258,George Bello,us,DF,,Arminia,Bundesliga,19,2002,4.8,7,7,7,0,0,4,4,100.0,0,5,4,1,6,13,11
259,Jeanuël Belocian,fr,DF,,Rennes,Ligue 1,16,2005,0.1,0,0,0,0,0,0,0,,0,0,0,0,0,0,0
260,Andrea Belotti,it,FW,,Torino,Serie A,27,1993,15.2,7,3,2,2,3,3,12,25.0,9,12,4,8,2,9,9
261,Fran Beltrán,es,MF,,Celta Vigo,La Liga,22,1999,28.9,56,41,27,23,6,28,68,41.2,40,29,5,24,32,88,39
262,Hatem Ben Arfa,fr,FW,MF,Lille,Ligue 1,34,1987,3.5,4,2,2,1,1,2,4,50.0,2,3,0,3,0,4,1
263,Salim Ben Seghir,fr,MF,,Marseille,Ligue 1,18,2003,0.0,0,0,0,0,0,0,0,,0,0,0,0,0,0,0
264,Wissam Ben Yedder,fr,FW,,Monaco,Ligue 1,30,1990,28.1,18,8,1,11,6,6,15,40.0,9,12,1,11,0,18,1
265,Marco Benassi,it,DF,MF,Fiorentina,Serie A,26,1994,1.8,1,0,1,0,0,1,2,50.0,1,3,0,3,3,4,3
266,Marco Benassi,it,MF,,Empoli,Serie A,26,1994,4.2,6,3,3,2,1,1,10,10.0,9,4,0,4,3,9,6
267,Darío Benedetto,ar,FW,MF,Elche,La Liga,31,1990,6.6,5,1,2,2,1,3,6,50.0,3,4,0,4,1,6,1
268,Darío Benedetto,ar,FW,MF,Marseille,Ligue 1,31,1990,0.6,0,0,0,0,0,0,0,,0,2,0,2,0,0,0
269,László Bénes,sk,MF,,Gladbach,Bundesliga,23,1997,2.7,5,3,1,3,1,1,6,16.7,5,5,2,3,2,7,5
270,Walter Benítez,ar,GK,,Nice,Ligue 1,28,1993,37.0,0,0,0,0,0,0,2,0.0,2,1,0,1,0,0,12
271,Iker Benito,es,FW,MF,Osasuna,La Liga,18,2002,1.3,2,1,1,0,1,0,1,0.0,1,2,0,2,0,2,2
272,Loris Benito,ch,DF,,Bordeaux,Ligue 1,29,1992,0.7,0,0,0,0,0,0,0,,0,0,0,0,1,1,3
273,Pedro Benito,es,FW,,Cádiz,La Liga,21,2000,0.3,0,0,0,0,0,0,1,0.0,1,0,0,0,0,0,0
274,Filip Benković,hr,DF,FW,Udinese,Serie A,24,1997,0.1,0,0,0,0,0,0,0,,0,0,0,0,0,0,0
275,Ismaël Bennacer,dz,MF,,Milan,Serie A,23,1997,16.9,44,30,22,15,7,21,50,42.0,29,20,4,16,25,69,15
276,Keanan Bennetts,eng,FW,DF,Gladbach,Bundesliga,22,1999,0.6,2,0,1,1,0,1,1,100.0,0,1,0,1,0,2,0
277,Saïd Benrahma,dz,FW,MF,West Ham,Premier League,25,1995,24.1,28,17,16,9,3,15,38,39.5,23,17,1,16,9,37,8
278,Ramy Bensebaini,dz,DF,,Gladbach,Bundesliga,26,1995,22.4,42,30,24,15,3,27,44,61.4,17,33,7,26,39,81,77
279,Nabil Bentaleb,dz,MF,,Angers,Ligue 1,26,1994,16.8,42,24,15,20,7,16,29,55.2,13,24,9,15,28,70,13
280,Rodrigo Bentancur,uy,MF,,Tottenham,Premier League,24,1997,15.1,36,18,14,14,8,16,32,50.0,16,24,9,15,20,56,35
281,Rodrigo Bentancur,uy,MF,,Juventus,Serie A,24,1997,12.8,32,18,11,18,3,7,20,35.0,13,15,2,13,26,58,15
282,Christian Benteke,be,FW,,Crystal Palace,Premier League,30,1990,12.7,3,2,1,2,0,2,6,33.3,4,7,3,4,2,5,33
283,Karim Benzema,fr,FW,,Real Madrid,La Liga,33,1987,28.8,11,9,5,3,3,2,9,22.2,7,10,0,10,4,15,13
284,Alessandro Berardi,it,GK,,Hellas Verona,Serie A,30,1991,1.0,0,0,0,0,0,0,0,,0,0,0,0,0,0,0
285,Domenico Berardi,it,FW,,Sassuolo,Serie A,26,1994,31.3,32,19,9,16,7,15,57,26.3,42,39,2,37,31,63,23
286,Yuri Berchiche,es,DF,,Athletic Club,La Liga,31,1990,11.3,25,11,10,11,4,7,14,50.0,7,19,6,13,13,38,25
287,Álex Berenguer,es,MF,,Athletic Club,La Liga,26,1995,24.1,45,26,23,14,8,11,51,21.6,40,40,2,38,16,61,20
288,Bartosz Bereszyński,pl,DF,,Sampdoria,Serie A,29,1992,32.7,64,38,34,25,5,37,80,46.3,43,38,12,26,42,106,73
289,Jóhann Berg Guðmundsson,is,MF,,Burnley,Premier League,30,1990,12.2,16,6,7,7,2,5,20,25.0,15,11,2,9,12,28,22
290,Patrick Berg,no,MF,,Lens,Ligue 1,23,1997,3.4,14,6,6,8,0,0,4,0.0,4,2,1,1,4,18,3
291,Mitchell van Bergen,nl,FW,MF,Reims,Ligue 1,21,1999,10.9,8,5,7,0,1,6,15,40.0,9,9,0,9,4,12,7
292,Steven Bergwijn,nl,FW,MF,Tottenham,Premier League,23,1997,6.3,3,2,2,1,0,1,10,10.0,9,3,0,3,1,4,8
293,Etrit Berisha,al,GK,,Torino,Serie A,32,1989,10.0,0,0,0,0,0,0,0,,0,0,0,0,0,0,4
294,Valon Berisha,xk,MF,FW,Reims,Ligue 1,28,1993,5.1,10,7,2,5,3,2,10,20.0,8,9,0,9,4,14,3
295,Federico Bernardeschi,it,MF,FW,Juventus,Serie A,27,1994,16.4,16,10,7,4,5,6,13,46.2,7,12,4,8,5,21,15
296,Paul Bernardoni,fr,GK,,Angers,Ligue 1,24,1997,13.0,3,2,3,0,0,3,4,75.0,1,0,0,0,0,3,8
297,Paul Bernardoni,fr,GK,,Saint-Étienne,Ligue 1,24,1997,19.0,0,0,0,0,0,0,0,,0,0,0,0,0,0,14
298,Juan Bernat,es,DF,MF,Paris S-G,Ligue 1,28,1993,10.6,24,14,10,10,4,13,18,72.2,5,8,0,8,8,32,16
299,Dimitry Bertaud,cd,GK,,Montpellier,Ligue 1,23,1998,9.3,0,0,0,0,0,0,1,0.0,1,0,0,0,0,0,5
300,Jason Berthomier,fr,MF,,Clermont Foot,Ligue 1,31,1990,19.2,29,14,5,17,7,12,34,35.3,22,14,2,12,8,37,4
301,Nicolò Bertola,it,MF,DF,Spezia,Serie A,18,2003,0.4,3,2,3,0,0,3,4,75.0,1,0,0,0,3,6,1
302,Ryan Bertrand,eng,DF,,Leicester City,Premier League,31,1989,3.7,8,5,3,4,1,2,5,40.0,3,8,3,5,1,9,7
303,Daniel Bessa,it,MF,,Hellas Verona,Serie A,28,1993,8.5,7,2,3,3,1,4,15,26.7,11,13,3,10,5,12,11
304,Beto,gw,FW,,Udinese,Serie A,23,1998,24.1,21,6,2,14,5,9,19,47.4,10,16,1,15,5,26,25
305,Jordan Beyer,de,DF,,Gladbach,Bundesliga,21,2000,15.4,46,27,32,13,1,23,39,59.0,16,18,5,13,15,61,52
306,Giulian Biancone,fr,DF,MF,Troyes,Ligue 1,21,2000,25.5,70,42,44,22,4,40,69,58.0,29,23,8,15,53,123,71
307,Bartosz Białek,pl,FW,DF,Wolfsburg,Bundesliga,19,2001,2.0,0,0,0,0,0,0,1,0.0,1,1,0,1,0,0,2
308,Ermin Bičakčić,ba,DF,,Hoffenheim,Bundesliga,31,1990,0.1,0,0,0,0,0,0,0,,0,0,0,0,0,0,0
309,Mads Bidstrup,dk,MF,,Brentford,Premier League,20,2001,0.5,1,0,0,1,0,0,3,0.0,3,0,0,0,1,2,2
310,Pedro Bigas,es,DF,,Elche,La Liga,30,1990,17.2,24,10,16,8,0,9,20,45.0,11,21,16,5,18,42,77
311,El Bilal Touré,ml,FW,,Reims,Ligue 1,19,2001,13.3,13,6,4,6,3,2,7,28.6,5,10,3,7,6,19,19
312,Jean-Claude Billong,cm,DF,,Clermont Foot,Ligue 1,27,1993,10.9,17,8,14,1,2,8,11,72.7,3,9,1,8,10,27,35
313,Luis Binks,eng,DF,,Bologna,Serie A,19,2001,7.2,8,4,7,1,0,4,6,66.7,2,6,5,1,17,25,33
314,Cristiano Biraghi,it,DF,,Fiorentina,Serie A,28,1992,35.0,37,24,17,15,5,22,53,41.5,31,28,10,18,19,56,31
315,Davide Biraschi,it,DF,,Genoa,Serie A,27,1994,10.3,31,16,19,9,3,17,24,70.8,7,16,9,7,16,47,26
316,Tom Bischof,de,MF,,Hoffenheim,Bundesliga,16,2005,0.2,0,0,0,0,0,0,0,,0,1,0,1,0,0,1
317,Yves Bissouma,ml,MF,,Brighton,Premier League,24,1996,23.5,76,49,35,37,4,21,37,56.8,16,33,3,30,50,126,49
318,Nathan Bitumazala,fr,DF,,Paris S-G,Ligue 1,18,2002,0.1,0,0,0,0,0,0,0,,0,1,0,1,0,0,0
319,Marco Bizot,nl,GK,,Brest,Ligue 1,30,1991,38.0,3,1,3,0,0,3,5,60.0,2,1,0,1,0,3,24
320,Bjarki Bjarkason,is,MF,,Venezia,Serie A,21,2000,0.0,0,0,0,0,0,0,0,,0,0,0,0,0,0,0
321,Antonio Blanco,es,MF,,Real Madrid,La Liga,21,2000,0.3,2,0,1,1,0,0,0,,0,1,1,0,1,3,0
322,Ludovic Blas,fr,MF,FW,Nantes,Ligue 1,23,1997,32.9,33,18,7,20,6,15,44,34.1,29,33,3,30,31,64,6
323,Danny Blum,de,FW,,Bochum,Bundesliga,30,1991,3.8,2,1,0,0,2,0,2,0.0,2,4,0,4,2,4,1
324,Myron Boadu,nl,FW,,Monaco,Ligue 1,20,2001,10.7,9,7,2,3,4,1,5,20.0,4,6,0,6,2,11,1
325,Jérôme Boateng,de,DF,,Lyon,Ligue 1,32,1988,18.0,20,15,11,9,0,9,17,52.9,8,20,10,10,20,40,73
326,Kevin-Prince Boateng,gh,MF,FW,Hertha BSC,Bundesliga,34,1987,7.7,6,5,1,4,1,3,9,33.3,6,7,2,5,6,12,11
327,Antonin Bobichon,fr,MF,FW,Angers,Ligue 1,25,1995,0.4,1,0,0,1,0,0,0,,0,0,0,0,1,2,0
328,Herbert Bockhorn,de,DF,,Bochum,Bundesliga,26,1995,9.4,20,14,13,4,3,12,20,60.0,8,10,1,9,14,34,18
329,Jean-Paul Boëtius,nl,MF,,Mainz 05,Bundesliga,27,1994,20.0,40,23,18,17,5,22,53,41.5,31,41,3,38,25,65,11
330,Jeremie Boga,ci,FW,MF,Atalanta,Serie A,24,1997,8.5,7,3,0,4,3,4,6,66.7,2,6,0,6,1,8,3
331,Jeremie Boga,ci,FW,MF,Sassuolo,Serie A,24,1997,7.4,7,4,1,2,4,2,3,66.7,1,3,0,3,2,9,1
332,Luka Bogdan,hr,DF,,Salernitana,Serie A,25,1996,4.4,6,3,6,0,0,4,8,50.0,4,3,2,1,6,12,21
333,Emil Bohinen,no,MF,,Salernitana,Serie A,22,1999,7.8,15,9,4,9,2,10,20,50.0,10,17,3,14,12,27,14
334,Quentin Boisgard,fr,MF,FW,Lorient,Ligue 1,24,1997,10.6,19,11,6,10,3,8,17,47.1,9,15,0,15,6,25,5
335,Charles Boli,fr,MF,DF,Lens,Ligue 1,22,1998,0.4,2,1,0,2,0,0,0,,0,0,0,0,0,2,0
336,Willy Boly,ci,DF,,Wolves,Premier League,30,1991,10.0,25,19,18,7,0,8,15,53.3,7,14,6,8,14,39,35
337,Giacomo Bonaventura,it,MF,,Fiorentina,Serie A,31,1989,25.2,33,17,12,16,5,21,46,45.7,25,20,2,18,14,47,9
338,Federico Bonazzoli,it,FW,MF,Salernitana,Serie A,24,1997,20.7,24,12,9,8,7,6,25,24.0,19,17,1,16,6,30,7
339,Tarsis Bonga,de,MF,FW,Bochum,Bundesliga,24,1997,0.2,0,0,0,0,0,0,0,,0,0,0,0,0,0,0
340,Kevin Bonifazi,it,DF,,Bologna,Serie A,25,1996,13.4,25,16,16,7,2,13,14,92.9,1,22,7,15,16,41,35
341,Solomon Bonnah,nl,DF,,RB Leipzig,Bundesliga,17,2003,0.1,0,0,0,0,0,0,0,,0,1,0,1,1,1,0
342,Leonardo Bonucci,it,DF,,Juventus,Serie A,34,1987,22.3,14,5,4,10,0,8,13,61.5,5,22,17,5,26,40,82
343,Sebastiaan Bornauw,be,DF,,Wolfsburg,Bundesliga,22,1999,22.3,30,19,23,5,2,16,25,64.0,9,29,8,21,42,72,97
344,Rafael Borré,co,FW,,Eint Frankfurt,Bundesliga,25,1995,26.4,31,22,4,13,14,7,33,21.2,26,24,4,20,5,36,9
345,Sven Botman,nl,DF,,Lille,Ligue 1,21,2000,25.0,24,11,13,11,0,12,18,66.7,6,32,21,11,26,50,116
346,Denis Bouanga,ga,FW,MF,Saint-Étienne,Ligue 1,26,1994,27.1,46,25,14,13,19,22,63,34.9,41,30,0,30,8,54,34
347,Hicham Boudaoui,dz,MF,,Nice,Ligue 1,21,1999,18.0,31,18,15,10,6,13,36,36.1,23,17,4,13,18,49,15
348,Ryad Boudebouz,dz,MF,FW,Saint-Étienne,Ligue 1,31,1990,25.0,27,15,11,12,4,12,29,41.4,17,17,2,15,10,37,5
349,Sofiane Boufal,ma,FW,MF,Angers,Ligue 1,27,1993,25.9,44,29,19,16,9,18,38,47.4,20,19,2,17,7,51,1
350,Farid Boulaya,dz,MF,FW,Metz,Ligue 1,28,1993,17.0,18,10,7,9,2,14,38,36.8,24,8,2,6,12,30,5
351,Yassine Bounou,ma,GK,,Sevilla,La Liga,30,1991,31.0,0,0,0,0,0,0,0,,0,0,0,0,0,0,11
352,Ismaël Boura,km,DF,,Lens,Ligue 1,20,2000,1.1,2,2,1,1,0,0,0,,0,1,1,0,2,4,5
353,Mehdi Bourabia,ma,MF,,Spezia,Serie A,29,1991,3.1,5,1,2,3,0,3,11,27.3,8,7,6,1,3,8,10
354,Benjamin Bourigeaud,fr,FW,MF,Rennes,Ligue 1,27,1994,35.5,46,24,16,18,12,24,67,35.8,43,33,3,30,30,76,44
355,Redwan Bourles,fr,MF,FW,Lorient,Ligue 1,18,2003,0.2,0,0,0,0,0,0,0,,0,0,0,0,0,0,0
356,Edoardo Bove,it,MF,DF,Roma,Serie A,19,2002,0.8,1,1,1,0,0,0,2,0.0,2,1,0,1,1,2,0
357,Jarrod Bowen,eng,FW,,West Ham,Premier League,24,1996,33.1,36,20,20,11,5,17,44,38.6,27,29,2,27,21,57,14
358,Dedryck Boyata,be,DF,,Hertha BSC,Bundesliga,30,1990,21.1,15,13,11,3,1,8,11,72.7,3,17,13,4,17,32,134
359,Lucas Boyé,ar,FW,,Elche,La Liga,25,1996,19.0,27,13,5,15,7,9,24,37.5,15,24,1,23,2,29,23
360,Domagoj Bradarić,hr,DF,,Lille,Ligue 1,21,1999,4.6,11,9,8,2,1,7,12,58.3,5,5,2,3,10,21,7
361,Bilal Brahimi,dz,MF,,Nice,Ligue 1,21,2000,4.2,1,1,0,1,0,0,2,0.0,2,1,0,1,2,3,1
362,Bilal Brahimi,dz,FW,,Angers,Ligue 1,21,2000,3.8,1,1,0,1,0,0,3,0.0,3,0,0,0,1,2,1
363,Martin Braithwaite,dk,FW,,Barcelona,La Liga,30,1991,2.6,1,1,0,0,1,0,0,,0,2,0,2,1,2,1
364,Julian Brandt,de,MF,FW,Dortmund,Bundesliga,25,1996,23.1,37,19,13,20,4,17,54,31.5,37,19,2,17,24,61,14
365,Jarrad Branthwaite,eng,DF,,Everton,Premier League,19,2002,4.3,4,1,3,1,0,3,8,37.5,5,3,2,1,1,5,20
366,Darko Brašanac,rs,MF,,Osasuna,La Liga,29,1992,26.7,35,22,19,14,2,14,40,35.0,26,25,8,17,25,60,15
367,Lilian Brassier,fr,DF,,Brest,Ligue 1,21,1999,25.1,40,24,23,13,4,10,21,47.6,11,31,21,10,32,72,86
368,Claudio Bravo,cl,GK,,Betis,La Liga,38,1983,16.2,0,0,0,0,0,0,0,,0,0,0,0,0,0,6
369,Iker Bravo,es,FW,,Leverkusen,Bundesliga,16,2005,0.1,1,1,0,1,0,0,0,,0,0,0,0,0,1,0
370,Fabian Bredlow,de,GK,,Stuttgart,Bundesliga,26,1995,4.0,0,0,0,0,0,0,0,,0,0,0,0,0,0,1
371,Josip Brekalo,hr,MF,,Torino,Serie A,23,1998,25.4,9,5,5,1,3,3,21,14.3,18,16,1,15,4,13,7
372,Josip Brekalo,hr,FW,,Wolfsburg,Bundesliga,23,1998,0.2,0,0,0,0,0,0,0,,0,0,0,0,0,0,0
373,Gleison Bremer,br,DF,,Torino,Serie A,24,1997,32.1,49,24,27,22,0,18,28,64.3,10,54,23,31,105,154,137
374,Jimmy Briand,fr,FW,MF,Bordeaux,Ligue 1,35,1985,2.5,2,0,2,0,0,0,2,0.0,2,0,0,0,1,3,2
375,Yan Brice Eteki,cm,MF,,Granada,La Liga,23,1997,3.8,6,3,3,2,1,3,7,42.9,4,7,3,4,4,10,6
376,Brian Brobbey,nl,FW,MF,RB Leipzig,Bundesliga,19,2002,1.5,1,0,0,1,0,1,1,100.0,0,1,0,1,0,1,0
377,Armando Broja,al,FW,,Southampton,Premier League,19,2001,21.9,12,5,2,7,3,2,9,22.2,7,17,1,16,3,15,11
378,Dylan Bronn,tn,DF,,Metz,Ligue 1,26,1995,28.3,47,29,33,13,1,20,31,64.5,11,32,19,13,40,87,78
379,John Brooks,us,DF,,Wolfsburg,Bundesliga,28,1993,29.1,47,25,25,18,4,36,60,60.0,24,33,19,14,41,88,125
380,Daniel Brosinski,de,DF,,Mainz 05,Bundesliga,33,1988,4.3,2,1,1,1,0,1,1,100.0,0,6,0,6,3,5,9
381,Josh Brownhill,eng,MF,,Burnley,Premier League,25,1995,32.8,73,37,25,42,6,21,53,39.6,32,37,12,25,68,141,42
382,Marcelo Brozović,hr,MF,,Inter,Serie A,28,1992,32.6,77,45,34,35,8,34,68,50.0,34,28,10,18,37,114,36
383,Cédric Brunner,ch,DF,,Arminia,Bundesliga,27,1994,24.3,51,35,29,20,2,25,49,51.0,24,27,10,17,43,94,84
384,Lewis Brunt,eng,MF,,Leicester City,Premier League,20,2000,0.3,0,0,0,0,0,0,0,,0,1,0,1,0,0,0
385,Jacob Bruun Larsen,dk,FW,MF,Hoffenheim,Bundesliga,22,1998,9.0,2,1,1,1,0,0,5,0.0,5,14,3,11,5,7,5
386,Ante Budimir,hr,FW,,Osasuna,La Liga,30,1991,19.3,24,10,3,15,6,6,19,31.6,13,22,4,18,3,27,16
387,Emi Buendía,ar,MF,FW,Aston Villa,Premier League,24,1996,21.1,38,18,16,13,9,21,51,41.2,30,21,3,18,9,47,11
388,Osman Bukari,gh,FW,MF,Nantes,Ligue 1,22,1998,11.2,18,8,7,6,5,8,22,36.4,14,8,0,8,8,26,1
389,Aleksander Buksa,pl,FW,,Genoa,Serie A,18,2003,0.7,0,0,0,0,0,0,1,0.0,1,0,0,0,0,0,1
390,Alessandro Buongiorno,it,DF,,Torino,Serie A,22,1999,13.1,20,9,9,8,3,9,13,69.2,4,12,6,6,31,51,44
391,Sascha Burchert,de,GK,,Greuther Fürth,Bundesliga,31,1989,14.0,1,1,1,0,0,1,2,50.0,1,0,0,0,0,1,11
392,Delano Burgzorg,sr,MF,,Mainz 05,Bundesliga,22,1998,0.3,1,1,1,0,0,0,1,0.0,1,0,0,0,0,1,0
393,Jonathan Burkardt,de,FW,MF,Mainz 05,Bundesliga,21,2000,29.0,17,8,0,10,7,6,25,24.0,19,31,5,26,8,25,16
394,Roman Bürki,ch,GK,,Dortmund,Bundesliga,30,1990,1.0,0,0,0,0,0,0,0,,0,0,0,0,0,0,0
395,Dan Burn,eng,DF,,Newcastle Utd,Premier League,29,1992,16.0,16,11,11,4,1,7,11,63.6,4,22,14,8,20,36,101
396,Dan Burn,eng,DF,,Brighton,Premier League,29,1992,11.4,22,12,13,8,1,6,15,40.0,9,14,10,4,24,46,51
397,Maxime Busi,be,DF,,Reims,Ligue 1,21,1999,14.4,26,15,20,5,1,19,36,52.8,17,19,5,14,17,43,28
398,Gianluca Busio,us,MF,,Venezia,Serie A,19,2002,21.7,53,28,27,20,6,28,63,44.4,35,45,13,32,21,74,30
399,Oriol Busquets,es,MF,,Clermont Foot,Ligue 1,22,1999,2.2,3,3,0,3,0,2,6,33.3,4,7,4,3,1,4,2
400,Sergio Busquets,es,MF,,Barcelona,La Liga,33,1988,35.5,93,49,31,48,14,46,83,55.4,37,44,8,36,45,138,31
401,Jack Butland,eng,GK,,Crystal Palace,Premier League,28,1993,8.5,0,0,0,0,0,0,0,,0,0,0,0,0,0,1
402,Adrián Butzke,es,FW,,Granada,La Liga,22,1999,0.0,0,0,0,0,0,0,0,,0,0,0,0,0,0,0
403,Marcin Bułka,pl,GK,,Nice,Ligue 1,21,1999,1.0,0,0,0,0,0,0,0,,0,0,0,0,0,0,0
404,Sam Byram,eng,DF,,Norwich City,Premier League,27,1993,11.4,24,15,17,6,1,19,27,70.4,8,21,11,10,22,46,48
405,Erick Cabaco,uy,DF,,Getafe,La Liga,26,1995,4.5,2,1,1,1,0,2,5,40.0,3,5,2,3,4,6,10
406,Willy Caballero,ar,GK,,Southampton,Premier League,39,1981,2.0,0,0,0,0,0,0,0,,0,0,0,0,0,0,2
407,Rémy Cabella,fr,MF,FW,Montpellier,Ligue 1,31,1990,3.5,15,7,4,8,3,5,15,33.3,10,7,0,7,5,20,1
408,Jimmy Cabot,fr,DF,,Angers,Ligue 1,27,1994,22.3,81,44,59,15,7,47,83,56.6,36,29,0,29,32,113,30
409,Arthur Cabral,br,FW,,Fiorentina,Serie A,23,1998,8.3,9,5,2,5,2,4,7,57.1,3,4,1,3,1,10,8
410,Jovane Cabral,cv,FW,,Lazio,Serie A,23,1998,2.1,2,1,1,0,1,0,0,,0,1,1,0,1,3,1
411,Leandro Cabrera,uy,DF,,Espanyol,La Liga,30,1991,37.0,37,24,27,10,0,21,34,61.8,13,32,23,9,44,81,222
412,Liberato Cacace,nz,DF,,Empoli,Serie A,20,2000,5.2,15,6,8,4,3,8,8,100.0,0,7,2,5,8,23,9
413,Martín Cáceres,uy,DF,,Cagliari,Serie A,34,1987,9.2,13,7,5,5,3,4,12,33.3,8,12,3,9,14,27,21
414,Martín Cáceres,uy,DF,,Levante,La Liga,34,1987,7.4,2,2,2,0,0,1,5,20.0,4,2,2,0,11,13,16
415,Anthony Caci,fr,DF,,Strasbourg,Ligue 1,24,1997,26.6,65,34,35,24,6,33,55,60.0,22,22,3,19,33,98,49
416,Mathieu Cafaro,fr,MF,FW,Reims,Ligue 1,24,1997,2.1,4,2,3,1,0,0,7,0.0,7,2,0,2,3,7,1
417,Yannick Cahuzac,fr,MF,,Lens,Ligue 1,36,1985,6.9,5,2,2,3,0,0,5,0.0,5,8,2,6,9,14,12
418,Felipe Caicedo,ec,FW,,Genoa,Serie A,32,1988,3.2,3,3,0,2,1,0,1,0.0,1,1,0,1,0,3,4
419,Felipe Caicedo,ec,FW,DF,Inter,Serie A,32,1988,0.3,0,0,0,0,0,0,0,,0,1,0,1,0,0,0
420,Moisés Caicedo,ec,MF,,Brighton,Premier League,19,2001,7.3,16,10,7,7,2,5,12,41.7,7,18,4,14,10,26,7
421,Marc-Aurèle Caillard,fr,GK,,Metz,Ligue 1,27,1994,17.1,0,0,0,0,0,0,2,0.0,2,0,0,0,2,2,9
422,Jens Cajuste,se,MF,FW,Reims,Ligue 1,21,1999,4.0,10,6,6,2,2,6,17,35.3,11,7,2,5,5,15,6
423,Cala,es,DF,,Cádiz,La Liga,31,1989,10.5,9,4,9,0,0,8,17,47.1,9,12,6,6,12,21,56
424,Davide Calabria,it,DF,,Milan,Serie A,24,1996,23.5,62,37,31,23,8,37,72,51.4,35,25,5,20,23,85,40
425,Riccardo Calafiori,it,DF,,Genoa,Serie A,19,2002,0.9,1,0,0,0,1,1,2,50.0,1,2,1,1,2,3,4
426,Riccardo Calafiori,it,DF,,Roma,Serie A,19,2002,1.9,5,4,2,2,1,1,5,20.0,4,3,0,3,3,8,1
427,Mattia Caldara,it,DF,,Venezia,Serie A,27,1994,30.0,48,28,30,15,3,20,34,58.8,14,49,37,12,62,110,147
428,Calderón,es,DF,,Betis,La Liga,21,2000,0.7,2,0,1,0,1,1,3,33.3,2,0,0,0,0,2,2
429,Fernando Calero,es,DF,,Espanyol,La Liga,25,1995,12.1,17,10,12,5,0,8,13,61.5,5,7,2,5,16,33,63
430,Duje Ćaleta-Car,hr,DF,,Marseille,Ligue 1,24,1996,22.9,21,8,15,6,0,11,14,78.6,3,11,7,4,24,45,55
431,Hakan Çalhanoğlu,tr,MF,,Inter,Serie A,27,1994,27.6,41,23,16,19,6,11,40,27.5,29,29,5,24,25,66,12
432,Daniel Caligiuri,it,DF,MF,Augsburg,Bundesliga,33,1988,22.3,46,30,17,26,3,27,72,37.5,45,36,5,31,18,64,33
433,José Callejón,es,FW,,Fiorentina,Serie A,34,1987,14.4,15,6,6,6,3,13,31,41.9,18,6,0,6,3,18,1
434,Lucas Calodat,fr,DF,,Saint-Étienne,Ligue 1,19,2002,0.0,0,0,0,0,0,0,0,,0,0,0,0,0,0,0
435,Dominic Calvert-Lewin,eng,FW,,Everton,Premier League,24,1997,14.3,11,8,1,6,4,3,8,37.5,5,5,2,3,3,14,12
436,Mahdi Camara,fr,MF,DF,Saint-Étienne,Ligue 1,23,1998,34.1,101,57,39,50,12,39,70,55.7,31,44,8,36,57,158,35
437,Mamadou Camara,ml,FW,,Troyes,Ligue 1,20,2001,0.4,1,1,1,0,0,0,0,,0,0,0,0,0,1,0
438,Víctor Camarasa,es,MF,FW,Betis,La Liga,27,1994,1.2,2,1,1,1,0,0,1,0.0,1,2,1,1,2,4,2
439,Eduardo Camavinga,fr,MF,,Real Madrid,La Liga,18,2002,13.7,52,35,22,20,10,20,38,52.6,18,20,2,18,17,69,14
440,Eduardo Camavinga,fr,MF,,Rennes,Ligue 1,18,2002,1.6,4,1,2,1,1,2,5,40.0,3,1,1,0,1,5,3
441,Andrea Cambiaso,it,DF,,Genoa,Serie A,21,2000,19.9,46,20,28,14,4,18,32,56.3,14,33,8,25,23,69,37
442,José Campaña,es,MF,,Levante,La Liga,28,1993,15.8,27,16,13,10,4,12,32,37.5,20,13,2,11,21,48,19
443,Chem Campbell,wls,MF,,Wolves,Premier League,18,2002,0.1,1,1,0,1,0,0,0,,0,0,0,0,0,1,0
444,Emre Can,de,DF,MF,Dortmund,Bundesliga,27,1994,18.8,36,22,20,16,0,15,30,50.0,15,26,10,16,36,72,40
445,Sergio Canales,es,FW,MF,Betis,La Liga,30,1991,31.0,24,14,8,12,4,10,35,28.6,25,16,1,15,10,34,12
446,Matteo Cancellieri,it,MF,DF,Hellas Verona,Serie A,19,2002,2.5,4,4,2,2,0,0,5,0.0,5,2,0,2,1,5,0
447,João Cancelo,pt,DF,,Manchester City,Premier League,27,1994,35.9,83,54,33,35,15,46,91,50.5,45,25,3,22,59,142,45
448,Fali Candé,gw,DF,,Metz,Ligue 1,23,1998,10.8,30,18,13,15,2,13,31,41.9,18,11,2,9,6,36,21
449,Antonio Candreva,it,MF,FW,Sampdoria,Serie A,34,1987,34.7,27,16,9,11,7,19,55,34.5,36,23,2,21,33,60,19
450,Sergi Canós,es,DF,FW,Brentford,Premier League,24,1997,23.1,56,25,32,15,9,33,60,55.0,27,32,3,29,22,78,38
451,Álex Cantero,es,FW,MF,Levante,La Liga,21,2000,6.8,6,4,2,3,1,1,8,12.5,7,2,0,2,1,7,0
452,Todd Cantwell,eng,FW,MF,Norwich City,Premier League,23,1998,4.9,15,13,8,6,1,6,17,35.3,11,2,0,2,3,18,2
453,Ander Capa,es,DF,,Athletic Club,La Liga,29,1992,0.0,0,0,0,0,0,0,0,,0,0,0,0,0,0,0
454,Pierrick Capelle,fr,MF,DF,Angers,Ligue 1,34,1987,13.3,36,24,16,17,3,18,52,34.6,34,12,1,11,16,52,20
455,Leonardo Capezzi,it,MF,,Salernitana,Serie A,26,1995,1.9,3,1,0,3,0,1,4,25.0,3,8,4,4,0,3,2
456,Étienne Capoue,fr,MF,,Villarreal,La Liga,33,1988,25.4,44,26,18,23,3,15,28,53.6,13,17,5,12,35,79,51
457,Gianluca Caprari,it,MF,FW,Hellas Verona,Serie A,28,1993,30.4,43,25,10,22,11,17,51,33.3,34,32,0,32,4,47,7
458,Francesco Caputo,it,FW,,Sampdoria,Serie A,33,1987,31.0,5,2,1,3,1,1,6,16.7,5,5,0,5,2,7,10
459,Francesco Caputo,it,FW,,Sassuolo,Serie A,33,1987,1.7,0,0,0,0,0,0,0,,0,0,0,0,0,0,0
460,Maxence Caqueret,fr,MF,,Lyon,Ligue 1,21,2000,25.9,73,40,29,36,8,30,80,37.5,50,38,10,28,43,116,26
461,Andrea Carboni,it,DF,,Cagliari,Serie A,20,2001,24.6,53,24,33,16,4,19,42,45.2,23,42,15,27,27,80,87
462,Isaac Carcelen,es,DF,MF,Cádiz,La Liga,28,1993,17.2,43,29,29,12,2,28,56,50.0,28,25,6,19,34,77,42
463,Cárdenas,es,GK,,Levante,La Liga,24,1997,24.0,1,1,1,0,0,0,3,0.0,3,0,0,0,1,2,19
464,Irvin Cardona,fr,FW,MF,Brest,Ligue 1,23,1997,14.8,13,7,5,4,4,3,16,18.8,13,10,0,10,5,18,17
465,Igor Carioca,br,DF,,Lorient,Ligue 1,24,1996,17.5,27,16,16,8,3,15,43,34.9,28,17,2,15,25,52,28
466,Carlo,es,MF,,Villarreal,La Liga,20,2001,0.1,0,0,0,0,0,0,0,,0,0,0,0,0,0,0
467,Diego Carlos,br,DF,,Sevilla,La Liga,28,1993,32.9,35,24,20,13,2,16,24,66.7,8,48,33,15,24,59,120
468,Carmona,es,DF,,Sevilla,La Liga,19,2002,0.3,0,0,0,0,0,0,0,,0,0,0,0,1,1,0
469,Yannick Carrasco,be,FW,MF,Atlético Madrid,La Liga,27,1993,28.7,34,19,16,12,6,19,44,43.2,25,26,5,21,19,53,12
470,Guido Carrillo,ar,FW,,Elche,La Liga,30,1991,13.0,7,4,2,4,1,3,13,23.1,10,9,2,7,1,8,27
471,Dani Carvajal,es,DF,,Real Madrid,La Liga,29,1992,17.2,43,28,21,15,7,15,26,57.7,11,22,8,14,20,63,38
472,William Carvalho,pt,MF,,Betis,La Liga,29,1992,20.1,49,33,20,25,4,15,40,37.5,25,18,7,11,16,65,20
473,Nicolò Casale,it,DF,,Hellas Verona,Serie A,23,1998,28.7,46,30,25,19,2,21,37,56.8,16,31,12,19,49,95,95
474,Casemiro,br,MF,,Real Madrid,La Liga,29,1992,28.5,79,51,45,30,4,30,67,44.8,37,65,19,46,38,117,65
475,Matty Cash,pl,DF,,Aston Villa,Premier League,23,1997,37.5,89,50,52,34,3,47,78,60.3,31,54,16,38,49,138,100
476,Kiko Casilla,es,GK,,Elche,La Liga,34,1986,14.0,0,0,0,0,0,0,1,0.0,1,0,0,0,1,1,2
477,Moreto Cassamã,gw,MF,,Reims,Ligue 1,23,1998,8.9,12,6,7,4,1,3,19,15.8,16,10,5,5,9,21,5
478,Francesco Cassata,it,MF,,Genoa,Serie A,24,1997,0.1,0,0,0,0,0,0,0,,0,0,0,0,0,0,0
479,Timothy Castagne,be,DF,,Leicester City,Premier League,25,1995,23.6,67,31,38,22,7,27,43,62.8,16,28,9,19,29,96,54
480,Koen Casteels,be,GK,,Wolfsburg,Bundesliga,29,1992,28.0,0,0,0,0,0,0,1,0.0,1,0,0,0,0,0,9
481,Jean-Charles Castelletto,cm,DF,,Nantes,Ligue 1,26,1995,27.9,45,24,27,17,1,25,35,71.4,10,38,27,11,30,75,73
482,Samu Castillejo,es,FW,MF,Milan,Serie A,26,1995,1.4,4,2,0,2,2,1,8,12.5,7,4,1,3,2,6,1
483,Gonzalo Castro,de,MF,FW,Arminia,Bundesliga,34,1987,4.8,8,3,4,4,0,1,5,20.0,4,3,0,3,3,11,3
484,Jonny Castro,es,DF,,Wolves,Premier League,27,1994,11.4,25,15,13,11,1,11,20,55.0,9,14,3,11,13,38,11
485,Gaetano Castrovilli,it,MF,,Fiorentina,Serie A,24,1997,15.5,25,17,15,6,4,12,23,52.2,11,18,4,14,11,36,6
486,Danilo Cataldi,it,MF,,Lazio,Serie A,26,1994,19.0,36,17,15,17,4,12,38,31.6,26,24,12,12,17,53,19
487,Catena,es,DF,,Rayo Vallecano,La Liga,26,1994,36.0,39,23,24,15,0,25,42,59.5,17,26,19,7,30,69,168
488,Craig Cathcart,nir,DF,,Watford,Premier League,32,1989,26.6,32,15,25,6,1,16,30,53.3,14,39,29,10,28,60,132
489,Edinson Cavani,uy,FW,,Manchester Utd,Premier League,34,1987,8.5,4,1,0,3,1,2,8,25.0,6,6,0,6,2,6,8
490,Dani Ceballos,es,MF,,Real Madrid,La Liga,24,1996,3.1,7,5,4,3,0,1,5,20.0,4,8,2,6,4,11,2
491,Pietro Ceccaroni,it,DF,,Venezia,Serie A,25,1995,34.7,55,31,33,18,4,25,36,69.4,11,45,32,13,30,85,143
492,Federico Ceccherini,it,DF,,Hellas Verona,Serie A,29,1992,26.2,32,16,19,10,3,19,33,57.6,14,13,8,5,50,82,76
493,Emil Ceide,no,FW,MF,Sassuolo,Serie A,19,2001,0.6,1,1,0,1,0,1,2,50.0,1,1,0,1,0,1,0
494,Zeki Çelik,tr,DF,,Lille,Ligue 1,24,1997,30.0,64,37,43,17,4,36,63,57.1,27,32,9,23,43,107,62
495,Fabien Centonze,fr,DF,,Metz,Ligue 1,25,1996,17.6,33,21,22,9,2,13,32,40.6,19,37,8,29,32,65,51
496,Luca Ceppitelli,it,DF,,Cagliari,Serie A,31,1989,16.1,23,12,13,10,0,16,27,59.3,11,21,14,7,25,48,54
497,Franco Cervi,ar,MF,,Celta Vigo,La Liga,27,1994,20.0,73,41,35,22,16,33,77,42.9,44,38,2,36,21,94,19
498,Damir Ceter,co,FW,,Cagliari,Serie A,23,1997,0.1,0,0,0,0,0,0,0,,0,0,0,0,0,0,0
499,Julian Chabot,de,DF,,Sampdoria,Serie A,23,1998,5.4,12,10,8,4,0,8,10,80.0,2,7,4,3,9,21,28
500,Julian Chabot,de,DF,,Köln,Bundesliga,23,1998,2.3,8,3,4,4,0,2,5,40.0,3,4,2,2,3,11,5
501,El Chadaille Bitshiabu,fr,DF,,Paris S-G,Ligue 1,16,2005,0.1,0,0,0,0,0,0,0,,0,0,0,0,0,0,2
502,Nassim Chadli,fr,MF,DF,Troyes,Ligue 1,20,2001,1.1,5,3,3,0,2,2,4,50.0,2,1,0,1,0,5,0
503,Kayky Chagas,br,FW,,Manchester City,Premier League,18,2003,0.1,0,0,0,0,0,0,0,,0,0,0,0,0,0,0
504,Mehdi Chahiri,ma,DF,,Strasbourg,Ligue 1,25,1996,0.2,1,1,1,0,0,1,1,100.0,0,0,0,0,0,1,0
505,Trevoh Chalobah,eng,DF,,Chelsea,Premier League,22,1999,16.1,40,27,22,18,0,24,31,77.4,7,16,6,10,19,59,43
506,Calum Chambers,eng,DF,,Arsenal,Premier League,26,1995,1.9,5,3,3,1,1,3,4,75.0,1,6,3,3,0,5,10
507,Calum Chambers,eng,DF,,Aston Villa,Premier League,26,1995,9.2,16,8,10,6,0,4,6,66.7,2,14,8,6,5,21,42
508,Dylan Chambost,fr,MF,FW,Troyes,Ligue 1,23,1997,8.4,16,11,6,9,1,4,25,16.0,21,9,2,7,8,24,4
509,Timothy Chandler,us,DF,,Eint Frankfurt,Bundesliga,31,1990,13.5,18,12,10,8,0,11,24,45.8,13,10,3,7,19,37,28
510,Chapela,es,MF,FW,Cádiz,La Liga,22,1999,4.4,4,2,1,0,3,2,4,50.0,2,6,1,5,4,8,5
511,Brendan Chardonnet,fr,DF,,Brest,Ligue 1,26,1994,29.8,44,25,32,11,1,29,40,72.5,11,42,29,13,55,99,141
512,Xavier Chavalerin,fr,MF,,Troyes,Ligue 1,30,1991,30.2,49,26,19,25,5,12,55,21.8,43,32,5,27,39,88,36
513,Xavier Chavalerin,fr,MF,,Reims,Ligue 1,30,1991,2.4,4,4,2,1,1,1,3,33.3,2,2,0,2,5,9,2
514,Justin Che,us,FW,DF,Hoffenheim,Bundesliga,17,2003,0.5,2,0,1,0,1,1,2,50.0,1,0,0,0,1,3,0
515,Chema,es,MF,,Getafe,La Liga,29,1992,0.5,0,0,0,0,0,0,1,0.0,1,0,0,0,0,0,0
516,Rayan Cherki,fr,FW,MF,Lyon,Ligue 1,17,2003,4.9,6,2,1,3,2,4,9,44.4,5,2,0,2,1,7,0
517,Denis Cheryshev,ru,MF,FW,Valencia,La Liga,30,1990,6.3,14,5,6,1,7,6,15,40.0,9,9,1,8,9,23,9
518,Daniel Chesters,eng,MF,,West Ham,Premier League,19,2002,0.0,0,0,0,0,0,0,0,,0,0,0,0,0,0,0
519,Giorgio Chiellini,it,DF,,Juventus,Serie A,36,1984,15.0,22,13,17,4,1,7,13,53.8,6,24,18,6,22,44,59
520,Federico Chiesa,it,MF,FW,Juventus,Serie A,23,1997,9.6,26,19,9,9,8,12,26,46.2,14,7,0,7,4,30,3
521,Ben Chilwell,eng,DF,,Chelsea,Premier League,24,1996,6.0,8,3,2,6,0,2,5,40.0,3,7,0,7,4,12,14
522,Chiquinho,pt,DF,FW,Wolves,Premier League,21,2000,2.3,9,6,4,5,0,4,5,80.0,1,5,0,5,2,11,1
523,Vlad Chiricheș,ro,DF,,Sassuolo,Serie A,31,1989,25.6,28,15,19,9,0,10,21,47.6,11,34,21,13,41,69,71
524,Pedro Chirivella,es,MF,,Nantes,Ligue 1,24,1997,29.3,49,31,14,26,9,25,70,35.7,45,23,2,21,37,86,11
525,Joris Chotard,fr,MF,,Montpellier,Ligue 1,19,2001,32.6,59,30,33,23,3,36,78,46.2,42,27,15,12,42,101,56
526,Hamza Choudhury,eng,DF,MF,Leicester City,Premier League,23,1997,3.2,9,3,4,4,1,3,5,60.0,2,0,0,0,12,21,10
527,Andreas Christensen,dk,DF,,Chelsea,Premier League,25,1996,16.6,14,8,9,4,1,4,7,57.1,3,14,6,8,29,43,57
528,Max Christiansen,de,MF,,Greuther Fürth,Bundesliga,24,1996,22.8,46,25,19,22,5,18,43,41.9,25,52,16,36,68,114,56
529,Carney Chukwuemeka,eng,MF,FW,Aston Villa,Premier League,17,2003,3.3,7,1,2,5,0,3,5,60.0,2,3,0,3,1,8,2
530,Samuel Chukwueze,ng,MF,FW,Villarreal,La Liga,22,1999,14.8,13,9,6,5,2,3,6,50.0,3,7,0,7,5,18,4
531,Víctor Chust,es,DF,,Cádiz,La Liga,21,2000,20.3,19,10,14,4,1,11,17,64.7,6,20,8,12,16,35,87
532,Riccardo Ciervo,it,MF,DF,Sampdoria,Serie A,19,2002,2.5,8,3,4,3,1,2,6,33.3,4,1,0,1,2,10,2
533,Jasper Cillessen,nl,GK,,Valencia,La Liga,32,1989,16.2,0,0,0,0,0,0,1,0.0,1,0,0,0,1,1,6
534,Pathé Ciss,sn,MF,,Rayo Vallecano,La Liga,27,1994,12.2,31,15,20,8,3,12,26,46.2,14,16,6,10,30,61,27
535,Moustapha Cissé,gn,FW,,Atalanta,Serie A,17,2003,0.4,1,0,0,1,0,0,3,0.0,3,0,0,0,0,1,0
536,Giorgio Cittadini,it,DF,,Atalanta,Serie A,19,2002,0.0,0,0,0,0,0,0,0,,0,0,0,0,1,1,0
537,Ciaran Clark,ie,DF,,Newcastle Utd,Premier League,31,1989,11.3,13,10,4,7,2,9,14,64.3,5,14,11,3,13,26,43
538,Alexis Claude-Maurice,fr,MF,,Nice,Ligue 1,23,1998,2.3,2,0,1,0,1,1,4,25.0,3,7,0,7,3,5,1
539,Jonathan Clauss,fr,DF,,Lens,Ligue 1,28,1992,33.8,63,34,33,20,10,22,55,40.0,33,43,1,42,73,136,51
540,Carlos Clerc,es,DF,,Levante,La Liga,29,1992,16.8,35,17,21,10,4,7,19,36.8,12,8,3,5,26,61,32
541,Tom Cleverley,eng,MF,,Watford,Premier League,31,1989,18.0,37,20,19,17,1,18,33,54.5,15,23,6,17,18,55,19
542,Nathaniel Clyne,eng,DF,,Crystal Palace,Premier League,30,1991,15.0,21,10,11,9,1,10,20,50.0,10,7,2,5,15,36,32
543,Conor Coady,eng,DF,,Wolves,Premier League,28,1993,37.3,31,14,23,7,1,16,28,57.1,12,46,40,6,28,59,140
544,Marcus Coco,fr,MF,FW,Nantes,Ligue 1,25,1996,10.3,34,14,17,11,6,8,18,44.4,10,11,1,10,10,44,15
545,Coke,es,DF,,Levante,La Liga,34,1987,1.3,3,2,1,1,1,3,4,75.0,1,1,0,1,2,5,7
546,Séamus Coleman,ie,DF,,Everton,Premier League,32,1988,29.5,61,36,35,16,10,33,51,64.7,18,30,11,19,32,93,80
547,Álex Collado,es,MF,FW,Granada,La Liga,22,1999,11.3,27,12,6,16,5,12,31,38.7,19,28,2,26,6,33,11
548,Ebrima Colley,gm,FW,MF,Spezia,Serie A,21,2000,4.4,6,1,3,2,1,1,7,14.3,6,8,0,8,3,9,2
549,Omar Colley,gm,DF,,Sampdoria,Serie A,28,1992,30.5,47,36,32,14,1,22,32,68.8,10,31,19,12,80,127,135
550,Nathan Collins,ie,DF,,Burnley,Premier League,20,2001,18.6,37,15,27,8,2,17,27,63.0,10,38,25,13,24,61,83
551,Kingsley Coman,fr,FW,DF,Bayern Munich,Bundesliga,25,1996,15.1,14,8,1,9,4,5,16,31.3,11,14,0,14,8,22,5
552,Eray Cömert,ch,DF,,Valencia,La Liga,23,1998,4.5,5,3,4,1,0,3,6,50.0,3,3,2,1,2,7,6
553,Santi Comesaña,es,MF,,Rayo Vallecano,La Liga,24,1996,29.8,87,56,45,33,9,40,104,38.5,64,46,6,40,33,120,30
554,Diego Conde,es,GK,,Getafe,La Liga,22,1998,0.1,0,0,0,0,0,0,0,,0,0,0,0,0,0,0
555,Aaron Connolly,ie,FW,MF,Brighton,Premier League,21,2000,1.7,0,0,0,0,0,0,1,0.0,1,2,0,2,0,0,0
556,Andrea Consigli,it,GK,,Sassuolo,Serie A,34,1987,36.9,0,0,0,0,0,0,2,0.0,2,0,0,0,0,0,23
557,Abdu Conté,pt,DF,,Troyes,Ligue 1,23,1998,15.0,22,12,16,5,1,12,24,50.0,12,12,2,10,4,26,10
558,Andrea Conti,it,DF,MF,Sampdoria,Serie A,27,1994,2.6,4,2,2,1,1,3,6,50.0,3,4,0,4,7,11,4
559,Andrea Conti,it,DF,,Milan,Serie A,27,1994,0.1,0,0,0,0,0,0,0,,0,0,0,0,0,0,0
560,Liam Cooper,sct,DF,,Leeds United,Premier League,29,1991,20.2,41,23,27,13,1,23,33,69.7,10,29,18,11,43,84,72
561,Lucas Copado,de,FW,,Bayern Munich,Bundesliga,17,2004,0.2,1,0,1,0,0,1,1,100.0,0,0,0,0,0,1,0
562,Diego Coppola,it,DF,,Hellas Verona,Serie A,17,2003,2.8,8,4,4,4,0,3,3,100.0,0,5,1,4,4,12,5
563,Francis Coquelin,fr,MF,,Villarreal,La Liga,30,1991,9.2,26,17,9,11,6,11,20,55.0,9,15,5,10,19,45,11
564,Sébastien Corchia,fr,DF,,Nantes,Ligue 1,30,1990,14.7,33,20,17,11,5,24,42,57.1,18,24,3,21,13,46,36
565,Sergio Córdova,ve,FW,MF,Augsburg,Bundesliga,23,1997,3.6,4,3,2,2,0,1,2,50.0,1,4,0,4,0,4,4
566,Jack Cork,eng,MF,,Burnley,Premier League,32,1989,18.6,20,6,6,11,3,7,20,35.0,13,17,4,13,17,37,29
567,Maxwel Cornet,ci,FW,MF,Burnley,Premier League,24,1996,19.6,16,9,7,5,4,7,15,46.7,8,13,4,9,10,26,14
568,Maxwel Cornet,ci,DF,,Lyon,Ligue 1,24,1996,0.7,3,1,1,0,2,3,4,75.0,1,0,0,0,1,4,1
569,Jesús Corona,mx,FW,DF,Sevilla,La Liga,28,1993,12.9,12,7,7,5,0,3,6,50.0,3,4,0,4,8,20,6
570,Ángel Correa,ar,FW,MF,Atlético Madrid,La Liga,26,1995,20.6,16,8,5,10,1,7,29,24.1,22,25,2,23,10,26,4
571,Joaquín Correa,ar,FW,,Inter,Serie A,26,1994,11.4,11,5,2,6,3,1,13,7.7,12,8,1,7,3,14,2
572,Thierry Correia,pt,DF,,Valencia,La Liga,22,1999,15.7,35,23,26,6,3,14,29,48.3,15,20,5,15,19,54,27
573,Danny da Costa,de,DF,MF,Eint Frankfurt,Bundesliga,28,1993,8.1,15,4,6,7,2,6,18,33.3,12,14,1,13,11,26,18
574,David Costa,pt,MF,FW,Lens,Ligue 1,20,2001,16.3,22,12,9,6,7,11,26,42.3,15,12,0,12,13,35,5
575,Hélder Costa,ao,MF,,Leeds United,Premier League,27,1994,0.2,0,0,0,0,0,0,0,,0,1,0,1,0,0,0
576,Hélder Costa,ao,MF,FW,Valencia,La Liga,27,1994,12.4,27,16,11,9,7,14,41,34.1,27,12,1,11,3,30,9
577,Jaume Costa,es,DF,,Mallorca,La Liga,33,1988,20.3,35,26,23,7,5,23,31,74.2,8,22,7,15,23,58,55
578,Benoît Costil,fr,GK,,Bordeaux,Ligue 1,34,1987,25.0,1,0,1,0,0,1,2,50.0,1,0,0,0,0,1,6
579,Vladimír Coufal,cz,DF,,West Ham,Premier League,28,1992,24.5,45,25,24,14,7,18,36,50.0,18,31,9,22,22,67,64
580,Kalifa Coulibaly,ml,FW,,Nantes,Ligue 1,29,1991,9.4,5,1,1,1,3,0,4,0.0,4,2,2,0,0,5,11
581,Lassana Coulibaly,ml,MF,,Salernitana,Serie A,25,1996,25.9,58,32,29,26,3,24,62,38.7,38,40,13,27,22,80,27
582,Mamadou Coulibaly,sn,MF,,Salernitana,Serie A,22,1999,9.0,15,12,8,5,2,7,20,35.0,13,9,0,9,11,26,9
583,Tanguy Coulibaly,fr,FW,MF,Stuttgart,Bundesliga,20,2001,12.0,27,15,14,11,2,9,19,47.4,10,14,2,12,4,31,10
584,Thibaut Courtois,be,GK,,Real Madrid,La Liga,29,1992,36.0,1,0,1,0,0,1,2,50.0,1,0,0,0,0,1,9
585,Philippe Coutinho,br,MF,FW,Aston Villa,Premier League,29,1992,14.8,17,12,4,11,2,6,21,28.6,15,11,1,10,7,24,4
586,Philippe Coutinho,br,MF,FW,Barcelona,La Liga,29,1992,5.6,6,3,3,3,0,3,11,27.3,8,3,0,3,4,10,3
587,Nicolas Cozza,fr,DF,,Montpellier,Ligue 1,22,1999,30.8,80,47,50,23,7,35,65,53.8,30,35,19,16,38,118,82
588,Alessio Cragno,it,GK,,Cagliari,Serie A,27,1994,35.0,3,3,2,1,0,3,3,100.0,0,0,0,0,1,4,14
589,Aaron Cresswell,eng,DF,,West Ham,Premier League,31,1989,30.3,28,18,18,6,4,13,25,52.0,12,31,18,13,35,63,66
590,Charlie Cresswell,eng,DF,,Leeds United,Premier League,18,2002,1.6,5,2,1,4,0,3,3,100.0,0,1,1,0,2,7,6
591,Domenico Criscito,it,DF,,Genoa,Serie A,34,1986,18.0,37,21,19,14,4,16,25,64.0,9,22,12,10,39,76,57
592,Bryan Cristante,it,MF,,Roma,Serie A,26,1995,29.8,79,39,31,39,9,37,69,53.6,32,31,5,26,40,119,45
593,Cristo,es,DF,,Real Sociedad,La Liga,21,2000,0.2,0,0,0,0,0,0,0,,0,0,0,0,0,0,0
594,Enzo Crivelli,fr,FW,MF,Saint-Étienne,Ligue 1,26,1995,1.1,1,0,0,0,1,0,0,,0,0,0,0,0,1,1
595,Domen Črnigoj,si,MF,,Venezia,Serie A,25,1995,20.9,21,13,7,11,3,11,29,37.9,18,27,8,19,24,45,42
596,Giovanni Crociata,it,FW,,Empoli,Serie A,23,1997,0.2,0,0,0,0,0,0,1,0.0,1,0,0,0,0,0,0
597,Juan Cruz Armada,es,DF,,Osasuna,La Liga,29,1992,21.5,28,21,15,12,1,8,16,50.0,8,15,12,3,16,44,58
598,Juan Cuadrado,co,DF,MF,Juventus,Serie A,33,1988,27.6,48,23,30,13,5,30,55,54.5,25,23,5,18,29,77,34
599,Cucho,co,FW,MF,Watford,Premier League,22,1999,12.7,13,5,5,5,3,5,27,18.5,22,13,1,12,5,18,9
600,Marc Cucurella,es,DF,,Brighton,Premier League,23,1998,34.3,93,62,43,32,18,44,71,62.0,27,42,14,28,30,123,74
601,Marc Cucurella,es,MF,DF,Getafe,La Liga,23,1998,0.3,0,0,0,0,0,0,0,,0,0,0,0,0,0,0
602,Jorge Cuenca,es,DF,,Getafe,La Liga,21,1999,29.8,46,32,30,15,1,21,28,75.0,7,29,14,15,39,85,155
603,Mickaël Cuisance,fr,MF,,Venezia,Serie A,21,1999,10.2,23,9,7,12,4,10,28,35.7,18,14,0,14,12,35,5
604,Mickaël Cuisance,fr,MF,,Bayern Munich,Bundesliga,21,1999,0.1,1,1,0,1,0,0,0,,0,0,0,0,0,1,0
605,Luke Cundle,eng,MF,,Wolves,Premier League,19,2002,2.0,4,3,0,4,0,1,1,100.0,0,0,0,0,1,5,1
606,Matheus Cunha,br,FW,,Atlético Madrid,La Liga,22,1999,11.8,19,12,3,11,5,5,20,25.0,15,18,2,16,6,25,9
607,Matheus Cunha,br,FW,,Hertha BSC,Bundesliga,22,1999,0.7,0,0,0,0,0,0,0,,0,0,0,0,0,0,0
608,Patrick Cutrone,it,FW,,Empoli,Serie A,23,1998,15.6,5,2,0,3,2,1,9,11.1,8,11,1,10,5,10,1
609,Wylan Cyprien,fr,MF,,Nantes,Ligue 1,26,1995,16.6,33,17,12,18,3,13,32,40.6,19,16,6,10,10,43,14
610,Rafael Czichos,de,DF,,Köln,Bundesliga,31,1990,15.6,29,18,18,9,2,14,28,50.0,14,23,13,10,19,48,53
611,Lennart-Marten Czyborra,de,DF,,Arminia,Bundesliga,22,1999,1.5,0,0,0,0,0,0,2,0.0,2,0,0,0,3,3,3
612,Danilo D'Ambrosio,it,DF,,Inter,Serie A,32,1988,11.1,30,15,21,8,1,11,22,50.0,11,21,10,11,8,38,20
613,Lucas Da Cunha,fr,MF,,Nice,Ligue 1,20,2001,4.4,13,7,2,7,4,6,11,54.5,5,2,0,2,1,14,2
614,Lucas Da Cunha,fr,FW,MF,Clermont Foot,Ligue 1,20,2001,9.3,17,11,5,8,4,9,18,50.0,9,13,0,13,1,18,3
615,Damien Da Silva,fr,DF,,Lyon,Ligue 1,33,1988,12.5,13,9,7,5,1,5,9,55.6,4,15,10,5,22,35,53
616,Moanes Dabbur,il,FW,MF,Hoffenheim,Bundesliga,29,1992,14.6,18,10,3,5,10,4,17,23.5,13,10,0,10,5,23,4
617,Colin Dagba,fr,DF,,Paris S-G,Ligue 1,22,1998,1.8,4,2,2,2,0,3,6,50.0,3,4,2,2,2,6,1
618,Finn Dahmen,de,GK,,Mainz 05,Bundesliga,23,1998,2.0,0,0,0,0,0,0,0,,0,0,0,0,0,0,2
619,Mahmoud Dahoud,de,MF,,Dortmund,Bundesliga,25,1996,18.4,42,19,10,24,8,20,46,43.5,26,18,3,15,17,59,16
620,Patson Daka,zm,FW,,Leicester City,Premier League,22,1998,12.9,15,10,2,8,5,2,19,10.5,17,7,0,7,2,17,8
621,Stuart Dallas,nir,DF,MF,Leeds United,Premier League,30,1991,32.4,93,55,58,31,4,56,105,53.3,49,45,14,31,57,150,63
622,Diogo Dalot,pt,DF,,Manchester Utd,Premier League,22,1999,20.0,55,41,35,12,8,31,57,54.4,26,24,13,11,29,84,59
623,Mikkel Damsgaard,dk,MF,FW,Sampdoria,Serie A,21,2000,6.4,27,13,12,11,4,20,36,55.6,16,16,1,15,7,34,7
624,Flavius Daniliuc,at,DF,,Nice,Ligue 1,20,2001,14.4,46,31,26,17,3,34,43,79.1,9,13,7,6,14,60,34
625,Danilo,br,DF,MF,Juventus,Serie A,30,1991,21.0,37,26,20,13,4,18,28,64.3,10,21,12,9,32,69,53
626,Arnaut Danjuma,nl,FW,,Villarreal,La Liga,24,1997,16.4,7,6,3,0,4,2,4,50.0,2,5,0,5,2,9,3
627,Kevin Danso,at,DF,,Lens,Ligue 1,22,1998,31.0,41,29,29,12,0,23,34,67.6,11,38,25,13,40,81,111
628,Dante,br,DF,,Nice,Ligue 1,37,1983,31.9,42,29,30,12,0,23,33,69.7,10,43,27,16,49,91,96
629,Ebrima Darboe,gm,MF,,Roma,Serie A,20,2001,0.7,1,1,0,1,0,0,0,,0,0,0,0,1,2,0
630,Márton Dárdai,hu,DF,,Hertha BSC,Bundesliga,19,2002,8.4,10,4,8,2,0,8,18,44.4,10,16,6,10,20,30,33
631,Sergi Darder,es,MF,,Espanyol,La Liga,27,1993,34.7,45,22,16,19,10,18,54,33.3,36,16,1,15,26,71,32
632,Vladimír Darida,cz,MF,,Hertha BSC,Bundesliga,30,1990,19.8,32,18,15,13,4,13,32,40.6,19,22,3,19,20,52,17
633,Karl Darlow,wls,GK,,Newcastle Utd,Premier League,30,1990,8.0,0,0,0,0,0,0,0,,0,0,0,0,0,0,5
634,Matteo Darmian,it,DF,,Inter,Serie A,31,1989,16.7,32,16,17,9,6,16,41,39.0,25,16,1,15,19,51,25
635,Josh Dasilva,eng,MF,FW,Brentford,Premier League,22,1998,2.9,2,1,0,1,1,1,2,50.0,1,3,0,3,1,3,7
636,Jonathan David,ca,FW,,Lille,Ligue 1,21,2000,31.2,24,9,7,11,6,9,30,30.0,21,14,4,10,5,29,15
637,Alphonso Davies,ca,DF,,Bayern Munich,Bundesliga,20,2000,19.3,34,17,17,8,9,13,31,41.9,18,27,1,26,23,57,26
638,Ben Davies,wls,DF,,Tottenham,Premier League,28,1993,28.2,36,21,20,12,4,13,26,50.0,13,32,19,13,30,66,75
639,Tom Davies,eng,MF,,Everton,Premier League,23,1998,2.6,3,1,1,1,1,2,5,40.0,3,2,1,1,2,5,9
640,Keinan Davis,eng,FW,,Aston Villa,Premier League,23,1998,0.1,0,0,0,0,0,0,0,,0,0,0,0,0,0,0
641,Paweł Dawidowicz,pl,DF,,Hellas Verona,Serie A,26,1995,13.3,30,18,16,10,4,16,25,64.0,9,14,11,3,21,51,53
642,Craig Dawson,eng,DF,,West Ham,Premier League,31,1990,30.6,29,17,20,8,1,14,25,56.0,11,59,52,7,29,58,139
643,Kevin De Bruyne,be,MF,,Manchester City,Premier League,30,1991,24.5,32,16,4,15,13,12,37,32.4,25,32,2,30,6,38,16
644,Konrad De La Fuente,us,FW,MF,Marseille,Ligue 1,20,2001,8.7,11,7,8,2,1,7,11,63.6,4,5,0,5,2,13,4
645,Sebastien De Maio,fr,DF,,Udinese,Serie A,34,1987,2.0,5,1,4,1,0,1,9,11.1,8,6,5,1,1,6,9
646,Tommaso De Nipoti,it,FW,,Atalanta,Serie A,18,2003,0.1,0,0,0,0,0,0,0,,0,0,0,0,0,0,0
647,Rodrigo De Paul,ar,MF,,Atlético Madrid,La Liga,27,1994,23.9,55,30,22,25,8,30,60,50.0,30,24,3,21,21,76,17
648,Mattia De Sciglio,it,DF,,Juventus,Serie A,28,1992,13.0,24,12,7,9,8,11,24,45.8,13,10,0,10,10,34,30
649,Lorenzo De Silvestri,it,DF,,Bologna,Serie A,33,1988,25.5,23,14,13,8,2,9,31,29.0,22,25,7,18,26,49,52
650,Saulo Decarli,ch,DF,,Bochum,Bundesliga,29,1992,0.1,0,0,0,0,0,0,0,,0,0,0,0,0,0,0
651,Troy Deeney,eng,FW,,Watford,Premier League,33,1988,0.3,0,0,0,0,0,0,1,0.0,1,0,0,0,0,0,2
652,Grégoire Defrel,mq,FW,,Sassuolo,Serie A,30,1991,15.1,15,9,4,8,3,6,16,37.5,10,11,1,10,4,19,11
653,Alessandro Deiola,it,MF,,Cagliari,Serie A,25,1995,23.7,47,22,15,25,7,23,58,39.7,35,28,10,18,26,73,45
654,Romain Del Castillo,fr,MF,FW,Rennes,Ligue 1,25,1996,0.3,2,1,0,1,1,2,2,100.0,0,0,0,0,1,3,0
655,Romain Del Castillo,fr,MF,FW,Brest,Ligue 1,25,1996,10.8,27,16,3,17,7,12,31,38.7,19,12,0,12,7,34,3
656,Thomas Delaine,fr,DF,,Metz,Ligue 1,29,1992,25.7,48,35,34,12,2,22,42,52.4,20,20,7,13,27,75,31
657,Thomas Delaney,dk,MF,,Sevilla,La Liga,29,1991,17.2,41,24,17,21,3,16,30,53.3,14,19,10,9,13,54,35
658,Thomas Delaney,dk,MF,,Dortmund,Bundesliga,29,1991,0.2,0,0,0,0,0,0,0,,0,0,0,0,0,0,0
659,Liam Delap,eng,FW,,Manchester City,Premier League,18,2003,0.1,0,0,0,0,0,0,0,,0,0,0,0,0,0,0
660,Sacha Delaye,fr,MF,FW,Montpellier,Ligue 1,19,2002,2.8,8,6,3,2,3,2,8,25.0,6,1,0,1,1,9,1
661,Filippo Delli Carri,it,DF,,Salernitana,Serie A,22,1999,3.7,6,4,4,2,0,5,14,35.7,9,6,2,4,4,10,14
662,Andy Delort,dz,FW,,Nice,Ligue 1,29,1991,27.2,15,9,3,5,7,7,12,58.3,5,13,4,9,9,24,14
663,Andy Delort,dz,FW,,Montpellier,Ligue 1,29,1991,3.0,2,0,0,1,1,0,1,0.0,1,1,0,1,0,2,4
664,Fabian Delph,eng,MF,,Everton,Premier League,31,1989,7.4,18,15,10,7,1,8,21,38.1,13,12,5,7,14,32,10
665,Moussa Dembélé,fr,FW,,Lyon,Ligue 1,25,1996,24.5,18,9,5,5,8,6,15,40.0,9,13,0,13,8,26,30
666,Ousmane Dembélé,fr,FW,,Barcelona,La Liga,24,1997,15.7,24,16,6,10,8,7,23,30.4,16,8,0,8,8,32,3
667,Yusuf Demir,at,FW,,Barcelona,La Liga,18,2003,2.1,3,1,1,1,1,2,5,40.0,3,1,0,1,2,5,1
668,Merih Demiral,tr,DF,,Atalanta,Serie A,23,1998,21.3,31,17,18,12,1,15,28,53.6,13,26,14,12,58,89,68
669,Kerem Demirbay,de,MF,,Leverkusen,Bundesliga,28,1993,22.8,52,31,19,30,3,16,41,39.0,25,32,9,23,33,85,21
670,Ermedin Demirović,ba,FW,,Freiburg,Bundesliga,23,1998,9.7,12,6,4,4,4,1,10,10.0,9,14,1,13,1,13,7
671,Diego Demme,de,MF,,Napoli,Serie A,29,1991,7.7,21,12,4,13,4,10,21,47.6,11,11,2,9,9,30,2
672,Jason Denayer,be,DF,,Lyon,Ligue 1,26,1995,11.1,11,4,8,3,0,6,7,85.7,1,8,7,1,16,27,52
673,Leander Dendoncker,be,MF,,Wolves,Premier League,26,1995,21.7,42,17,25,14,3,22,50,44.0,28,37,10,27,9,51,38
674,Emmanuel Dennis,ng,FW,MF,Watford,Premier League,23,1997,28.7,51,35,20,22,9,17,52,32.7,35,36,2,34,15,66,13
675,Fabio Depaoli,it,DF,,Hellas Verona,Serie A,24,1997,7.8,12,7,6,4,2,1,7,14.3,6,9,2,7,8,20,14
676,Fabio Depaoli,it,MF,DF,Sampdoria,Serie A,24,1997,1.2,3,1,1,2,0,0,2,0.0,2,2,1,1,1,4,2
677,Mike van der Hoorn,nl,DF,,Arminia,Bundesliga,28,1992,0.2,1,0,1,0,0,0,0,,0,0,0,0,1,2,2
678,Arthur Desmas,fr,GK,,Clermont Foot,Ligue 1,27,1994,14.5,0,0,0,0,0,0,3,0.0,3,0,0,0,0,0,1
679,Sergiño Dest,us,DF,FW,Barcelona,La Liga,20,2000,16.8,32,15,21,10,1,13,18,72.2,5,22,4,18,2,34,18
680,Mattia Destro,it,FW,,Genoa,Serie A,30,1991,19.4,9,4,1,4,4,1,6,16.7,5,14,1,13,2,11,16
681,Gerard Deulofeu,es,FW,MF,Udinese,Serie A,27,1994,29.1,11,6,2,3,6,7,29,24.1,22,14,0,14,9,20,4
682,Kiernan Dewsbury-Hall,eng,MF,,Leicester City,Premier League,22,1998,23.4,39,24,20,14,5,19,40,47.5,21,37,8,29,21,60,26
683,Jacopo Dezi,it,MF,,Venezia,Serie A,29,1992,0.2,0,0,0,0,0,0,1,0.0,1,0,0,0,1,1,0
684,Samuel Di Carmine,it,FW,,Hellas Verona,Serie A,32,1988,0.4,0,0,0,0,0,0,0,,0,0,0,0,0,0,0
685,Federico Di Francesco,it,FW,MF,Empoli,Serie A,27,1994,15.2,16,5,2,8,6,9,23,39.1,14,17,1,16,9,25,11
686,Giovanni Di Lorenzo,it,DF,,Napoli,Serie A,27,1993,31.9,58,36,30,20,8,33,58,56.9,25,28,10,18,38,96,46
687,Ángel Di María,ar,FW,,Paris S-G,Ligue 1,33,1988,18.3,29,18,6,13,10,14,37,37.8,23,17,0,17,6,35,3
688,Francesco Di Mariano,it,FW,,Venezia,Serie A,25,1996,0.7,1,1,0,1,0,0,0,,0,2,1,1,0,1,0
689,Francesco Di Tacchio,it,MF,,Salernitana,Serie A,31,1990,13.9,17,7,5,10,2,9,25,36.0,16,16,8,8,22,39,25
690,Boulaye Dia,sn,FW,,Villarreal,La Liga,24,1996,14.1,8,6,3,4,1,2,5,40.0,3,6,1,5,5,13,4
691,Moussa Diaby,fr,FW,MF,Leverkusen,Bundesliga,22,1999,30.7,20,11,8,9,3,5,38,13.2,33,11,0,11,8,28,2
692,Yadaly Diaby,gn,FW,MF,Clermont Foot,Ligue 1,20,2000,0.7,0,0,0,0,0,0,1,0.0,1,0,0,0,2,2,2
693,Mouctar Diakhaby,gn,DF,,Valencia,La Liga,24,1996,21.6,35,24,18,15,2,13,23,56.5,10,29,17,12,30,65,87
694,Ibrahim Diakité,gn,MF,,Reims,Ligue 1,17,2003,0.0,0,0,0,0,0,0,1,0.0,1,0,0,0,0,0,0
695,Abdou Diallo,sn,DF,,Paris S-G,Ligue 1,25,1996,9.7,22,14,10,9,3,8,14,57.1,6,6,2,4,10,32,19
696,Habib Diallo,sn,FW,,Strasbourg,Ligue 1,26,1995,17.1,9,5,0,8,1,0,8,0.0,8,13,4,9,4,13,11
697,Ibrahima Diallo,fr,MF,,Southampton,Premier League,22,1999,11.4,22,11,10,9,3,10,24,41.7,14,7,0,7,9,31,10
698,Habib Diarra,sn,MF,,Strasbourg,Ligue 1,17,2004,1.2,2,1,1,1,0,1,1,100.0,0,0,0,0,0,2,0
699,Stéphane Diarra,fr,MF,FW,Lorient,Ligue 1,22,1998,5.8,11,9,7,3,1,5,10,50.0,5,4,0,4,7,18,1
700,Rúben Dias,pt,DF,,Manchester City,Premier League,24,1997,26.7,26,19,11,12,3,8,15,53.3,7,19,13,6,23,49,66
701,Krépin Diatta,sn,MF,DF,Monaco,Ligue 1,22,1999,3.2,3,2,1,0,2,1,3,33.3,2,2,0,2,1,4,0
702,Amadou Diawara,gn,MF,,Roma,Serie A,24,1997,1.9,7,2,5,2,0,1,3,33.3,2,2,0,2,0,7,1
703,Brahim Díaz,ma,MF,,Milan,Serie A,21,1999,20.6,23,17,3,11,9,8,22,36.4,14,11,0,11,8,31,4
704,Javier Díaz,es,GK,,Sevilla,La Liga,24,1997,1.0,0,0,0,0,0,0,0,,0,0,0,0,0,0,0
705,Luis Díaz,co,FW,,Liverpool,Premier League,24,1997,10.6,9,7,3,5,1,2,8,25.0,6,7,0,7,4,13,2
706,Víctor Díaz,es,DF,,Granada,La Liga,33,1988,16.7,23,15,14,9,0,12,25,48.0,13,19,11,8,17,40,71
707,Daniel Didavi,de,MF,FW,Stuttgart,Bundesliga,31,1990,3.1,6,2,0,4,2,4,7,57.1,3,4,1,3,1,7,1
708,Bamba Dieng,sn,FW,,Marseille,Ligue 1,21,2000,10.8,17,11,5,5,7,4,14,28.6,10,7,0,7,5,22,8
709,Eric Dier,eng,DF,,Tottenham,Premier League,27,1994,34.1,15,9,6,8,1,7,14,50.0,7,37,32,5,27,42,142
710,Elhadji Dieye,sn,FW,MF,Saint-Étienne,Ligue 1,19,2002,0.4,3,2,2,1,0,0,1,0.0,1,2,0,2,1,4,0
711,Lucas Digne,fr,DF,,Aston Villa,Premier League,28,1993,14.1,13,10,8,3,2,9,19,47.4,10,15,8,7,23,36,40
712,Lucas Digne,fr,DF,,Everton,Premier League,28,1993,13.0,33,19,26,4,3,21,28,75.0,7,16,5,11,14,47,30
713,Mitchell Dijks,nl,DF,FW,Bologna,Serie A,28,1993,7.7,15,6,6,6,3,5,12,41.7,7,11,2,9,3,18,10
714,Javairô Dilrosun,nl,MF,FW,Bordeaux,Ligue 1,23,1998,19.2,13,4,2,8,3,7,24,29.2,17,14,1,13,11,24,5
715,Javairô Dilrosun,nl,FW,,Hertha BSC,Bundesliga,23,1998,1.5,3,1,1,2,0,1,1,100.0,0,1,0,1,0,3,0
716,Federico Dimarco,it,DF,,Inter,Serie A,23,1997,15.9,28,15,10,15,3,13,24,54.2,11,6,1,5,19,47,19
717,Landry Dimata,be,FW,MF,Espanyol,La Liga,23,1997,6.0,2,2,1,1,0,1,4,25.0,3,0,0,0,1,3,7
718,Stole Dimitrievski,mk,GK,,Rayo Vallecano,La Liga,27,1993,30.8,0,0,0,0,0,0,0,,0,0,0,0,1,1,14
719,Junior Dina Ebimbe,fr,MF,,Paris S-G,Ligue 1,20,2000,3.5,9,4,3,4,2,2,3,66.7,1,5,3,2,2,11,1
720,Tristan Dingomé,cm,MF,FW,Troyes,Ligue 1,30,1991,12.0,23,11,10,12,1,10,18,55.6,8,7,1,6,9,32,3
721,Sinaly Diomande,ci,DF,,Lyon,Ligue 1,20,2001,6.4,6,3,4,2,0,5,6,83.3,1,6,6,0,12,18,26
722,Issa Diop,fr,DF,,West Ham,Premier League,24,1997,10.7,10,8,5,5,0,4,11,36.4,7,14,13,1,7,17,44
723,Sofiane Diop,fr,MF,FW,Monaco,Ligue 1,21,2000,21.6,38,20,12,19,7,15,47,31.9,32,10,0,10,23,61,4
724,Andy Diouf,fr,MF,,Rennes,Ligue 1,18,2003,0.2,1,1,1,0,0,1,1,100.0,0,1,0,1,0,1,0
725,Assane Dioussé,sn,MF,,Saint-Étienne,Ligue 1,23,1997,0.3,1,1,1,0,0,1,1,100.0,0,0,0,0,0,1,0
726,Axel Disasi,fr,DF,,Monaco,Ligue 1,23,1998,30.2,42,27,20,21,1,23,39,59.0,16,40,30,10,26,68,75
727,Filippo Distefano,it,FW,,Fiorentina,Serie A,17,2003,0.0,0,0,0,0,0,0,0,,0,0,0,0,0,0,0
728,Matías Dituro,ar,GK,,Celta Vigo,La Liga,34,1987,38.0,0,0,0,0,0,0,0,,0,0,0,0,0,0,10
729,Tiago Djaló,pt,DF,,Lille,Ligue 1,21,2000,25.9,60,39,39,19,2,26,39,66.7,13,26,10,16,24,84,71
730,Djené,tg,DF,,Getafe,La Liga,29,1991,34.6,44,26,24,16,4,23,34,67.6,11,24,5,19,59,103,109
731,Moussa Djenepo,ml,MF,,Southampton,Premier League,23,1998,5.1,9,3,3,5,1,3,11,27.3,8,6,1,5,2,11,6
732,Koffi Djidji,ci,DF,,Torino,Serie A,28,1992,19.3,48,29,21,23,4,14,18,77.8,4,20,9,11,34,82,60
733,Alexander Djiku,gh,DF,,Strasbourg,Ligue 1,26,1994,29.9,50,37,33,13,4,18,35,51.4,17,30,13,17,61,111,90
734,Bryan Djile Nokoué,cm,DF,MF,Saint-Étienne,Ligue 1,19,2002,0.6,3,3,1,2,0,2,2,100.0,0,1,0,1,1,4,2
735,Berat Djimsiti,al,DF,,Atalanta,Serie A,28,1993,25.1,43,24,21,20,2,29,46,63.0,17,21,11,10,31,74,56
736,Ouparine Djoco,gw,GK,,Clermont Foot,Ligue 1,23,1998,23.5,0,0,0,0,0,0,0,,0,0,0,0,1,1,14
737,Naïs Djouahra,fr,FW,MF,Real Sociedad,La Liga,21,1999,2.4,7,3,2,2,3,4,8,50.0,4,3,0,3,2,9,2
738,Marko Dmitrović,rs,GK,,Sevilla,La Liga,29,1992,6.0,0,0,0,0,0,0,0,,0,0,0,0,0,0,3
739,Lewis Dobbin,eng,FW,MF,Everton,Premier League,18,2003,0.4,2,1,0,1,1,1,2,50.0,1,0,0,0,0,2,0
740,Matt Doherty,ie,DF,,Tottenham,Premier League,29,1992,9.7,18,12,5,11,2,8,14,57.1,6,11,2,9,13,31,20
741,Jeremy Doku,be,FW,MF,Rennes,Ligue 1,19,2002,5.2,10,5,3,5,2,3,6,50.0,3,4,0,4,3,13,0
742,Kasper Dolberg,dk,FW,,Nice,Ligue 1,23,1997,16.6,9,4,4,3,2,3,9,33.3,6,15,1,14,6,15,17
743,Jaume Doménech,es,GK,,Valencia,La Liga,30,1990,3.8,0,0,0,0,0,0,0,,0,0,0,0,0,0,3
744,Brandon Domingues,fr,MF,FW,Troyes,Ligue 1,21,2000,2.6,6,2,2,4,0,2,3,66.7,1,3,0,3,3,9,0
745,Carlos Dominguez,es,DF,,Celta Vigo,La Liga,20,2001,3.8,4,1,4,0,0,4,6,66.7,2,2,1,1,4,8,21
746,Mario Dominguez,es,FW,,Valencia,La Liga,17,2004,0.3,0,0,0,0,0,0,0,,0,0,0,0,0,0,1
747,Nicolás Domínguez,ar,MF,,Bologna,Serie A,23,1998,22.4,76,45,36,32,8,32,76,42.1,44,38,9,29,32,108,34
748,John Donald,es,DF,,Elche,La Liga,20,2000,2.0,7,4,4,2,1,5,8,62.5,3,5,3,2,3,10,3
749,Lee Dongjun,kr,MF,FW,Hertha BSC,Bundesliga,24,1997,1.3,2,1,0,2,0,1,3,33.3,2,2,0,2,2,4,1
750,Anastasios Donis,gr,FW,MF,Reims,Ligue 1,24,1996,4.1,8,7,4,2,2,2,6,33.3,4,3,0,3,0,8,1
751,Gianluigi Donnarumma,it,GK,,Paris S-G,Ligue 1,22,1999,17.0,0,0,0,0,0,0,0,,0,0,0,0,0,0,9
752,Niklas Dorsch,de,MF,,Augsburg,Bundesliga,23,1998,25.8,76,47,47,23,6,30,60,50.0,30,34,12,22,35,111,36
753,Jodel Dossou,bj,FW,,Clermont Foot,Ligue 1,29,1992,22.3,36,17,15,14,7,15,43,34.9,28,14,0,14,5,41,7
754,Lohann Doucet,fr,MF,DF,Nantes,Ligue 1,18,2002,0.1,0,0,0,0,0,0,0,,0,0,0,0,1,1,0
755,Abdoulaye Doucouré,ml,MF,,Everton,Premier League,28,1993,28.2,75,43,30,37,8,32,71,45.1,39,33,8,25,28,103,32
756,Cheick Doucouré,ml,MF,,Lens,Ligue 1,21,2000,32.7,75,43,34,34,7,35,79,44.3,44,30,7,23,68,143,24
757,Fodé Doucouré,ml,DF,FW,Reims,Ligue 1,20,2001,1.7,12,9,9,3,0,9,11,81.8,2,1,0,1,4,16,6
758,Ismaël Doukouré,fr,DF,,Strasbourg,Ligue 1,18,2003,0.2,0,0,0,0,0,0,0,,0,0,0,0,0,0,1
759,Kamory Doumbia,ml,MF,FW,Reims,Ligue 1,18,2003,3.9,8,2,2,5,1,5,13,38.5,8,9,3,6,3,11,3
760,Moussa Doumbia,ml,FW,,Reims,Ligue 1,26,1994,1.0,0,0,0,0,0,0,1,0.0,1,0,0,0,0,0,0
761,Souleyman Doumbia,ci,DF,FW,Angers,Ligue 1,24,1996,24.7,30,20,16,9,5,13,27,48.1,14,25,4,21,39,69,51
762,Kieran Dowell,eng,FW,MF,Norwich City,Premier League,23,1997,10.1,18,7,8,7,3,9,32,28.1,23,10,1,9,7,25,4
763,Bartłomiej Drągowski,pl,GK,,Fiorentina,Serie A,23,1997,6.2,0,0,0,0,0,0,0,,0,0,0,0,1,1,5
764,Radu Drăgușin,ro,DF,,Sampdoria,Serie A,19,2002,6.9,4,3,2,2,0,2,6,33.3,4,8,4,4,10,14,33
765,Radu Drăgușin,ro,DF,,Salernitana,Serie A,19,2002,5.4,5,4,2,3,0,4,10,40.0,6,7,3,4,13,18,17
766,Cody Drameh,eng,DF,MF,Leeds United,Premier League,19,2001,1.4,4,2,3,1,0,1,3,33.3,2,0,0,0,1,5,4
767,Julian Draxler,de,FW,MF,Paris S-G,Ligue 1,27,1993,6.1,3,2,0,3,0,0,4,0.0,4,3,0,3,5,8,3
768,Matthieu Dreyer,fr,GK,,Lorient,Ligue 1,32,1989,16.0,1,1,1,0,0,1,1,100.0,0,0,0,0,0,1,9
769,Domingos Duarte,pt,DF,,Granada,La Liga,26,1995,18.7,18,14,9,9,0,6,11,54.5,5,27,20,7,22,40,82
770,Óscar Duarte,cr,DF,,Levante,La Liga,32,1989,19.7,18,8,12,6,0,8,23,34.8,15,18,9,9,24,42,102
771,Rubén Duarte,es,DF,,Alavés,La Liga,25,1995,29.1,76,47,43,27,6,43,85,50.6,42,40,6,34,57,133,82
772,Leo Dubois,fr,DF,,Lyon,Ligue 1,26,1994,19.4,43,27,22,14,7,27,46,58.7,19,27,3,24,22,65,35
773,Martin Dúbravka,sk,GK,,Newcastle Utd,Premier League,32,1989,26.0,1,1,1,0,0,0,1,0.0,1,0,0,0,0,1,8
774,Ondrej Duda,sk,MF,FW,Köln,Bundesliga,26,1994,17.9,23,16,4,12,7,6,23,26.1,17,14,2,12,17,40,9
775,Jeremy Dudziak,tn,MF,FW,Greuther Fürth,Bundesliga,25,1995,12.6,17,6,5,8,4,3,14,21.4,11,8,0,8,10,27,4
776,Shane Duffy,ie,DF,,Brighton,Premier League,29,1992,16.0,15,12,12,3,0,8,14,57.1,6,24,18,6,16,31,76
777,Unai Dufur,es,DF,,Osasuna,La Liga,22,1999,1.0,0,0,0,0,0,0,0,,0,1,0,1,4,4,4
778,Denzel Dumfries,nl,DF,,Inter,Serie A,25,1996,22.5,32,12,9,14,9,16,32,50.0,16,15,6,9,9,41,26
779,Paul Dummett,wls,DF,,Newcastle Utd,Premier League,29,1991,2.2,7,3,3,4,0,5,8,62.5,3,5,0,5,3,10,5
780,Alfred Duncan,gh,MF,,Fiorentina,Serie A,28,1993,21.5,34,19,13,16,5,11,32,34.4,21,32,3,29,10,44,7
781,Lewis Dunk,eng,DF,,Brighton,Premier League,29,1991,28.6,10,8,5,5,0,5,11,45.5,6,32,28,4,27,37,113
782,Erik Durm,de,DF,,Eint Frankfurt,Bundesliga,29,1992,5.3,13,7,6,5,2,10,13,76.9,3,8,1,7,10,23,7
783,Hugo Duro,es,DF,MF,Getafe,La Liga,21,1999,0.1,0,0,0,0,0,0,0,,0,0,0,0,0,0,0
784,Hugo Duro,es,FW,MF,Valencia,La Liga,21,1999,20.4,25,19,11,13,1,15,38,39.5,23,24,2,22,4,29,20
785,Jean-Kevin Duverne,ht,DF,,Brest,Ligue 1,24,1997,33.4,71,44,43,21,7,42,90,46.7,48,40,5,35,53,124,92
786,Paulo Dybala,ar,FW,MF,Juventus,Serie A,27,1993,22.9,30,13,7,14,9,8,35,22.9,27,19,0,19,9,39,4
787,Edin Džeko,ba,FW,,Inter,Serie A,35,1986,27.4,14,8,7,4,3,8,25,32.0,17,22,5,17,4,18,35
788,Enzo Ebosse,cm,DF,,Angers,Ligue 1,22,1999,21.0,25,14,19,6,0,11,19,57.9,8,19,9,10,15,40,42
789,Tyronne Ebuehi,ng,DF,,Venezia,Serie A,25,1995,12.6,28,12,16,8,4,10,18,55.6,8,13,3,10,16,44,38
790,Ederson,br,GK,,Manchester City,Premier League,27,1993,37.0,2,1,2,0,0,0,2,0.0,2,0,0,0,0,2,12
791,Éderson,br,MF,,Salernitana,Serie A,22,1999,12.7,29,18,11,14,4,14,26,53.8,12,11,2,9,19,48,8
792,Odsonne Édouard,fr,FW,,Crystal Palace,Premier League,23,1998,17.4,16,10,2,7,7,7,21,33.3,14,20,5,15,0,16,18
793,CJ Egan-Riley,eng,DF,,Manchester City,Premier League,18,2003,0.0,1,1,1,0,0,1,1,100.0,0,0,0,0,0,1,0
794,Maximilian Eggestein,de,MF,,Freiburg,Bundesliga,24,1996,24.4,48,28,17,25,6,22,50,44.0,28,35,11,24,30,78,32
795,Lilian Egloff,de,MF,DF,Stuttgart,Bundesliga,18,2002,0.3,1,0,0,1,0,0,0,,0,1,0,1,0,1,0
796,Kingsley Ehizibue,nl,DF,,Köln,Bundesliga,26,1995,7.6,32,18,27,5,0,15,24,62.5,9,13,4,9,9,41,26
797,Julian Eitschberger,de,DF,,Hertha BSC,Bundesliga,17,2004,0.5,0,0,0,0,0,0,1,0.0,1,1,1,0,2,2,2
798,Albin Ekdal,se,MF,,Sampdoria,Serie A,32,1989,18.2,43,28,17,21,5,26,56,46.4,30,27,7,20,29,72,25
799,Hugo Ekitike,fr,FW,,Reims,Ligue 1,19,2002,14.1,18,10,8,6,4,4,11,36.4,7,9,2,7,6,24,15
800,Jurgen Ekkelenkamp,nl,MF,FW,Hertha BSC,Bundesliga,21,2000,8.0,8,3,2,6,0,2,7,28.6,5,9,2,7,4,12,5
801,Caleb Ekuban,gh,FW,MF,Genoa,Serie A,27,1994,19.1,19,12,2,12,5,7,23,30.4,16,19,5,14,9,28,6
802,Anthony Elanga,se,FW,,Manchester Utd,Premier League,19,2002,13.5,26,20,12,12,2,15,29,51.7,14,17,1,16,9,35,7
803,Alberth Elis,hn,FW,MF,Bordeaux,Ligue 1,25,1996,15.7,19,10,5,5,9,11,25,44.0,14,9,0,9,7,26,10
804,Harvey Elliott,eng,MF,,Liverpool,Premier League,18,2003,3.8,3,0,1,1,1,0,6,0.0,6,8,1,7,4,7,2
805,Elif Elmas,mk,FW,MF,Napoli,Serie A,21,1999,18.0,25,15,10,10,5,12,28,42.9,16,13,2,11,8,33,17
806,Mohamed Elneny,eg,MF,,Arsenal,Premier League,29,1992,9.0,16,8,10,5,1,7,12,58.3,5,7,1,6,14,30,13
807,Aritz Elustondo,es,DF,,Real Sociedad,La Liga,27,1994,23.4,21,14,16,5,0,10,20,50.0,10,19,13,6,29,50,86
808,Nico Elvedi,ch,DF,,Gladbach,Bundesliga,24,1996,27.0,40,24,23,17,0,22,36,61.1,14,33,22,11,34,74,83
809,Mohamed Elyounoussi,no,MF,FW,Southampton,Premier League,26,1994,22.7,36,17,14,15,7,11,39,28.2,28,23,2,21,12,48,28
810,Adri Embarba,es,FW,MF,Espanyol,La Liga,29,1992,22.1,44,29,22,15,7,26,69,37.7,43,35,3,32,19,63,30
811,Breel Embolo,ch,FW,,Gladbach,Bundesliga,24,1997,24.1,16,11,1,12,3,3,8,37.5,5,14,2,12,6,22,7
812,Emerson,br,DF,MF,Tottenham,Premier League,22,1999,25.4,72,47,50,16,6,36,67,53.7,31,25,2,23,22,94,92
813,Emerson,br,DF,,Barcelona,La Liga,22,1999,1.0,3,3,2,1,0,1,2,50.0,1,1,0,1,2,5,1
814,Renaud Emond,be,FW,MF,Nantes,Ligue 1,29,1991,2.1,1,0,0,1,0,0,4,0.0,4,2,1,1,0,1,1
815,Youssef En-Nesyri,ma,FW,,Sevilla,La Liga,24,1997,14.2,10,5,5,2,3,4,11,36.4,7,9,1,8,4,14,18
816,Keita Endo,jp,MF,,Union Berlin,Bundesliga,23,1997,0.6,1,1,1,0,0,0,0,,0,1,0,1,0,1,0
817,Wataru Endo,jp,MF,,Stuttgart,Bundesliga,28,1993,32.2,73,41,34,34,5,31,72,43.1,41,43,12,31,30,103,64
818,Christian Eriksen,dk,MF,,Brentford,Premier League,29,1992,10.4,13,6,4,5,4,8,17,47.1,9,9,1,8,9,22,14
819,Martin Erlic,hr,DF,,Spezia,Serie A,23,1998,28.6,28,16,18,10,0,10,18,55.6,8,54,39,15,28,56,122
820,Gonzalo Escalante,ar,MF,,Lazio,Serie A,28,1993,0.1,1,0,1,0,0,1,1,100.0,0,2,1,1,1,2,0
821,Gonzalo Escalante,ar,MF,,Alavés,La Liga,28,1993,14.4,30,14,9,20,1,13,34,38.2,21,27,2,25,21,51,28
822,Aarón Escandell,es,GK,,Granada,La Liga,25,1995,3.2,0,0,0,0,0,0,1,0.0,1,0,0,0,0,0,4
823,Sergio Escudero,es,DF,MF,Granada,La Liga,31,1989,15.9,46,24,25,17,4,26,54,48.1,28,18,3,15,26,72,35
824,Alfonso Espino,uy,DF,,Cádiz,La Liga,29,1992,37.0,107,63,58,39,10,44,112,39.3,68,45,10,35,54,161,87
825,Michael Esser,de,GK,,Bochum,Bundesliga,33,1987,3.0,0,0,0,0,0,0,1,0.0,1,0,0,0,0,0,2
826,Estanis,es,FW,,Barcelona,La Liga,17,2003,0.1,1,1,0,1,0,1,1,100.0,0,0,0,0,0,1,0
827,Maxime Estève,fr,DF,,Montpellier,Ligue 1,19,2002,20.6,27,18,22,4,1,15,27,55.6,12,31,24,7,22,49,69
828,Pervis Estupiñán,ec,DF,,Villarreal,La Liga,23,1998,17.5,36,22,20,11,5,17,24,70.8,7,13,5,8,25,61,29
829,Oghenekaro Etebo,ng,MF,,Watford,Premier League,25,1995,4.5,11,8,7,4,0,3,8,37.5,5,3,1,2,5,16,5
830,Jonny Evans,nir,DF,,Leicester City,Premier League,33,1988,15.0,24,14,14,8,2,14,22,63.6,8,17,13,4,20,44,59
831,Eberechi Eze,eng,MF,FW,Crystal Palace,Premier League,23,1998,6.7,10,6,5,2,3,6,11,54.5,5,4,1,3,5,15,1
832,Abde Ezzalzouli,ma,FW,,Barcelona,La Liga,19,2001,6.4,17,9,9,5,3,5,8,62.5,3,3,0,3,9,26,0
833,Łukasz Fabiański,pl,GK,,West Ham,Premier League,36,1985,37.0,0,0,0,0,0,0,0,,0,0,0,0,0,0,11
834,Fabinho,br,MF,,Liverpool,Premier League,27,1993,25.7,46,25,17,23,6,24,70,34.3,46,33,10,23,39,85,25
835,Fábio,br,DF,,Nantes,Ligue 1,31,1990,18.5,61,40,31,23,7,36,74,48.6,38,29,7,22,35,96,31
836,Cesc Fàbregas,es,MF,,Monaco,Ligue 1,34,1987,0.4,1,0,0,1,0,1,1,100.0,0,0,0,0,1,2,0
837,Wout Faes,be,DF,,Reims,Ligue 1,23,1998,37.0,40,24,30,9,1,25,33,75.8,8,47,37,10,53,93,169
838,Wahid Faghir,dk,FW,,Stuttgart,Bundesliga,18,2003,1.4,0,0,0,0,0,0,1,0.0,1,2,0,2,0,0,0
839,Romain Faivre,fr,FW,MF,Lyon,Ligue 1,23,1998,9.9,10,4,2,6,2,4,13,30.8,9,4,0,4,3,13,2
840,Romain Faivre,fr,MF,,Brest,Ligue 1,23,1998,19.9,30,18,12,13,5,12,30,40.0,18,11,0,11,13,43,10
841,Radamel Falcao,co,FW,,Rayo Vallecano,La Liga,35,1986,9.3,2,1,0,1,1,1,4,25.0,3,4,1,3,2,4,11
842,Diego Falcinelli,it,FW,,Bologna,Serie A,30,1991,0.7,2,2,2,0,0,0,0,,0,0,0,0,1,3,1
843,Wladimiro Falcone,it,GK,,Sampdoria,Serie A,26,1995,9.5,0,0,0,0,0,0,0,,0,0,0,0,1,1,5
844,Fali,es,DF,MF,Cádiz,La Liga,27,1993,20.0,32,19,24,8,0,17,32,53.1,15,26,16,10,24,56,82
845,Paolo Faragò,it,MF,,Cagliari,Serie A,28,1993,0.2,1,1,1,0,0,0,0,,0,2,0,2,0,1,0
846,Omar Faraj,ps,FW,,Levante,La Liga,19,2002,0.0,1,0,1,0,0,1,1,100.0,0,0,0,0,0,1,0
847,Davide Faraoni,it,DF,,Hellas Verona,Serie A,29,1991,28.6,62,40,38,21,3,29,62,46.8,33,38,5,33,23,85,62
848,Mohamed Fares,dz,DF,FW,Genoa,Serie A,25,1996,6.5,4,2,1,3,0,0,4,0.0,4,8,3,5,8,12,11
849,Diego Farias,br,MF,FW,Cagliari,Serie A,31,1990,0.7,1,1,0,1,0,1,3,33.3,2,0,0,0,0,1,0
850,Wuilker Faríñez,ve,GK,,Lens,Ligue 1,23,1998,12.3,0,0,0,0,0,0,0,,0,0,0,0,0,0,4
851,Ömer Faruk Beyaz,tr,DF,MF,Stuttgart,Bundesliga,17,2003,0.8,4,3,1,3,0,1,5,20.0,4,0,0,0,2,6,0
852,Noah Fatar,fr,DF,MF,Angers,Ligue 1,19,2002,0.1,1,0,0,0,1,0,1,0.0,1,0,0,0,1,2,0
853,Ansu Fati,es,FW,,Barcelona,La Liga,18,2002,3.7,3,2,0,2,1,1,1,100.0,0,4,0,4,1,4,0
854,Julien Faussurier,fr,MF,DF,Brest,Ligue 1,34,1987,5.4,10,6,3,3,4,6,13,46.2,7,12,1,11,5,15,6
855,Andrea Favilli,it,FW,,Genoa,Serie A,24,1997,0.4,1,1,0,0,1,0,0,,0,0,0,0,0,1,2
856,Federico Fazio,ar,DF,,Salernitana,Serie A,34,1987,15.9,17,11,10,6,1,9,12,75.0,3,21,16,5,27,44,67
857,Aleix Febas,es,MF,,Mallorca,La Liga,25,1996,1.3,4,1,0,4,0,2,4,50.0,2,0,0,0,0,4,0
858,Peter Federico,do,MF,DF,Real Madrid,La Liga,19,2002,0.3,0,0,0,0,0,0,0,,0,0,0,0,1,1,0
859,Adrian Fein,de,MF,,Greuther Fürth,Bundesliga,22,1999,0.4,0,0,0,0,0,0,1,0.0,1,0,0,0,2,2,0
860,Nabil Fekir,fr,MF,,Betis,La Liga,28,1993,31.0,43,29,5,25,13,7,36,19.4,29,14,0,14,7,50,7
861,Felipe,br,DF,,Atlético Madrid,La Liga,32,1989,16.7,20,15,11,8,1,8,18,44.4,10,17,11,6,28,48,77
862,Luiz Felipe,it,DF,,Lazio,Serie A,24,1997,27.7,41,23,21,16,4,20,34,58.8,14,40,33,7,33,74,102
863,João Félix,pt,FW,MF,Atlético Madrid,La Liga,21,1999,14.0,5,2,1,4,0,1,5,20.0,4,4,1,3,7,12,8
864,Ohis Felix Uduokhai,de,DF,,Augsburg,Bundesliga,23,1997,8.7,9,6,6,3,0,6,11,54.5,5,13,8,5,9,18,33
865,Kiko Femenía,es,DF,,Watford,Premier League,30,1991,23.8,35,22,23,10,2,21,37,56.8,16,24,8,16,37,72,51
866,Evan Ferguson,ie,MF,,Brighton,Premier League,16,2004,0.3,0,0,0,0,0,0,0,,0,0,0,0,0,0,0
867,Nathan Ferguson,eng,DF,,Crystal Palace,Premier League,20,2000,0.1,0,0,0,0,0,0,0,,0,0,0,0,0,0,0
868,Bruno Fernandes,pt,MF,,Manchester Utd,Premier League,26,1994,34.6,54,28,26,22,6,26,91,28.6,65,36,0,36,17,71,42
869,Edimilson Fernandes,ch,MF,FW,Arminia,Bundesliga,25,1996,3.1,2,0,1,1,0,1,4,25.0,3,2,2,0,2,4,6
870,Aitor Fernández,es,GK,,Levante,La Liga,30,1991,13.0,2,1,2,0,0,2,2,100.0,0,0,0,0,0,2,7
871,Álex Fernández,es,MF,,Cádiz,La Liga,28,1992,22.8,47,31,22,17,8,21,61,34.4,40,30,7,23,30,77,31
872,Álvaro Fernández,es,GK,,Brentford,Premier League,23,1998,12.0,0,0,0,0,0,0,0,,0,0,0,0,0,0,5
873,Federico Fernández,ar,DF,,Newcastle Utd,Premier League,32,1989,5.8,3,0,3,0,0,2,5,40.0,3,10,10,0,4,7,28
874,Fernandinho,br,MF,DF,Manchester City,Premier League,36,1985,10.7,21,10,7,10,4,9,27,33.3,18,8,2,6,8,29,13
875,Fernando,br,MF,DF,Sevilla,La Liga,34,1987,20.6,24,17,14,9,1,12,33,36.4,21,21,13,8,29,53,32
876,Alex Ferrari,it,DF,,Sampdoria,Serie A,27,1994,18.3,40,22,28,9,3,19,33,57.6,14,31,22,9,39,79,63
877,Salvador Ferrer,es,DF,MF,Spezia,Serie A,23,1998,16.6,32,18,15,9,8,12,25,48.0,13,24,12,12,18,50,46
878,Jordan Ferri,fr,MF,,Montpellier,Ligue 1,29,1992,32.3,55,35,28,23,4,29,87,33.3,58,21,5,16,30,85,35
879,Riccardo Fiamozzi,it,DF,,Empoli,Serie A,28,1993,6.9,7,5,2,2,3,2,4,50.0,2,6,5,1,7,14,12
880,Fidel,es,MF,,Elche,La Liga,31,1989,25.1,44,23,18,17,9,14,57,24.6,43,9,1,8,7,51,20
881,Karol Fila,pl,DF,,Strasbourg,Ligue 1,23,1998,6.2,10,8,5,4,1,4,8,50.0,4,7,2,5,4,14,6
882,Alfreð Finnbogason,is,FW,,Augsburg,Bundesliga,32,1989,3.2,3,1,0,2,1,2,4,50.0,2,5,1,4,2,5,8
883,Luca Fiordilino,it,MF,,Venezia,Serie A,25,1996,7.3,21,13,11,6,4,13,27,48.1,14,14,4,10,11,32,12
884,Vincenzo Fiorillo,it,GK,,Salernitana,Serie A,31,1990,1.0,0,0,0,0,0,0,0,,0,0,0,0,0,0,1
885,Roberto Firmino,br,FW,,Liverpool,Premier League,29,1991,11.0,23,14,5,8,10,3,16,18.8,13,20,0,20,4,27,3
886,Junior Firpo,do,DF,MF,Leeds United,Premier League,24,1996,19.0,61,29,30,26,5,31,59,52.5,28,22,6,16,24,85,37
887,Mark Flekken,nl,GK,,Freiburg,Bundesliga,28,1993,32.0,0,0,0,0,0,0,2,0.0,2,1,0,1,2,2,10
888,Ashley Fletcher,eng,FW,,Watford,Premier League,25,1995,0.3,2,1,1,1,0,1,1,100.0,0,1,1,0,0,2,0
889,Alexis Flips,fr,MF,DF,Reims,Ligue 1,21,2000,11.7,37,21,21,9,7,22,45,48.9,23,21,0,21,24,61,17
890,Alessandro Florenzi,it,DF,FW,Milan,Serie A,30,1991,12.8,28,14,14,7,7,14,32,43.8,18,9,2,7,27,55,10
891,Phil Foden,eng,FW,,Manchester City,Premier League,21,2000,23.6,16,8,10,4,2,7,17,41.2,10,9,0,9,11,27,5
892,Mamadou Fofana,ml,DF,,Metz,Ligue 1,23,1998,0.4,1,1,0,1,0,1,2,50.0,1,2,1,1,1,2,2
893,Seko Fofana,ci,MF,,Lens,Ligue 1,26,1995,37.3,27,19,11,13,3,12,58,20.7,46,24,2,22,26,53,17
894,Wesley Fofana,fr,DF,,Leicester City,Premier League,20,2000,7.0,12,8,11,1,0,7,11,63.6,4,5,2,3,12,24,26
895,Youssouf Fofana,fr,MF,,Monaco,Ligue 1,22,1999,24.3,69,43,19,41,9,29,56,51.8,27,29,7,22,32,101,22
896,Thomas Foket,be,DF,FW,Reims,Ligue 1,26,1994,24.8,28,19,12,13,3,18,40,45.0,22,26,4,22,33,61,35
897,Thomas Fontaine,mg,DF,,Lorient,Ligue 1,30,1991,1.9,2,0,1,0,1,0,1,0.0,1,3,3,0,2,4,4
898,José Fontán,es,DF,,Celta Vigo,La Liga,21,2000,3.1,5,3,3,2,0,1,5,20.0,4,3,1,2,10,15,10
899,José Fonte,pt,DF,,Lille,Ligue 1,37,1983,38.0,23,12,14,7,2,11,25,44.0,14,39,32,7,44,67,159
900,Fernando Forestieri,it,FW,MF,Udinese,Serie A,31,1990,0.6,0,0,0,0,0,0,1,0.0,1,1,0,1,0,0,1
901,Pablo Fornals,es,FW,MF,West Ham,Premier League,25,1996,31.1,54,28,21,21,12,22,84,26.2,62,49,2,47,27,81,16
902,Emil Forsberg,se,MF,,RB Leipzig,Bundesliga,29,1991,19.0,21,12,2,11,8,7,22,31.8,15,18,0,18,2,23,2
903,Adam Forshaw,eng,MF,,Leeds United,Premier League,29,1991,17.0,53,23,21,27,5,21,54,38.9,33,17,1,16,19,72,12
904,Marcus Forss,fi,FW,MF,Brentford,Premier League,22,1999,2.3,3,3,0,2,1,2,4,50.0,2,5,0,5,1,4,0
905,Fraser Forster,eng,GK,,Southampton,Premier League,33,1988,19.0,1,0,1,0,0,0,1,0.0,1,0,0,0,0,1,23
906,Philipp Förster,de,MF,FW,Stuttgart,Bundesliga,26,1995,10.7,20,13,4,12,4,11,26,42.3,15,12,1,11,3,23,2
907,Francesco Forte,it,FW,,Venezia,Serie A,28,1993,4.7,3,2,0,2,1,2,5,40.0,3,1,0,1,0,3,2
908,Steven Fortes,cv,DF,,Lens,Ligue 1,29,1992,1.0,2,0,2,0,0,1,2,50.0,1,2,1,1,0,2,4
909,Ben Foster,eng,GK,,Watford,Premier League,38,1983,26.0,0,0,0,0,0,0,3,0.0,3,0,0,0,0,0,9
910,Tariqe Fosu,gh,DF,,Brentford,Premier League,25,1995,0.2,0,0,0,0,0,0,0,,0,1,0,1,0,0,0
911,Timothy Fosu-Mensah,nl,DF,,Leverkusen,Bundesliga,23,1998,1.6,5,3,3,1,1,4,4,100.0,0,1,0,1,2,7,2
912,Dimitri Foulquier,fr,DF,,Granada,La Liga,28,1993,2.0,0,0,0,0,0,0,1,0.0,1,2,1,1,1,1,2
913,Dimitri Foulquier,fr,DF,,Valencia,La Liga,28,1993,26.0,36,17,17,15,4,21,34,61.8,13,19,3,16,29,65,49
914,Juan Foyth,ar,DF,,Villarreal,La Liga,23,1998,21.4,69,49,35,28,6,35,47,74.5,12,29,7,22,20,89,50
915,Gianluca Frabotta,it,DF,MF,Hellas Verona,Serie A,22,1999,0.2,0,0,0,0,0,0,1,0.0,1,1,0,1,1,1,0
916,Raphael Framberger,de,DF,,Augsburg,Bundesliga,25,1995,9.4,26,19,12,10,4,13,27,48.1,14,8,2,6,9,35,25
917,Przemysław Frankowski,pl,DF,,Lens,Ligue 1,26,1995,27.2,57,39,22,27,8,36,74,48.6,38,27,0,27,28,85,52
918,Enric Franquesa,es,DF,FW,Levante,La Liga,24,1997,6.9,5,3,4,0,1,0,1,0.0,1,4,0,4,7,12,11
919,Fransérgio,br,MF,,Bordeaux,Ligue 1,30,1990,14.0,24,10,8,12,4,12,43,27.9,31,18,6,12,23,47,23
920,Ryan Fraser,sct,FW,MF,Newcastle Utd,Premier League,27,1994,16.3,10,3,5,3,2,5,13,38.5,8,11,1,10,11,21,11
921,Davide Frattesi,it,MF,,Sassuolo,Serie A,21,1999,31.7,46,16,26,18,2,26,52,50.0,26,44,12,32,29,75,62
922,Fred,br,MF,,Manchester Utd,Premier League,28,1993,22.5,63,27,32,24,7,22,79,27.8,57,38,11,27,32,95,24
923,Ryan Fredericks,eng,DF,,West Ham,Premier League,28,1992,3.4,2,2,2,0,0,0,1,0.0,1,2,1,1,4,6,6
924,Morten Frendrup,dk,DF,MF,Genoa,Serie A,20,2001,7.7,40,24,19,13,8,13,29,44.8,16,19,2,17,17,57,7
925,Remo Freuler,ch,MF,,Atalanta,Serie A,29,1992,26.3,69,39,22,33,14,30,70,42.9,40,48,8,40,35,104,26
926,Marvin Friedrich,de,DF,,Gladbach,Bundesliga,25,1995,6.7,14,8,10,4,0,9,11,81.8,2,5,3,2,5,19,26
927,Marvin Friedrich,de,DF,,Union Berlin,Bundesliga,25,1995,13.0,17,5,14,3,0,10,16,62.5,6,13,7,6,23,40,47
928,Jeremie Frimpong,nl,DF,,Leverkusen,Bundesliga,20,2000,22.8,32,18,19,12,1,12,23,52.2,11,24,6,18,17,49,40
929,Christian Früchtl,de,GK,,Bayern Munich,Bundesliga,21,2000,0.1,0,0,0,0,0,0,0,,0,0,0,0,0,0,0
930,Jorge de Frutos,es,MF,FW,Levante,La Liga,24,1997,19.6,33,15,14,11,8,10,51,19.6,41,11,1,10,12,45,13
931,Leo Fuhr Hjelde,no,MF,DF,Leeds United,Premier League,17,2003,1.7,5,4,3,2,0,3,3,100.0,0,3,3,0,4,9,7
932,Chris Führich,de,FW,MF,Stuttgart,Bundesliga,23,1998,19.0,28,16,10,10,8,18,39,46.2,21,31,2,29,8,36,9
933,Angelo Fulgini,fr,MF,FW,Angers,Ligue 1,24,1996,32.5,35,25,8,18,9,14,44,31.8,30,21,5,16,22,57,5
934,Marius Funk,de,GK,,Greuther Fürth,Bundesliga,25,1996,8.0,0,0,0,0,0,0,0,,0,0,0,0,0,0,8
935,Stephan Fürstner,de,MF,,Mainz 05,Bundesliga,33,1987,0.1,0,0,0,0,0,0,2,0.0,2,0,0,0,0,0,1
936,Matteo Gabbia,it,DF,,Milan,Serie A,21,1999,6.0,4,3,1,3,0,0,4,0.0,4,2,2,0,8,12,12
937,Manolo Gabbiadini,it,FW,MF,Sampdoria,Serie A,29,1991,12.7,6,4,3,2,1,1,7,14.3,6,5,2,3,3,9,10
938,Mijat Gaćinović,rs,FW,MF,Hoffenheim,Bundesliga,26,1995,1.2,3,3,1,1,1,3,3,100.0,0,1,0,1,1,4,2
939,Gianluca Gaetano,it,MF,,Napoli,Serie A,21,2000,0.2,1,1,1,0,0,1,2,50.0,1,0,0,0,2,3,0
940,Luca Gagliano,it,FW,DF,Cagliari,Serie A,21,2000,0.1,0,0,0,0,0,0,0,,0,1,0,1,0,0,1
941,Roberto Gagliardini,it,MF,,Inter,Serie A,27,1994,7.2,12,6,7,4,1,1,13,7.7,12,14,5,9,9,21,7
942,Riccardo Gagliolo,se,DF,,Salernitana,Serie A,31,1990,12.6,23,12,16,4,3,16,27,59.3,11,15,8,7,28,51,52
943,Javi Galán,es,DF,,Celta Vigo,La Liga,26,1994,36.6,108,66,60,37,11,42,99,42.4,57,48,8,40,45,153,52
944,Iñigo Ruiz de Galarreta,es,MF,,Mallorca,La Liga,27,1993,15.3,40,21,14,21,5,14,30,46.7,16,16,2,14,20,60,21
945,Nicolas Galazzi,it,MF,,Venezia,Serie A,20,2000,0.2,2,1,1,0,1,0,1,0.0,1,0,0,0,0,2,0
946,Pablo Galdames Millán,cl,MF,,Genoa,Serie A,24,1996,11.4,28,12,6,16,6,12,35,34.3,23,16,2,14,8,36,9
947,Thiago Galhardo,br,FW,MF,Celta Vigo,La Liga,32,1989,12.8,12,6,3,3,6,2,12,16.7,10,15,2,13,6,18,9
948,Conor Gallagher,eng,MF,,Crystal Palace,Premier League,21,2000,31.6,69,38,35,20,14,21,69,30.4,48,58,9,49,29,98,26
949,Gauthier Gallon,fr,GK,,Troyes,Ligue 1,28,1993,31.0,3,0,3,0,0,1,1,100.0,0,0,0,0,2,5,12
950,Cristian Gamboa,cr,DF,,Bochum,Bundesliga,31,1989,19.1,59,36,40,16,3,30,61,49.2,31,22,7,15,32,91,35
951,Kévin Gameiro,fr,FW,,Strasbourg,Ligue 1,34,1987,26.5,19,10,5,9,5,6,18,33.3,12,22,1,21,6,25,1
952,Idrissa Gana Gueye,sn,MF,,Paris S-G,Ligue 1,31,1989,18.2,60,36,24,24,12,18,44,40.9,26,23,4,19,24,84,13
953,Ignatius Ganago,cm,FW,,Lens,Ligue 1,22,1999,11.4,3,2,1,2,0,2,6,33.3,4,4,0,4,2,5,3
954,Silvère Ganvoula M'Boussy,cg,FW,,Bochum,Bundesliga,25,1996,1.7,0,0,0,0,0,0,1,0.0,1,0,0,0,0,0,1
955,Álvaro García,es,FW,MF,Rayo Vallecano,La Liga,28,1992,33.3,42,23,15,18,9,8,35,22.9,27,27,3,24,42,84,24
956,Dani García,es,MF,,Athletic Club,La Liga,31,1990,24.2,36,22,15,17,4,14,47,29.8,33,27,10,17,24,60,41
957,David García,es,DF,,Osasuna,La Liga,27,1994,34.5,28,14,15,11,2,12,22,54.5,10,27,21,6,52,80,168
958,Eric García,es,DF,,Barcelona,La Liga,20,2001,22.7,27,18,13,13,1,11,26,42.3,15,22,12,10,44,71,53
959,Fran Garcia,es,DF,,Rayo Vallecano,La Liga,21,1999,33.6,60,35,44,12,4,39,73,53.4,34,34,8,26,45,105,53
960,Joan García,es,GK,,Espanyol,La Liga,20,2001,1.2,0,0,0,0,0,0,0,,0,0,0,0,1,1,1
961,Manu García,es,MF,,Alavés,La Liga,23,1998,12.0,18,9,6,9,3,9,27,33.3,18,8,2,6,13,31,4
962,Raúl García,es,FW,,Athletic Club,La Liga,35,1986,20.0,27,17,6,11,10,8,36,22.2,28,30,4,26,9,36,21
963,Rubén García,es,MF,FW,Osasuna,La Liga,28,1993,26.4,43,26,12,23,8,16,49,32.7,33,31,4,27,24,67,16
964,Saúl García,es,MF,,Alavés,La Liga,26,1994,0.0,1,1,1,0,0,0,0,,0,0,0,0,0,1,0
965,Unai García,es,DF,,Osasuna,La Liga,29,1992,15.6,21,12,14,6,1,14,17,82.4,3,19,11,8,22,43,78
966,Alejandro Garnacho,ar,FW,MF,Manchester Utd,Premier League,17,2004,0.1,0,0,0,0,0,0,1,0.0,1,0,0,0,0,0,0
967,Mario Gaspar,es,DF,,Villarreal,La Liga,30,1990,6.9,10,4,2,5,3,6,10,60.0,4,6,3,3,6,16,15
968,Djeidi Gassama,fr,FW,,Paris S-G,Ligue 1,17,2003,0.0,0,0,0,0,0,0,0,,0,1,1,0,0,0,0
969,Johan Gastien,fr,MF,,Clermont Foot,Ligue 1,33,1988,30.5,56,34,26,25,5,27,74,36.5,47,45,11,34,53,109,49
970,Gavi,es,MF,FW,Barcelona,La Liga,16,2004,25.7,38,18,13,18,7,9,33,27.3,24,36,0,36,25,63,13
971,Dwight Gayle,eng,FW,DF,Newcastle Utd,Premier League,30,1990,0.4,1,0,0,1,0,0,1,0.0,1,0,0,0,1,2,0
972,Jean-Philippe Gbamin,ci,MF,,Everton,Premier League,25,1995,0.7,1,1,1,0,0,0,2,0.0,2,0,0,0,1,2,1
973,David de Gea,es,GK,,Manchester Utd,Premier League,30,1990,38.0,0,0,0,0,0,0,0,,0,0,0,0,0,0,11
974,Linus Gechter,de,DF,,Hertha BSC,Bundesliga,17,2004,8.0,15,8,13,2,0,7,14,50.0,7,12,7,5,11,26,29
975,Dennis Geiger,de,MF,,Hoffenheim,Bundesliga,23,1998,15.3,34,23,9,20,5,17,30,56.7,13,15,1,14,14,48,7
976,Joe Gelhardt,eng,FW,MF,Leeds United,Premier League,19,2002,8.3,4,3,1,0,3,2,10,20.0,8,9,0,9,0,4,3
977,Luca Gemello,it,GK,,Torino,Serie A,21,2000,1.0,0,0,0,0,0,0,0,,0,0,0,0,0,0,0
978,Yannick Gerhardt,de,MF,DF,Wolfsburg,Bundesliga,27,1994,17.5,42,20,18,17,7,22,36,61.1,14,24,1,23,25,67,25
979,Valère Germain,fr,FW,,Montpellier,Ligue 1,31,1990,21.9,23,14,6,11,6,8,31,25.8,23,13,1,12,9,32,27
980,Gerson,br,MF,FW,Marseille,Ligue 1,24,1997,28.3,42,17,16,20,6,8,35,22.9,27,26,4,22,16,58,16
981,Willem Geubbels,fr,FW,MF,Nantes,Ligue 1,19,2001,6.0,8,5,4,2,2,5,12,41.7,7,5,0,5,6,14,5
982,Hamadi Al Ghaddioui,ma,FW,,Stuttgart,Bundesliga,30,1990,5.5,5,4,2,1,2,0,4,0.0,4,3,1,2,0,5,4
983,Ismaël Gharbi,es,FW,,Paris S-G,Ligue 1,17,2004,0.0,0,0,0,0,0,0,0,,0,0,0,0,0,0,0
984,Anwar El Ghazi,nl,FW,MF,Aston Villa,Premier League,26,1995,4.3,4,4,2,2,0,2,7,28.6,5,6,0,6,1,5,2
985,Anwar El Ghazi,nl,FW,MF,Everton,Premier League,26,1995,0.1,1,1,1,0,0,1,1,100.0,0,3,0,3,0,1,0
986,Lamine Ghezali,fr,DF,,Saint-Étienne,Ligue 1,22,1999,0.0,0,0,0,0,0,0,0,,0,1,0,1,0,0,0
987,Paolo Ghiglione,it,DF,,Genoa,Serie A,24,1997,6.7,17,12,8,6,3,9,14,64.3,5,11,5,6,10,27,12
988,Saman Ghoddos,ir,MF,DF,Brentford,Premier League,27,1993,6.0,17,10,8,6,3,9,15,60.0,6,2,0,2,3,20,16
989,Faouzi Ghoulam,dz,DF,,Napoli,Serie A,30,1991,3.7,3,1,1,2,0,0,3,0.0,3,2,1,1,3,6,10
990,Dimitris Giannoulis,gr,DF,,Norwich City,Premier League,25,1995,13.0,36,21,17,17,2,24,36,66.7,12,22,6,16,19,55,41
991,Morgan Gibbs-White,eng,DF,FW,Wolves,Premier League,21,2000,0.1,0,0,0,0,0,0,0,,0,1,0,1,0,0,0
992,Ben Gibson,eng,DF,,Norwich City,Premier League,28,1993,27.7,23,16,17,6,0,7,12,58.3,5,36,30,6,27,50,139
993,Niko Gießelmann,de,DF,FW,Union Berlin,Bundesliga,29,1991,23.1,24,17,10,11,3,15,38,39.5,23,26,4,22,18,42,29
994,Rafał Gikiewicz,pl,GK,,Augsburg,Bundesliga,33,1987,34.0,2,0,2,0,0,2,7,28.6,5,0,0,0,3,5,11
995,Bryan Gil,es,FW,MF,Tottenham,Premier League,20,2001,1.0,3,0,1,0,2,1,2,50.0,1,2,0,2,0,3,0
996,Bryan Gil,es,MF,FW,Valencia,La Liga,20,2001,8.4,13,8,6,3,4,2,13,15.4,11,13,0,13,1,14,4
997,Óscar Gil,es,DF,,Espanyol,La Liga,24,1997,18.8,52,35,27,20,5,25,46,54.3,21,33,9,24,19,71,33
998,Mario Gila,es,DF,,Real Madrid,La Liga,20,2000,0.3,1,0,1,0,0,0,1,0.0,1,0,0,0,1,2,1
999,Billy Gilmour,sct,MF,,Norwich City,Premier League,20,2001,20.6,41,21,16,21,4,14,52,26.9,38,21,4,17,17,58,29
1000,Daniel Ginczek,de,MF,FW,Wolfsburg,Bundesliga,30,1991,0.1,0,0,0,0,0,0,0,,0,0,0,0,0,0,0
1001,Matthias Ginter,de,DF,,Gladbach,Bundesliga,27,1994,26.2,36,22,20,13,3,27,40,67.5,13,21,10,11,33,69,76
1002,Nicholas Gioacchini,us,FW,MF,Montpellier,Ligue 1,21,2000,5.5,7,5,3,2,2,4,10,40.0,6,8,0,8,4,11,5
1003,Sebastian Giovinco,it,MF,,Sampdoria,Serie A,34,1987,0.4,0,0,0,0,0,0,1,0.0,1,0,0,0,0,0,0
1004,Jimmy Giraudon,fr,DF,,Troyes,Ligue 1,29,1992,18.0,14,6,10,4,0,7,22,31.8,15,24,14,10,37,51,68
1005,Andrei Girotto,br,DF,MF,Nantes,Ligue 1,29,1992,35.0,85,52,49,32,4,52,103,50.5,51,67,33,34,69,154,143
1006,Olivier Giroud,fr,FW,,Milan,Serie A,34,1986,21.0,15,11,4,6,5,3,17,17.6,14,13,4,9,3,18,19
1007,Jamie Gittens,eng,FW,,Dortmund,Bundesliga,16,2004,1.5,3,2,0,2,1,2,5,40.0,3,4,1,3,1,4,1
1008,Serge Gnabry,de,FW,DF,Bayern Munich,Bundesliga,26,1995,24.3,47,31,16,20,11,22,57,38.6,35,26,0,26,14,61,3
1009,Ben Godfrey,eng,DF,,Everton,Premier League,23,1998,22.5,47,32,29,14,4,24,39,61.5,15,41,19,22,15,62,100
1010,Diego Godín,uy,DF,,Cagliari,Serie A,35,1986,9.1,18,7,13,3,2,10,15,66.7,5,7,5,2,13,31,46
1011,Edoardo Goldaniga,it,DF,,Cagliari,Serie A,27,1993,10.4,12,5,7,5,0,4,11,36.4,7,8,5,3,22,34,23
1012,Edoardo Goldaniga,it,DF,MF,Sassuolo,Serie A,27,1993,0.0,0,0,0,0,0,0,0,,0,0,0,0,0,0,0
1013,Aleksandr Golovin,ru,FW,MF,Monaco,Ligue 1,25,1996,16.7,40,22,10,18,12,18,41,43.9,23,26,1,25,12,52,8
1014,André Gomes,pt,MF,,Everton,Premier League,28,1993,6.9,16,4,6,6,4,8,32,25.0,24,8,2,6,1,17,7
1015,Angel Gomes,eng,MF,FW,Lille,Ligue 1,20,2000,10.6,23,13,6,12,5,10,15,66.7,5,4,0,4,3,26,4
1016,Toti Gomes,pt,DF,,Wolves,Premier League,22,1999,4.0,11,7,10,1,0,7,9,77.8,2,6,3,3,8,19,15
1017,Dani Gómez,es,FW,,Levante,La Liga,23,1998,11.8,7,4,3,2,2,4,12,33.3,8,3,0,3,3,10,5
1018,Joe Gomez,eng,DF,,Liverpool,Premier League,24,1997,3.7,10,6,5,2,3,5,9,55.6,4,4,1,3,5,15,6
1019,Maxi Gómez,uy,FW,,Valencia,La Liga,24,1996,21.7,5,3,1,2,2,5,8,62.5,3,5,1,4,3,8,22
1020,Moi Gómez,es,MF,FW,Villarreal,La Liga,27,1994,14.3,15,7,8,3,4,5,17,29.4,12,5,0,5,6,21,6
1021,Papu Gómez,ar,FW,MF,Sevilla,La Liga,33,1988,19.8,19,11,9,5,5,9,35,25.7,26,15,2,13,7,26,12
1022,Sergi Gómez,es,DF,,Espanyol,La Liga,29,1992,30.2,33,24,29,3,1,18,27,66.7,9,33,23,10,40,73,125
1023,Victor Gomez,es,DF,,Espanyol,La Liga,21,2000,0.0,0,0,0,0,0,0,0,,0,0,0,0,0,0,0
1024,Alfred Gomis,sn,GK,,Rennes,Ligue 1,27,1993,25.0,1,0,1,0,0,1,2,50.0,1,0,0,0,1,2,8
1025,Maxime Gonalons,fr,MF,,Granada,La Liga,32,1989,17.2,43,28,17,22,4,14,39,35.9,25,33,10,23,18,61,29
1026,Vagner Gonçalves,cv,FW,,Metz,Ligue 1,25,1996,1.0,2,1,0,2,0,1,1,100.0,0,0,0,0,1,3,0
1027,Cedric Gondo,ci,FW,,Salernitana,Serie A,24,1996,7.8,5,2,2,2,1,2,5,40.0,3,2,0,2,3,8,2
1028,Álvaro González,es,DF,,Marseille,Ligue 1,31,1990,5.0,1,1,1,0,0,1,1,100.0,0,0,0,0,1,2,9
1029,Diego González,es,DF,,Elche,La Liga,26,1995,19.9,25,16,18,7,0,9,16,56.3,7,21,13,8,19,44,87
1030,Édgar González,es,DF,,Betis,La Liga,24,1997,16.3,25,19,15,8,2,17,24,70.8,7,17,11,6,23,48,82
1031,Giovanni González,uy,DF,,Mallorca,La Liga,26,1994,4.1,9,3,4,4,1,3,5,60.0,2,7,2,5,4,13,14
1032,Nicolás González,ar,FW,,Fiorentina,Serie A,23,1998,26.2,21,16,6,8,7,9,28,32.1,19,26,2,24,21,42,4
1033,Nicolás González,es,MF,,Barcelona,La Liga,19,2002,12.4,31,20,5,23,3,11,27,40.7,16,12,0,12,6,37,12
1034,Roberto González,es,FW,MF,Betis,La Liga,20,2001,1.5,5,4,3,2,0,4,6,66.7,2,5,0,5,1,6,1
1035,Charlie Goode,eng,DF,,Brentford,Premier League,25,1995,5.0,7,5,5,2,0,4,4,100.0,0,4,2,2,2,9,8
1036,Anthony Gordon,eng,MF,FW,Everton,Premier League,20,2001,25.4,54,32,20,30,4,21,59,35.6,38,49,3,46,22,76,17
1037,Kaide Gordon,eng,FW,,Liverpool,Premier League,16,2004,0.1,1,0,0,0,1,0,0,,0,0,0,0,0,1,0
1038,Leon Goretzka,de,MF,,Bayern Munich,Bundesliga,26,1995,15.5,25,15,12,9,4,11,26,42.3,15,11,1,10,17,42,23
1039,Gori,es,MF,,Espanyol,La Liga,19,2002,0.1,0,0,0,0,0,0,0,,0,2,0,2,0,0,0
1040,Andoni Gorosabel,es,DF,,Real Sociedad,La Liga,24,1996,25.4,47,31,32,9,6,25,47,53.2,22,16,3,13,18,65,49
1041,Robin Gosens,de,DF,,Atalanta,Serie A,27,1994,5.1,7,3,3,4,0,4,8,50.0,4,4,0,4,9,16,1
1042,Robin Gosens,de,DF,,Inter,Serie A,27,1994,1.9,3,1,1,2,0,0,0,,0,5,2,3,3,6,3
1043,Dan Gosling,eng,MF,,Watford,Premier League,31,1990,1.8,2,1,1,1,0,2,6,33.3,4,2,0,2,0,2,3
1044,Amine Gouiri,dz,FW,MF,Nice,Ligue 1,21,2000,30.6,22,13,2,13,7,10,32,31.3,22,22,5,17,11,33,17
1045,Lucas Gourna-Douath,fr,MF,,Saint-Étienne,Ligue 1,17,2003,20.0,45,26,22,18,5,21,36,58.3,15,22,3,19,13,58,9
1046,Jeffrey Gouweleeuw,nl,DF,,Augsburg,Bundesliga,30,1991,28.6,50,27,33,17,0,22,36,61.1,14,35,18,17,49,99,116
1047,Jonathan Gradit,fr,DF,,Lens,Ligue 1,28,1992,34.1,60,28,24,28,8,25,45,55.6,20,39,27,12,65,125,106
1048,Jens Grahl,de,GK,,Eint Frankfurt,Bundesliga,32,1988,1.0,0,0,0,0,0,0,0,,0,0,0,0,0,0,1
1049,Alberto Grassi,it,MF,,Cagliari,Serie A,26,1995,24.2,47,26,13,30,4,16,38,42.1,22,27,9,18,63,110,33
1050,Jaume Grau,es,MF,,Osasuna,La Liga,24,1997,0.0,1,1,1,0,0,0,1,0.0,1,0,0,0,0,1,0
1051,Andrew Gravillon,gp,DF,,Reims,Ligue 1,23,1998,23.7,32,24,19,13,0,17,27,63.0,10,25,15,10,33,65,83
1052,Demarai Gray,jm,MF,FW,Everton,Premier League,25,1996,26.0,30,19,13,10,7,10,22,45.5,12,30,2,28,15,45,21
1053,Adrian Grbić,at,FW,MF,Lorient,Ligue 1,24,1996,5.8,2,1,0,2,0,2,6,33.3,4,3,1,2,0,2,7
1054,Ivo Grbić,hr,GK,,Lille,Ligue 1,25,1996,21.0,0,0,0,0,0,0,0,,0,0,0,0,0,0,14
1055,Jack Grealish,eng,FW,,Manchester City,Premier League,25,1995,21.3,18,17,4,10,4,5,13,38.5,8,11,1,10,8,26,7
1056,Etienne Green,eng,GK,,Saint-Étienne,Ligue 1,21,2000,13.3,1,1,1,0,0,0,0,,0,0,0,0,1,2,9
1057,Julian Green,us,MF,,Greuther Fürth,Bundesliga,26,1995,11.7,9,5,0,8,1,2,8,25.0,6,10,2,8,7,16,10
1058,Mason Greenwood,eng,FW,MF,Manchester Utd,Premier League,19,2001,14.1,15,9,9,1,5,3,9,33.3,6,5,0,5,1,16,6
1059,Sam Greenwood,eng,MF,FW,Leeds United,Premier League,19,2002,2.6,8,5,0,5,3,4,7,57.1,3,3,0,3,2,10,1
1060,Michael Gregoritsch,at,FW,MF,Augsburg,Bundesliga,27,1994,15.5,19,8,4,10,5,2,15,13.3,13,18,2,16,6,25,29
1061,Dominik Greif,sk,GK,,Mallorca,La Liga,24,1997,1.0,0,0,0,0,0,0,0,,0,0,0,0,0,0,0
1062,Clément Grenier,fr,MF,,Mallorca,La Liga,30,1991,0.7,0,0,0,0,0,0,0,,0,1,1,0,0,0,1
1063,Sebastian Griesbeck,de,DF,MF,Greuther Fürth,Bundesliga,30,1990,27.1,60,31,38,19,3,39,62,62.9,23,38,13,25,43,103,100
1064,Sebastian Griesbeck,de,MF,,Union Berlin,Bundesliga,30,1990,0.1,1,1,0,1,0,1,1,100.0,0,0,0,0,0,1,0
1065,Antoine Griezmann,fr,FW,,Barcelona,La Liga,30,1991,2.9,13,5,3,10,0,2,6,33.3,4,4,0,4,3,16,5
1066,Antoine Griezmann,fr,FW,MF,Atlético Madrid,La Liga,30,1991,18.8,30,14,11,15,4,12,32,37.5,20,18,1,17,7,37,18
1067,Vincenzo Grifo,it,MF,FW,Freiburg,Bundesliga,28,1993,30.8,27,15,9,13,5,9,26,34.6,17,12,2,10,13,40,28
1068,Lennart Grill,de,GK,,Leverkusen,Bundesliga,22,1999,1.0,0,0,0,0,0,0,0,,0,0,0,0,0,0,0
1069,Florian Grillitsch,at,DF,MF,Hoffenheim,Bundesliga,25,1995,16.6,37,19,15,21,1,17,31,54.8,14,18,7,11,29,66,36
1070,Pascal Groß,de,MF,DF,Brighton,Premier League,30,1991,22.6,28,15,15,11,2,12,33,36.4,21,34,8,26,18,46,23
1071,Carlos Gruezo,ec,MF,,Augsburg,Bundesliga,26,1995,10.8,22,11,10,10,2,8,21,38.1,13,11,2,9,9,31,15
1072,Vicente Guaita,es,GK,,Crystal Palace,Premier League,34,1987,29.5,1,0,1,0,0,1,1,100.0,0,0,0,0,1,2,8
1073,Andrés Guardado,mx,MF,,Betis,La Liga,34,1986,15.5,30,13,12,17,1,13,34,38.2,21,18,4,14,21,51,29
1074,Sergi Guardiola,es,FW,,Rayo Vallecano,La Liga,30,1991,19.0,10,9,3,5,2,1,21,4.8,20,14,2,12,4,14,17
1075,Nemanja Gudelj,rs,DF,MF,Sevilla,La Liga,29,1991,11.6,16,7,10,4,2,5,8,62.5,3,14,9,5,22,38,37
1076,Gabriel Gudmundsson,se,DF,MF,Lille,Ligue 1,22,1999,14.9,43,31,24,16,3,17,35,48.6,18,15,3,12,20,63,13
1077,Noah Guede-Nadje,fr,MF,,Angers,Ligue 1,17,2003,0.0,0,0,0,0,0,0,0,,0,0,0,0,0,0,0
1078,Gonçalo Guedes,pt,FW,MF,Valencia,La Liga,24,1996,29.0,21,14,6,7,8,2,22,9.1,20,14,0,14,9,30,1
1079,Marc Guéhi,eng,DF,,Crystal Palace,Premier League,21,2000,35.8,35,17,24,10,1,15,16,93.8,1,34,26,8,30,65,127
1080,Mattéo Guendouzi,fr,MF,,Marseille,Ligue 1,22,1999,35.0,45,30,10,26,9,13,47,27.7,34,15,1,14,16,61,18
1081,Yanis Guermouche,fr,MF,FW,Montpellier,Ligue 1,20,2001,0.1,2,1,0,1,1,1,1,100.0,0,0,0,0,0,2,0
1082,Raphaël Guerreiro,pt,DF,,Dortmund,Bundesliga,27,1993,19.9,35,19,19,12,4,16,31,51.6,15,18,2,16,25,60,14
1083,Evann Guessand,ci,FW,,Nice,Ligue 1,20,2001,4.9,9,8,2,5,2,3,8,37.5,5,4,0,4,0,9,1
1084,Ander Guevara,es,MF,,Real Sociedad,La Liga,24,1997,9.6,18,13,6,10,2,10,17,58.8,7,12,6,6,12,30,8
1085,Lamine Gueye,sn,FW,MF,Metz,Ligue 1,23,1998,6.2,5,5,1,1,3,3,7,42.9,4,4,0,4,6,11,1
1086,Pape Gueye,sn,MF,,Marseille,Ligue 1,22,1999,17.0,38,19,15,22,1,16,31,51.6,15,15,3,12,24,62,16
1087,John Guidetti,se,FW,MF,Alavés,La Liga,29,1992,3.1,2,1,0,0,2,0,1,0.0,1,1,0,1,0,2,0
1088,Josuha Guilavogui,fr,MF,DF,Bordeaux,Ligue 1,30,1990,14.8,39,16,18,17,4,14,29,48.3,15,16,8,8,36,75,23
1089,Josuha Guilavogui,fr,MF,DF,Wolfsburg,Bundesliga,30,1990,10.5,23,14,13,9,1,7,18,38.9,11,11,6,5,25,48,42
1090,Frederic Guilbert,fr,DF,,Strasbourg,Ligue 1,26,1994,28.0,69,39,33,24,12,32,62,51.6,30,37,11,26,55,124,39
1091,Hugo Guillamón,es,MF,DF,Valencia,La Liga,21,2000,26.2,43,27,20,16,7,18,44,40.9,26,26,10,16,30,73,53
1092,Bruno Guimarães,br,MF,,Newcastle Utd,Premier League,23,1997,11.5,44,23,18,22,4,21,38,55.3,17,25,6,19,9,53,13
1093,Bruno Guimarães,br,MF,,Lyon,Ligue 1,23,1997,18.2,50,31,20,25,5,23,59,39.0,36,21,4,17,21,71,11
1094,Serhou Guirassy,gn,FW,,Rennes,Ligue 1,25,1996,11.3,4,2,1,2,1,1,7,14.3,6,4,0,4,1,5,8
1095,Péter Gulácsi,hu,GK,,RB Leipzig,Bundesliga,31,1990,33.0,0,0,0,0,0,0,0,,0,0,0,0,1,1,15
1096,Manuel Gulde,de,DF,,Freiburg,Bundesliga,30,1991,13.6,18,10,14,3,1,8,11,72.7,3,16,8,8,17,35,37
1097,Gerard Gumbau,es,MF,,Elche,La Liga,26,1994,21.0,46,19,22,19,5,22,51,43.1,29,18,4,14,23,69,25
1098,Robert Gumny,pl,DF,,Augsburg,Bundesliga,23,1998,25.2,48,29,25,20,3,25,43,58.1,18,24,7,17,28,76,57
1099,İlkay Gündoğan,de,MF,,Manchester City,Premier League,30,1990,20.6,23,9,10,12,1,12,31,38.7,19,11,1,10,15,38,10
1100,Angus Gunn,sct,GK,,Norwich City,Premier League,25,1996,9.0,0,0,0,0,0,0,0,,0,0,0,0,0,0,11
1101,Christian Günter,de,DF,MF,Freiburg,Bundesliga,28,1993,34.0,34,20,16,15,3,18,50,36.0,32,23,6,17,17,51,49
1102,Koray Günter,de,DF,,Hellas Verona,Serie A,26,1994,26.8,32,18,19,11,2,16,32,50.0,16,27,21,6,69,101,110
1103,Lasse Günther,de,DF,,Augsburg,Bundesliga,18,2003,1.8,8,5,4,3,1,5,9,55.6,4,0,0,0,2,10,2
1104,Jon Guridi,es,MF,,Real Sociedad,La Liga,26,1995,2.3,5,3,2,3,0,1,4,25.0,3,3,1,2,3,8,4
1105,Malo Gusto,fr,DF,,Lyon,Ligue 1,18,2003,20.9,55,35,29,21,5,24,40,60.0,16,21,6,15,33,88,41
1106,Raúl Guti,es,MF,,Elche,La Liga,24,1996,18.1,25,15,7,14,4,10,30,33.3,20,9,3,6,25,50,7
1107,Marcos Mauro López Gutiérrez,ar,DF,,Cádiz,La Liga,30,1991,1.5,1,0,0,1,0,0,2,0.0,2,2,1,1,1,2,9
1108,Miguel Gutiérrez,es,DF,,Real Madrid,La Liga,20,2001,2.9,7,5,5,0,2,3,5,60.0,2,0,0,0,2,9,2
1109,Albert Guðmundsson,is,FW,MF,Genoa,Serie A,24,1997,6.7,5,3,2,1,2,3,8,37.5,5,2,0,2,5,10,4
1110,Joško Gvardiol,hr,DF,,RB Leipzig,Bundesliga,19,2002,26.8,47,31,28,17,2,22,39,56.4,17,30,11,19,51,98,62
1111,Emmanuel Gyasi,gh,FW,MF,Spezia,Serie A,27,1994,33.7,47,30,31,9,7,21,41,51.2,20,22,4,18,16,63,43
1112,Norbert Gyömbér,sk,DF,,Salernitana,Serie A,29,1992,28.5,53,32,40,11,2,33,50,66.0,17,38,24,14,44,97,126
1113,Erling Haaland,no,FW,,Dortmund,Bundesliga,21,2000,21.2,2,1,0,1,1,0,1,0.0,1,8,1,7,1,3,31
1114,Nicolas Haas,ch,MF,,Empoli,Serie A,25,1996,11.1,35,22,15,10,10,17,39,43.6,22,24,4,20,9,44,17
1115,Janik Haberer,de,MF,,Freiburg,Bundesliga,27,1994,9.1,14,8,5,6,3,7,19,36.8,12,11,4,7,16,30,11
1116,Alexander Hack,de,DF,,Mainz 05,Bundesliga,27,1993,23.0,52,26,35,17,0,29,46,63.0,17,31,14,17,51,103,95
1117,Robin Hack,de,FW,MF,Arminia,Bundesliga,22,1998,15.2,14,8,6,5,3,3,21,14.3,18,18,1,17,5,19,4
1118,Munir El Haddadi,ma,FW,MF,Sevilla,La Liga,25,1995,5.3,8,4,1,6,1,2,8,25.0,6,7,1,6,5,13,2
1119,André Hahn,de,MF,FW,Augsburg,Bundesliga,30,1990,23.3,36,20,9,15,12,17,50,34.0,33,38,5,33,15,51,43
1120,Amadou Haidara,ml,MF,,RB Leipzig,Bundesliga,23,1998,14.7,30,14,11,19,0,17,37,45.9,20,22,6,16,16,46,8
1121,Massadio Haïdara,ml,DF,,Lens,Ligue 1,28,1992,12.0,28,21,18,7,3,15,24,62.5,9,18,4,14,22,50,31
1122,Oualid El Hajjam,ma,DF,,Troyes,Ligue 1,30,1991,11.9,22,11,12,6,4,15,23,65.2,8,12,6,6,22,44,28
1123,Achraf Hakimi,ma,DF,,Paris S-G,Ligue 1,22,1998,27.5,74,51,38,27,9,40,72,55.6,32,26,5,21,28,102,23
1124,Marcel Halstenberg,de,DF,,RB Leipzig,Bundesliga,29,1991,5.6,10,7,6,4,0,6,11,54.5,5,6,0,6,7,17,11
1125,Pierre-Yves Hamel,fr,FW,MF,Lorient,Ligue 1,27,1994,0.3,0,0,0,0,0,0,1,0.0,1,0,0,0,2,2,0
1126,Pierre-Yves Hamel,fr,FW,,Clermont Foot,Ligue 1,27,1994,5.8,11,6,0,5,6,5,6,83.3,1,2,1,1,0,11,0
1127,Romain Hamouma,fr,FW,MF,Saint-Étienne,Ligue 1,34,1987,9.8,10,7,1,5,4,2,13,15.4,11,8,0,8,4,14,1
1128,Samir Handanović,si,GK,,Inter,Serie A,37,1984,37.0,1,0,1,0,0,1,2,50.0,1,1,0,1,0,1,6
1129,Grant Hanley,sct,DF,,Norwich City,Premier League,29,1991,32.2,44,25,28,14,2,18,35,51.4,17,56,45,11,56,100,176
1130,Ridgeciano Haps,sr,DF,,Venezia,Serie A,28,1993,22.8,36,20,26,4,6,11,21,52.4,10,34,12,22,29,65,57
1131,Genki Haraguchi,jp,MF,,Union Berlin,Bundesliga,30,1991,19.5,37,20,12,22,3,15,48,31.3,33,25,3,22,26,63,15
1132,Amine Harit,ma,FW,MF,Marseille,Ligue 1,24,1997,12.9,18,11,9,9,0,9,17,52.9,8,10,0,10,4,22,2
1133,Varazdat Haroyan,am,DF,,Cádiz,La Liga,28,1992,16.0,31,21,20,10,1,19,29,65.5,10,22,12,10,15,46,62
1134,Jack Harrison,eng,FW,MF,Leeds United,Premier League,24,1996,29.3,57,37,22,22,13,31,76,40.8,45,35,1,34,21,78,19
1135,Abdou Harroui,nl,MF,,Sassuolo,Serie A,23,1998,5.0,11,4,4,7,0,8,11,72.7,3,14,0,14,4,15,5
1136,Luis Hartwig,de,FW,,Bochum,Bundesliga,18,2002,0.0,0,0,0,0,0,0,0,,0,0,0,0,0,0,0
1137,Makoto Hasebe,jp,DF,,Eint Frankfurt,Bundesliga,37,1984,13.2,27,12,15,11,1,13,29,44.8,16,24,8,16,22,49,36
1138,Hans Hateboer,nl,DF,MF,Atalanta,Serie A,27,1994,15.4,22,14,10,8,4,11,26,42.3,15,11,1,10,7,29,20
1139,Kortney Hause,eng,DF,,Aston Villa,Premier League,26,1995,4.4,3,3,2,0,1,3,4,75.0,1,8,5,3,6,9,13
1140,Kai Havertz,de,FW,MF,Chelsea,Premier League,22,1999,20.1,17,8,5,7,5,4,14,28.6,10,28,1,27,4,21,32
1141,Isaac Hayden,eng,MF,DF,Newcastle Utd,Premier League,26,1995,11.1,28,14,11,14,3,12,29,41.4,17,17,8,9,14,42,24
1142,Eden Hazard,be,FW,MF,Real Madrid,La Liga,30,1991,8.0,6,3,3,2,1,3,7,42.9,4,3,0,3,2,8,0
1143,Thorgan Hazard,be,FW,DF,Dortmund,Bundesliga,28,1993,14.9,23,13,8,10,5,15,40,37.5,25,23,1,22,6,29,4
1144,Jonas Hector,de,DF,,Köln,Bundesliga,31,1990,28.4,76,39,36,26,14,29,74,39.2,45,59,8,51,50,126,68
1145,Hwang Hee-chan,kr,FW,MF,Wolves,Premier League,25,1996,20.2,27,13,9,16,2,14,44,31.8,30,10,0,10,13,40,7
1146,Hwang Hee-chan,kr,FW,,RB Leipzig,Bundesliga,25,1996,0.5,0,0,0,0,0,0,0,,0,0,0,0,1,1,0
1147,Silvan Hefti,ch,DF,,Genoa,Serie A,23,1997,14.3,50,30,23,22,5,32,58,55.2,26,20,4,16,20,70,34
1148,Dominique Heintz,de,DF,,Union Berlin,Bundesliga,27,1993,5.2,8,5,5,3,0,3,6,50.0,3,7,4,3,7,15,14
1149,Dominique Heintz,de,DF,,Freiburg,Bundesliga,27,1993,0.3,0,0,0,0,0,0,0,,0,0,0,0,1,1,0
1150,Jordan Henderson,eng,MF,,Liverpool,Premier League,31,1990,28.9,36,20,9,25,2,17,44,38.6,27,25,1,24,23,59,14
1151,Liam Henderson,sct,MF,,Empoli,Serie A,25,1996,22.4,22,13,7,8,7,9,31,29.0,22,14,4,10,9,31,13
1152,Jeff Hendrick,ie,MF,,Newcastle Utd,Premier League,29,1992,0.8,1,1,0,1,0,1,1,100.0,0,0,0,0,0,1,1
1153,Wayne Hennessey,wls,GK,,Burnley,Premier League,34,1987,2.0,0,0,0,0,0,0,0,,0,0,0,0,1,1,0
1154,Benjamin Henrichs,de,DF,,RB Leipzig,Bundesliga,24,1997,12.7,30,21,18,6,6,12,22,54.5,10,16,1,15,19,49,14
1155,Henrique,br,DF,,Lyon,Ligue 1,27,1994,12.3,13,7,10,1,2,5,16,31.3,11,13,1,12,22,35,14
1156,Dalbert Henrique,br,DF,MF,Cagliari,Serie A,27,1993,23.1,43,23,23,16,4,11,35,31.4,24,28,5,23,24,67,34
1157,Luis Henrique,br,FW,MF,Marseille,Ligue 1,19,2001,7.8,4,3,2,1,1,2,5,40.0,3,2,0,2,5,9,1
1158,Matheus Henrique,br,MF,,Sassuolo,Serie A,23,1997,12.0,10,3,6,3,1,6,24,25.0,18,14,2,12,7,17,12
1159,Rico Henry,eng,DF,,Brentford,Premier League,24,1997,30.8,28,20,18,8,2,12,34,35.3,22,31,10,21,26,54,76
1160,Thomas Henry,fr,FW,,Venezia,Serie A,26,1994,23.5,9,4,2,3,4,5,13,38.5,8,11,5,6,2,11,25
1161,Christophe Hérelle,mq,DF,,Brest,Ligue 1,28,1992,21.5,48,28,30,16,2,17,26,65.4,9,20,15,5,44,92,84
1162,Jérôme Hergault,fr,DF,,Lorient,Ligue 1,35,1986,3.9,3,1,1,2,0,2,5,40.0,3,4,1,3,4,7,7
1163,Kike Hermoso,es,DF,,Betis,La Liga,21,1999,1.0,2,1,2,0,0,2,2,100.0,0,2,1,1,0,2,5
1164,Mario Hermoso,es,DF,,Atlético Madrid,La Liga,26,1995,20.7,30,15,23,4,3,20,38,52.6,18,18,3,15,29,59,49
1165,Aridane Hernández,es,DF,,Osasuna,La Liga,32,1989,12.9,12,9,10,2,0,3,13,23.1,10,11,9,2,20,32,71
1166,Lucas Hernández,fr,DF,,Bayern Munich,Bundesliga,25,1996,22.6,50,31,20,24,6,26,42,61.9,16,22,11,11,28,78,54
1167,Luis Hernández,es,DF,,Cádiz,La Liga,32,1989,15.2,9,5,9,0,0,5,8,62.5,3,5,3,2,16,25,34
1168,Mario Hernández,es,DF,FW,Rayo Vallecano,La Liga,22,1999,4.4,10,4,7,3,0,5,9,55.6,4,1,0,1,4,14,7
1169,Theo Hernández,fr,DF,,Milan,Serie A,23,1997,30.1,53,35,34,14,5,29,40,72.5,11,16,3,13,23,76,29
1170,Hernani,br,MF,FW,Genoa,Serie A,27,1994,7.6,20,10,8,9,3,13,32,40.6,19,17,4,13,13,33,5
1171,Ander Herrera,es,MF,,Paris S-G,Ligue 1,31,1989,12.1,29,17,7,16,6,14,39,35.9,25,22,8,14,14,43,8
1172,Héctor Herrera,mx,MF,,Atlético Madrid,La Liga,31,1990,9.5,16,8,11,4,1,7,20,35.0,13,13,2,11,12,28,16
1173,Sergio Herrera,es,GK,,Osasuna,La Liga,28,1993,36.0,3,2,3,0,0,3,6,50.0,3,1,0,1,1,4,18
1174,Yangel Herrera,ve,MF,,Espanyol,La Liga,23,1998,18.3,41,31,19,19,3,18,39,46.2,21,27,5,22,19,60,33
1175,Patrick Herrmann,de,DF,FW,Gladbach,Bundesliga,30,1991,8.4,15,7,5,6,4,9,24,37.5,15,10,1,9,6,21,8
1176,Son Heung-min,kr,MF,FW,Tottenham,Premier League,29,1992,33.4,15,6,5,7,3,5,23,21.7,18,27,6,21,13,28,8
1177,Daan Heymans,be,MF,FW,Venezia,Serie A,22,1999,2.8,3,1,1,2,0,1,5,20.0,4,7,3,4,4,7,3
1178,Aaron Hickey,sct,DF,,Bologna,Serie A,19,2002,31.3,46,29,24,15,7,20,30,66.7,10,36,13,23,29,75,44
1179,Piero Hincapié,ec,DF,,Leverkusen,Bundesliga,19,2002,19.5,33,23,23,8,2,19,25,76.0,6,34,15,19,33,66,56
1180,Martin Hinteregger,at,DF,,Eint Frankfurt,Bundesliga,28,1992,24.7,45,28,28,16,1,28,43,65.1,15,36,16,20,42,87,78
1181,Marwin Hitz,ch,GK,,Dortmund,Bundesliga,33,1987,4.5,0,0,0,0,0,0,0,,0,0,0,0,0,0,2
1182,Ki-Jana Hoever,nl,DF,MF,Wolves,Premier League,19,2002,3.4,10,6,5,5,0,7,12,58.3,5,6,0,6,6,16,8
1183,Nicolas Höfler,de,MF,,Freiburg,Bundesliga,31,1990,28.9,73,42,37,29,7,28,62,45.2,34,50,21,29,46,119,42
1184,Jonas Hofmann,de,MF,FW,Gladbach,Bundesliga,29,1992,23.1,30,20,6,17,7,17,42,40.5,25,23,0,23,12,42,10
1185,Rob Holding,eng,DF,,Arsenal,Premier League,25,1995,9.4,13,9,11,1,1,5,6,83.3,1,23,18,5,10,23,42
1186,Lucas Höler,de,FW,,Freiburg,Bundesliga,27,1994,28.7,41,25,10,17,14,13,28,46.4,15,25,4,21,17,58,39
1187,Mason Holgate,eng,DF,,Everton,Premier League,24,1996,23.7,35,18,26,9,0,11,26,42.3,15,25,17,8,26,61,95
1188,Gerrit Holtmann,ph,FW,MF,Bochum,Bundesliga,26,1995,20.4,15,9,5,3,7,6,22,27.3,16,26,2,24,8,23,6
1189,Martin Hongla,cm,MF,,Hellas Verona,Serie A,23,1998,7.2,14,8,5,6,3,4,8,50.0,4,6,2,4,4,18,16
1190,Franck Honorat,fr,FW,MF,Brest,Ligue 1,24,1996,32.2,54,38,25,13,16,27,47,57.4,20,24,2,22,15,69,25
1191,Justin Hoogma,nl,DF,,Greuther Fürth,Bundesliga,23,1998,3.0,6,5,4,2,0,4,6,66.7,2,5,5,0,4,10,4
1192,Sydney van Hooijdonk,nl,FW,MF,Bologna,Serie A,21,2000,0.4,0,0,0,0,0,0,1,0.0,1,1,0,1,0,0,0
1193,Matthew Hoppe,us,FW,MF,Mallorca,La Liga,20,2001,1.5,1,0,0,0,1,0,3,0.0,3,0,0,0,0,1,0
1194,Jannes Horn,de,DF,,Köln,Bundesliga,24,1997,5.3,6,4,4,2,0,4,8,50.0,4,1,1,0,3,9,9
1195,Timo Horn,de,GK,,Köln,Bundesliga,28,1993,13.0,0,0,0,0,0,0,1,0.0,1,0,0,0,0,0,5
1196,Fraser Hornby,sct,FW,MF,Reims,Ligue 1,21,1999,3.9,3,1,1,2,0,0,2,0.0,2,3,0,3,4,7,5
1197,Cédric Hountondji,bj,DF,,Clermont Foot,Ligue 1,27,1994,22.6,33,17,20,12,1,16,24,66.7,8,23,12,11,34,67,76
1198,Lukáš Hrádecký,fi,GK,,Leverkusen,Bundesliga,31,1989,32.0,1,1,1,0,0,1,1,100.0,0,0,0,0,0,1,10
1199,Branimir Hrgota,se,FW,,Greuther Fürth,Bundesliga,28,1993,30.9,46,29,10,31,5,21,72,29.2,51,27,1,26,11,57,3
1200,Petko Hristov,bg,DF,,Spezia,Serie A,22,1999,13.9,17,10,11,6,0,10,16,62.5,6,29,23,6,19,36,47
1201,Ajdin Hrustic,au,MF,,Eint Frankfurt,Bundesliga,25,1996,10.7,16,11,5,7,4,11,32,34.4,21,18,1,17,10,26,7
1202,Timo Hübers,de,DF,,Köln,Bundesliga,25,1996,19.3,45,27,28,17,0,27,45,60.0,18,31,19,12,52,97,95
1203,Benjamin Hübner,de,DF,,Hoffenheim,Bundesliga,32,1989,4.2,9,5,0,7,2,3,5,60.0,2,2,2,0,9,18,7
1204,Callum Hudson-Odoi,eng,MF,FW,Chelsea,Premier League,20,2000,10.7,14,10,5,6,3,8,23,34.8,15,8,0,8,2,16,6
1205,Will Hughes,eng,MF,,Crystal Palace,Premier League,26,1995,11.7,29,14,10,16,3,7,16,43.8,9,13,7,6,8,37,10
1206,Mats Hummels,de,DF,,Dortmund,Bundesliga,32,1988,19.6,34,22,20,13,1,20,36,55.6,16,18,13,5,32,66,66
1207,Elseid Hysaj,al,DF,,Lazio,Serie A,27,1994,22.5,46,30,25,17,4,29,45,64.4,16,18,6,12,24,70,34
1208,Suk Hyun-jun,kr,FW,MF,Troyes,Ligue 1,30,1991,1.7,0,0,0,0,0,0,0,,0,2,0,2,0,0,2
1209,Pierre Højbjerg,dk,MF,,Tottenham,Premier League,25,1995,35.5,78,45,31,38,9,38,85,44.7,47,61,13,48,48,126,54
1210,Iago,br,DF,,Augsburg,Bundesliga,24,1997,24.2,49,29,25,19,5,15,34,44.1,19,28,6,22,27,76,62
1211,Robert Ibáñez,es,MF,FW,Osasuna,La Liga,28,1993,1.0,3,3,2,0,1,1,2,50.0,1,1,0,1,1,4,1
1212,Roger Ibanez,br,DF,,Roma,Serie A,22,1998,32.1,54,32,31,19,4,26,43,60.5,17,26,7,19,62,116,104
1213,Vicente Iborra,es,MF,,Villarreal,La Liga,33,1988,11.5,19,10,9,7,3,12,24,50.0,12,11,5,6,11,30,27
1214,Zlatan Ibrahimović,se,FW,,Milan,Serie A,39,1981,11.3,0,0,0,0,0,0,2,0.0,2,2,1,1,3,3,9
1215,Mauro Icardi,ar,FW,,Paris S-G,Ligue 1,28,1993,11.4,5,3,1,3,1,3,7,42.9,4,3,0,3,5,10,12
1216,Adam Idah,ie,FW,MF,Norwich City,Premier League,20,2001,6.9,9,6,2,5,2,2,3,66.7,1,4,2,2,3,12,7
1217,Oussama Idrissi,ma,MF,FW,Sevilla,La Liga,25,1996,1.4,1,0,0,1,0,0,1,0.0,1,1,0,1,1,2,1
1218,Oussama Idrissi,ma,MF,,Cádiz,La Liga,25,1996,10.0,8,4,3,4,1,4,15,26.7,11,8,0,8,3,11,5
1219,Iglesias,es,DF,,Getafe,La Liga,23,1998,8.0,19,10,11,8,0,7,17,41.2,10,8,2,6,10,29,28
1220,Borja Iglesias,es,FW,,Betis,La Liga,28,1993,17.5,6,4,1,2,3,0,8,0.0,8,11,1,10,4,10,7
1221,Jonathan Iglesias,uy,MF,,Clermont Foot,Ligue 1,32,1988,6.4,18,11,6,10,2,10,18,55.6,8,8,2,6,5,23,2
1222,Juan Ignacio Ramírez,uy,FW,,Saint-Étienne,Ligue 1,24,1997,1.4,2,1,0,1,1,0,0,,0,0,0,0,0,2,0
1223,Igor,br,DF,,Fiorentina,Serie A,23,1998,24.9,53,31,34,16,3,30,40,75.0,10,37,19,18,31,84,46
1224,Kelechi Iheanacho,ng,FW,,Leicester City,Premier League,24,1996,14.0,10,7,2,5,3,3,14,21.4,11,19,0,19,4,14,10
1225,Danylo Ihnatenko,ua,MF,,Bordeaux,Ligue 1,24,1997,7.7,17,9,8,7,2,10,24,41.7,14,9,2,7,6,23,17
1226,Jonathan Ikone,fr,FW,,Fiorentina,Serie A,23,1998,7.2,7,3,2,3,2,3,10,30.0,7,10,2,8,1,8,2
1227,Jonathan Ikone,fr,MF,FW,Lille,Ligue 1,23,1998,11.8,11,3,6,4,1,4,11,36.4,7,13,1,12,5,16,4
1228,Ivan Ilić,rs,MF,,Hellas Verona,Serie A,20,2001,28.1,39,18,16,19,4,20,54,37.0,34,34,12,22,22,61,55
1229,Josip Iličić,si,MF,FW,Atalanta,Serie A,33,1988,9.3,7,7,3,2,2,4,17,23.5,13,6,1,5,3,10,1
1230,Asier Illarramendi,es,MF,,Real Sociedad,La Liga,31,1990,4.2,9,5,5,3,1,1,10,10.0,9,5,1,4,4,13,12
1231,Stefan Ilsanker,at,DF,MF,Eint Frankfurt,Bundesliga,32,1989,3.0,14,8,7,6,1,5,10,50.0,5,6,2,4,6,20,15
1232,Ciro Immobile,it,FW,,Lazio,Serie A,31,1990,30.1,10,5,4,4,2,1,15,6.7,14,7,1,6,3,13,16
1233,Burak İnce,tr,FW,,Arminia,Bundesliga,17,2004,1.5,1,1,1,0,0,1,2,50.0,1,1,0,1,0,1,0
1234,Danny Ings,eng,FW,,Aston Villa,Premier League,29,1992,21.1,23,16,2,16,5,13,37,35.1,24,31,2,29,6,29,22
1235,Marcus Ingvartsen,dk,MF,,Union Berlin,Bundesliga,25,1996,1.4,0,0,0,0,0,0,2,0.0,2,0,0,0,2,2,1
1236,Marcus Ingvartsen,dk,FW,MF,Mainz 05,Bundesliga,25,1996,7.6,3,2,2,0,1,3,9,33.3,6,6,0,6,6,9,7
1237,Bonke Innocent,ng,MF,,Lorient,Ligue 1,25,1996,9.7,27,16,10,16,1,11,26,42.3,15,11,3,8,16,43,14
1238,Lorenzo Insigne,it,FW,,Napoli,Serie A,30,1991,25.4,23,14,8,12,3,8,44,18.2,36,30,1,29,20,43,3
1239,Nikita Iosifov,ru,MF,,Villarreal,La Liga,20,2001,0.0,0,0,0,0,0,0,0,,0,0,0,0,0,0,0
1240,Tim Iroegbunam,eng,MF,,Aston Villa,Premier League,18,2003,1.0,5,4,2,3,0,1,1,100.0,0,0,0,0,2,7,1
1241,Alexander Isak,se,FW,,Real Sociedad,La Liga,21,1999,23.8,7,4,1,3,3,2,12,16.7,10,14,2,12,3,10,10
1242,Isco,es,MF,FW,Real Madrid,La Liga,29,1992,3.7,9,5,4,4,1,5,12,41.7,7,1,0,1,2,11,1
1243,Wilson Isidor,fr,FW,MF,Monaco,Ligue 1,20,2000,0.6,0,0,0,0,0,0,4,0.0,4,1,0,1,0,0,0
1244,Ardian Ismajli,al,DF,,Empoli,Serie A,24,1996,14.1,13,9,8,4,1,5,14,35.7,9,21,11,10,24,37,80
1245,Hiroki Ito,jp,DF,,Stuttgart,Bundesliga,22,1999,26.1,43,31,21,19,3,25,43,58.1,18,40,19,21,53,96,95
1246,Cedric Itten,ch,FW,,Greuther Fürth,Bundesliga,24,1996,7.1,5,2,1,2,2,1,6,16.7,5,3,0,3,2,7,4
1247,Gian-Luca Itter,de,DF,,Greuther Fürth,Bundesliga,22,1999,16.2,44,26,30,11,3,21,38,55.3,17,24,9,15,13,57,51
1248,Alex Iwobi,ng,MF,DF,Everton,Premier League,25,1996,22.6,40,19,23,12,5,21,52,40.4,31,39,3,36,20,60,25
1249,Armando Izzo,it,DF,,Torino,Serie A,29,1992,5.8,16,9,14,2,0,9,11,81.8,2,5,4,1,17,33,21
1250,Nicolas Jackson,sn,FW,MF,Villarreal,La Liga,20,2001,1.8,2,0,1,0,1,0,0,,0,0,0,0,1,3,1
1251,Lee Jae-sung,kr,MF,FW,Mainz 05,Bundesliga,28,1992,16.0,30,12,8,14,8,6,27,22.2,21,20,2,18,18,48,18
1252,Paul Jaeckel,de,DF,,Union Berlin,Bundesliga,23,1998,22.7,51,29,27,24,0,29,51,56.9,22,34,10,24,57,108,81
1253,Mato Jajalo,ba,MF,,Udinese,Serie A,33,1988,7.0,24,14,14,7,3,11,23,47.8,12,7,0,7,11,35,5
1254,Kristijan Jakić,hr,MF,,Eint Frankfurt,Bundesliga,24,1997,20.9,37,22,10,21,6,15,62,24.2,47,33,3,30,21,58,25
1255,Ismail Jakobs,sn,DF,FW,Monaco,Ligue 1,21,1999,13.4,32,16,14,15,3,16,35,45.7,19,16,1,15,17,49,31
1256,Marin Jakoliš,hr,FW,,Angers,Ligue 1,24,1996,2.5,2,1,0,1,1,0,6,0.0,6,0,0,0,1,3,0
1257,Abdel Jalil Medioub,dz,DF,,Bordeaux,Ligue 1,23,1997,6.9,9,5,5,3,1,3,4,75.0,1,8,4,4,12,21,34
1258,Daniel James,wls,FW,,Manchester Utd,Premier League,23,1997,1.4,2,1,0,2,0,0,0,,0,2,0,2,0,2,1
1259,Daniel James,wls,FW,MF,Leeds United,Premier League,23,1997,26.3,24,14,8,8,8,10,23,43.5,13,18,1,17,8,32,12
1260,Reece James,eng,DF,,Chelsea,Premier League,21,1999,20.7,33,25,14,18,1,9,22,40.9,13,20,2,18,17,50,22
1261,Vitaly Janelt,de,MF,,Brentford,Premier League,23,1998,25.5,61,32,26,27,8,27,53,50.9,26,23,7,16,28,89,35
1262,Jakub Jankto,cz,DF,MF,Getafe,La Liga,25,1996,6.5,11,7,5,5,1,10,17,58.8,7,4,0,4,4,15,7
1263,Pontus Jansson,se,DF,,Brentford,Premier League,30,1991,36.9,40,21,32,8,0,22,34,64.7,12,37,27,10,52,92,187
1264,Tony Jantschke,de,DF,,Gladbach,Bundesliga,31,1990,2.5,6,5,2,4,0,3,6,50.0,3,3,2,1,5,11,8
1265,Adnan Januzaj,be,FW,MF,Real Sociedad,La Liga,26,1995,18.1,17,11,5,8,4,9,24,37.5,15,15,3,12,12,29,15
1266,Léo Jardim,br,GK,,Lille,Ligue 1,26,1995,17.0,0,0,0,0,0,0,0,,0,0,0,0,1,1,10
1267,Paweł Jaroszyński,pl,DF,,Salernitana,Serie A,26,1994,5.7,10,5,7,3,0,5,7,71.4,2,4,0,4,10,20,19
1268,Jason,es,MF,FW,Alavés,La Liga,27,1994,7.5,11,7,6,4,1,7,20,35.0,13,7,0,7,7,18,5
1269,Jason,es,MF,DF,Valencia,La Liga,27,1994,0.8,4,1,2,1,1,0,1,0.0,1,2,0,2,1,5,1
1270,Dennis Jastrzembski,pl,DF,FW,Hertha BSC,Bundesliga,21,2000,2.5,2,1,1,1,0,2,8,25.0,6,1,0,1,5,7,3
1271,Luis Javier Suárez,co,FW,,Granada,La Liga,23,1997,31.6,26,14,9,9,8,8,27,29.6,19,25,3,22,6,32,23
1272,Corentin Jean,fr,FW,MF,Lens,Ligue 1,26,1995,2.8,9,6,4,4,1,3,6,50.0,3,5,0,5,1,10,0
1273,Jemerson,br,DF,,Metz,Ligue 1,28,1992,13.4,37,25,30,7,0,18,26,69.2,8,23,8,15,25,62,33
1274,Fredrik Jensen,fi,MF,FW,Augsburg,Bundesliga,23,1997,4.6,5,4,1,3,1,4,7,57.1,3,5,1,4,2,7,4
1275,Mathias Jensen,dk,MF,,Brentford,Premier League,25,1996,17.8,33,18,12,16,5,22,63,34.9,41,32,3,29,22,55,13
1276,Moritz Jenz,de,DF,,Lorient,Ligue 1,22,1999,15.3,26,12,18,6,2,11,24,45.8,13,19,11,8,28,54,55
1277,Gabriel Jesus,br,FW,,Manchester City,Premier League,24,1997,20.9,18,12,2,4,12,6,26,23.1,20,18,0,18,15,33,8
1278,Juan Jesus,br,DF,,Napoli,Serie A,30,1991,14.2,25,17,14,11,0,12,18,66.7,6,21,16,5,9,34,34
1279,Álvaro Jiménez,es,MF,FW,Cádiz,La Liga,26,1995,2.6,6,3,3,2,1,4,7,57.1,3,3,0,3,3,9,0
1280,Raúl Jiménez,mx,FW,,Wolves,Premier League,30,1991,29.2,29,14,6,16,7,6,30,20.0,24,31,5,26,13,42,26
1281,João Pedro,br,FW,MF,Watford,Premier League,19,2001,18.3,20,14,7,8,5,6,23,26.1,17,23,3,20,15,35,17
1282,Joaquín,es,FW,MF,Betis,La Liga,40,1981,5.2,6,2,4,2,0,3,8,37.5,5,5,2,3,3,9,10
1283,Joelinton,br,MF,FW,Newcastle Utd,Premier League,24,1996,28.4,72,38,30,33,9,26,61,42.6,35,46,11,35,34,106,50
1284,Jofre,es,MF,DF,Espanyol,La Liga,20,2001,0.2,1,1,0,0,1,1,1,100.0,0,0,0,0,0,1,0
1285,Marco John,de,DF,,Hoffenheim,Bundesliga,19,2002,0.5,0,0,0,0,0,0,1,0.0,1,1,0,1,1,1,1
1286,Dennis Johnsen,no,FW,MF,Venezia,Serie A,23,1998,16.1,14,10,8,4,2,6,18,33.3,12,14,1,13,5,19,3
1287,Ben Johnson,eng,DF,,West Ham,Premier League,21,2000,15.5,33,16,15,15,3,21,28,75.0,7,16,8,8,22,55,55
1288,Curtis Jones,eng,MF,,Liverpool,Premier League,20,2001,9.5,11,9,3,6,2,1,10,10.0,9,4,0,4,6,17,4
1289,Phil Jones,eng,DF,,Manchester Utd,Premier League,29,1992,1.8,5,5,3,1,1,2,3,66.7,1,4,4,0,3,8,8
1290,Frenkie de Jong,nl,MF,,Barcelona,La Liga,24,1997,27.5,35,19,12,18,5,12,23,52.2,11,19,5,14,20,55,16
1291,Luuk de Jong,nl,FW,,Barcelona,La Liga,30,1990,7.3,9,7,1,5,3,1,2,50.0,1,4,0,4,0,9,12
1292,Joan Jordán,es,MF,,Sevilla,La Liga,27,1994,27.9,61,30,22,31,8,28,65,43.1,37,27,6,21,30,91,18
1293,Kaio Jorge,br,MF,FW,Juventus,Serie A,19,2002,1.3,2,1,0,2,0,1,3,33.3,2,1,0,1,0,2,2
1294,Jorginho,it,MF,,Chelsea,Premier League,29,1991,25.3,64,33,27,31,6,29,83,34.9,54,27,4,23,36,100,21
1295,Josan,es,DF,MF,Elche,La Liga,31,1989,13.5,36,22,23,9,4,26,44,59.1,18,11,4,7,10,46,21
1296,Willian José,br,FW,,Betis,La Liga,29,1991,17.8,15,13,2,10,3,2,8,25.0,6,10,2,8,3,18,16
1297,Joselu,es,FW,,Alavés,La Liga,31,1990,34.7,16,11,1,9,6,7,25,28.0,18,21,4,17,7,23,45
1298,Josema,es,DF,,Elche,La Liga,25,1996,2.0,3,2,1,1,1,0,2,0.0,2,1,1,0,0,3,11
1299,Lenny Joseph,fr,FW,MF,Metz,Ligue 1,20,2000,1.7,2,1,1,1,0,0,0,,0,3,0,3,0,2,0
1300,Diogo Jota,pt,FW,,Liverpool,Premier League,24,1996,26.3,39,18,12,18,9,13,55,23.6,42,19,2,17,6,45,6
1301,Stevan Jovetić,me,FW,MF,Hertha BSC,Bundesliga,31,1989,11.3,5,2,0,2,3,1,6,16.7,5,3,0,3,1,6,6
1302,Luka Jović,rs,FW,,Real Madrid,La Liga,23,1997,4.1,1,1,0,1,0,0,1,0.0,1,3,0,3,1,2,4
1303,Miguel Juan Llambrich,es,DF,,Espanyol,La Liga,25,1996,0.8,2,2,1,1,0,0,0,,0,1,0,1,0,2,5
1304,José Juan Macías,mx,FW,MF,Getafe,La Liga,21,1999,2.2,1,0,0,0,1,0,1,0.0,1,1,0,1,1,2,0
1305,Juanmi,es,FW,,Betis,La Liga,28,1993,23.7,39,25,11,19,9,19,49,38.8,30,24,1,23,9,48,10
1306,Gideon Jung,de,DF,,Greuther Fürth,Bundesliga,26,1994,1.6,3,1,1,2,0,2,4,50.0,2,1,1,0,2,5,5
1307,Flavio Junior Bianchi,it,FW,MF,Genoa,Serie A,21,2000,3.5,2,2,1,0,1,0,2,0.0,2,0,0,0,0,2,0
1308,Lago Junior,ci,FW,MF,Mallorca,La Liga,30,1990,2.0,3,2,3,0,0,3,5,60.0,2,0,0,0,2,5,2
1309,Hamed Junior Traorè,ci,FW,MF,Sassuolo,Serie A,21,2000,19.7,32,18,8,14,10,10,46,21.7,36,22,2,20,12,44,6
1310,Vinicius Júnior,br,FW,,Real Madrid,La Liga,21,2000,29.9,46,24,23,19,4,15,50,30.0,35,25,0,25,6,52,6
1311,James Justin,eng,DF,,Leicester City,Premier League,23,1998,11.1,22,13,11,8,3,7,15,46.7,8,16,4,12,17,39,34
1312,Ferran Jutglà,es,FW,,Barcelona,La Liga,22,1999,3.3,2,1,0,1,1,0,1,0.0,1,2,0,2,1,3,1
1313,Jens Jønsson,dk,MF,,Cádiz,La Liga,28,1993,14.5,40,29,22,17,1,17,35,48.6,18,17,7,10,34,74,32
1314,Mathias Jørgensen,dk,DF,,Brentford,Premier League,31,1990,5.8,10,4,3,5,2,7,10,70.0,3,6,1,5,10,20,13
1315,Ozan Kabak,tr,DF,,Norwich City,Premier League,21,2000,10.2,10,5,4,6,0,5,9,55.6,4,19,11,8,16,26,26
1316,Christian Kabasele,be,DF,,Watford,Premier League,30,1991,13.3,11,5,10,1,0,7,10,70.0,3,20,16,4,14,25,67
1317,Issa Kaboré,bf,DF,MF,Troyes,Ligue 1,20,2001,25.0,45,22,22,14,9,20,38,52.6,18,27,2,25,20,65,38
1318,Anton Kade,de,FW,MF,Hertha BSC,Bundesliga,17,2004,0.9,4,2,3,1,0,2,8,25.0,6,3,0,3,3,7,1
1319,Pavel Kadeřábek,cz,DF,MF,Hoffenheim,Bundesliga,29,1992,13.3,11,10,6,3,2,5,16,31.3,11,18,6,12,13,24,22
1320,Tino Kadewere,zw,FW,,Lyon,Ligue 1,25,1996,5.6,7,5,2,2,3,4,13,30.8,9,7,0,7,4,11,1
1321,Florian Kainz,at,MF,FW,Köln,Bundesliga,28,1992,25.8,41,26,9,25,7,23,51,45.1,28,27,3,24,32,73,24
1322,Gaël Kakuta,cd,MF,FW,Lens,Ligue 1,30,1991,18.6,22,14,2,13,7,4,20,20.0,16,10,0,10,4,26,3
1323,Sasa Kalajdzic,at,FW,,Stuttgart,Bundesliga,24,1997,13.6,10,6,2,5,3,3,11,27.3,8,5,0,5,2,12,14
1324,Arnaud Kalimuendo,fr,FW,,Lens,Ligue 1,19,2002,23.9,9,8,1,3,5,2,7,28.6,5,6,1,5,8,17,0
1325,Arnaud Kalimuendo,fr,FW,,Paris S-G,Ligue 1,19,2002,0.1,0,0,0,0,0,0,0,,0,0,0,0,0,0,0
1326,Nikola Kalinić,hr,FW,,Hellas Verona,Serie A,33,1988,4.5,2,0,0,1,1,1,2,50.0,1,2,0,2,0,2,2
1327,Yayah Kallon,sl,FW,MF,Genoa,Serie A,20,2001,7.1,15,11,5,6,4,3,11,27.3,8,7,1,6,1,16,5
1328,Samuel Kalu,ng,FW,,Watford,Premier League,23,1997,2.5,2,2,0,2,0,1,1,100.0,0,2,0,2,3,5,3
1329,Samuel Kalu,ng,FW,MF,Bordeaux,Ligue 1,23,1997,3.6,8,5,3,4,1,2,5,40.0,3,2,0,2,3,11,1
1330,Pierre Kalulu,fr,DF,,Milan,Serie A,21,2000,21.6,61,36,36,21,4,17,22,77.3,5,36,15,21,26,87,54
1331,Daichi Kamada,jp,MF,,Eint Frankfurt,Bundesliga,24,1996,23.8,40,21,7,26,7,11,40,27.5,29,18,0,18,8,48,10
1332,Boubacar Kamara,fr,MF,DF,Marseille,Ligue 1,21,1999,30.9,68,38,27,36,5,26,47,55.3,21,29,10,19,46,114,44
1333,Hassane Kamara,ci,DF,,Watford,Premier League,27,1994,18.0,53,34,31,16,6,27,43,62.8,16,20,4,16,69,122,67
1334,Hassane Kamara,ci,MF,DF,Nice,Ligue 1,27,1994,6.0,13,10,4,6,3,5,8,62.5,3,10,2,8,9,22,4
1335,Dimitrije Kamenović,rs,DF,,Lazio,Serie A,21,2000,0.5,1,1,1,0,0,1,1,100.0,0,0,0,0,2,3,1
1336,Kevin Kampl,si,MF,,RB Leipzig,Bundesliga,30,1990,21.1,41,19,16,20,5,10,42,23.8,32,24,5,19,24,65,17
1337,Jean-Armel Kana-Biyik,cm,DF,,Metz,Ligue 1,32,1989,7.4,10,6,8,2,0,4,9,44.4,5,11,4,7,16,26,22
1338,Nordine Kandil,fr,MF,FW,Strasbourg,Ligue 1,19,2001,1.0,2,1,2,0,0,1,1,100.0,0,1,1,0,0,2,0
1339,Harry Kane,eng,FW,,Tottenham,Premier League,28,1993,35.9,15,5,2,10,3,7,18,38.9,11,26,8,18,3,18,39
1340,Lee Kang-in,kr,MF,FW,Mallorca,La Liga,20,2001,15.7,13,6,2,9,2,5,29,17.2,24,11,1,10,5,18,7
1341,N'Golo Kanté,fr,MF,,Chelsea,Premier League,30,1991,19.7,59,31,20,27,12,25,40,62.5,15,37,2,35,31,90,8
1342,Stefanos Kapino,gr,GK,,Arminia,Bundesliga,27,1994,1.0,0,0,0,0,0,0,0,,0,0,0,0,0,0,0
1343,Atakan Karazor,,MF,,Stuttgart,Bundesliga,24,1996,21.1,48,24,18,27,3,18,36,50.0,18,37,14,23,34,82,47
1344,Rick Karsdorp,nl,DF,FW,Roma,Serie A,26,1995,32.0,53,38,33,13,7,28,50,56.0,22,22,5,17,34,87,26
1345,Denso Kasius,nl,DF,FW,Bologna,Serie A,18,2002,2.0,9,7,5,3,1,2,5,40.0,3,4,0,4,3,12,4
1346,Grigoris Kastanos,cy,MF,FW,Salernitana,Serie A,23,1998,15.0,30,19,9,19,2,7,23,30.4,16,21,5,16,22,52,8
1347,Silas Katompa,cd,FW,MF,Stuttgart,Bundesliga,22,1998,3.1,5,4,4,0,1,3,7,42.9,4,5,0,5,2,7,1
1348,Noah Katterbach,de,DF,,Köln,Bundesliga,20,2001,0.2,1,1,1,0,0,1,1,100.0,0,0,0,0,0,1,1
1349,Eiji Kawashima,jp,GK,,Strasbourg,Ligue 1,38,1983,1.0,0,0,0,0,0,0,0,,0,0,0,0,0,0,0
1350,Edo Kayembe,cd,MF,,Watford,Premier League,23,1998,8.9,21,13,11,9,1,8,16,50.0,8,6,1,5,9,30,13
1351,Moise Kean,it,FW,,Everton,Premier League,21,2000,0.0,0,0,0,0,0,0,0,,0,0,0,0,0,0,0
1352,Moise Kean,it,FW,,Juventus,Serie A,21,2000,12.2,9,4,2,5,2,6,16,37.5,10,5,0,5,3,12,8
1353,Michael Keane,eng,DF,,Everton,Premier League,28,1993,31.0,46,25,32,13,1,28,45,62.2,17,33,28,5,62,108,128
1354,Ilan Kebbal,dz,MF,FW,Reims,Ligue 1,23,1998,19.7,31,15,13,10,8,12,44,27.3,32,16,0,16,13,44,3
1355,Wajdi Kechrida,tn,DF,MF,Salernitana,Serie A,25,1995,10.6,9,6,6,3,0,8,13,61.5,5,10,2,8,8,17,15
1356,Thilo Kehrer,de,DF,,Paris S-G,Ligue 1,24,1996,16.8,21,14,9,11,1,9,21,42.9,12,19,11,8,24,45,29
1357,Habib Keita,ml,MF,FW,Lyon,Ligue 1,19,2002,0.1,0,0,0,0,0,0,0,,0,0,0,0,0,0,0
1358,Naby Keïta,gn,MF,,Liverpool,Premier League,26,1995,13.0,46,23,17,19,10,26,42,61.9,16,33,2,31,14,60,8
1359,Yannik Keitel,de,MF,,Freiburg,Bundesliga,21,2000,5.6,11,4,5,4,2,5,15,33.3,10,7,1,6,1,12,8
1360,Caoimhín Kelleher,ie,GK,,Liverpool,Premier League,22,1998,2.0,1,1,1,0,0,1,1,100.0,0,0,0,0,0,1,1
1361,Marc-Oliver Kempf,de,DF,,Hertha BSC,Bundesliga,26,1995,11.7,10,9,9,1,0,5,14,35.7,9,14,7,7,25,35,49
1362,Marc-Oliver Kempf,de,DF,,Stuttgart,Bundesliga,26,1995,9.3,13,8,7,4,2,3,10,30.0,7,16,14,2,16,29,26
1363,Kenedy,br,DF,,Chelsea,Premier League,25,1996,0.6,5,2,1,2,2,2,3,66.7,1,0,0,0,0,5,0
1364,Jonjoe Kenny,eng,DF,,Everton,Premier League,24,1997,11.3,17,7,11,6,0,13,21,61.9,8,8,1,7,20,37,31
1365,Dimitrios Keramitsis,gr,MF,,Roma,Serie A,17,2004,0.0,0,0,0,0,0,0,0,,0,0,0,0,0,0,0
1366,Franck Kessié,ci,MF,,Milan,Serie A,24,1996,25.6,41,23,12,24,5,17,26,65.4,9,39,10,29,23,64,22
1367,Saîf-Eddine Khaoui,tn,MF,FW,Clermont Foot,Ligue 1,26,1995,10.3,19,10,5,10,4,9,18,50.0,9,9,0,9,14,33,5
1368,Wahbi Khazri,tn,FW,MF,Saint-Étienne,Ligue 1,30,1991,24.7,33,18,7,17,9,9,34,26.5,25,21,0,21,12,45,7
1369,Rani Khedira,de,MF,,Union Berlin,Bundesliga,27,1994,30.6,75,38,25,42,8,32,66,48.5,34,21,8,13,50,125,27
1370,Kiké,es,FW,,Osasuna,La Liga,31,1989,20.7,11,7,3,4,4,3,23,13.0,20,10,1,9,3,14,12
1371,Luca Kilian,de,FW,,Mainz 05,Bundesliga,21,1999,0.0,0,0,0,0,0,0,0,,0,0,0,0,0,0,0
1372,Luca Kilian,de,DF,,Köln,Bundesliga,21,1999,25.3,42,24,30,9,3,21,41,51.2,20,31,13,18,46,88,109
1373,Max Kilman,eng,DF,,Wolves,Premier League,24,1997,29.9,50,26,38,10,2,24,37,64.9,13,36,21,15,45,95,113
1374,Joshua Kimmich,de,MF,,Bayern Munich,Bundesliga,26,1995,27.5,39,20,14,17,8,18,58,31.0,40,34,8,26,52,91,29
1375,Presnel Kimpembe,fr,DF,,Paris S-G,Ligue 1,25,1995,28.6,34,19,18,15,1,14,23,60.9,9,20,14,6,38,72,73
1376,Joshua King,no,FW,,Watford,Premier League,29,1992,25.0,19,15,7,6,6,4,17,23.5,13,15,4,11,8,27,31
1377,Jakub Kiwior,pl,MF,,Spezia,Serie A,21,2000,21.8,50,27,25,19,6,26,57,45.6,31,38,15,23,40,90,53
1378,Sofian Kiyine,ma,MF,FW,Venezia,Serie A,23,1997,13.8,24,14,9,11,4,12,32,37.5,20,15,1,14,10,34,9
1379,Simon Kjær,dk,DF,,Milan,Serie A,32,1989,8.9,20,12,9,8,3,6,12,50.0,6,17,13,4,9,29,39
1380,Kristoffer Klaesson,no,GK,,Leeds United,Premier League,20,2000,0.4,0,0,0,0,0,0,0,,0,0,0,0,0,0,0
1381,Philipp Klement,de,MF,,Stuttgart,Bundesliga,28,1992,3.8,7,3,1,4,2,3,3,100.0,0,6,1,5,1,8,0
1382,Mateusz Klich,pl,MF,,Leeds United,Premier League,31,1990,23.0,47,25,18,23,6,25,66,37.9,41,22,4,18,11,58,20
1383,Thibault Klidje,tg,MF,FW,Bordeaux,Ligue 1,20,2001,1.0,0,0,0,0,0,0,1,0.0,1,1,1,0,2,2,0
1384,Mateo Klimowicz,de,MF,FW,Stuttgart,Bundesliga,21,2000,6.7,13,6,6,7,0,5,16,31.3,11,2,0,2,4,17,3
1385,Fabian Klos,de,FW,,Arminia,Bundesliga,33,1987,15.8,7,5,0,5,2,2,10,20.0,8,17,4,13,0,7,31
1386,Lukas Klostermann,de,DF,,RB Leipzig,Bundesliga,25,1996,18.3,29,16,11,15,3,13,19,68.4,6,16,3,13,26,55,58
1387,Justin Kluivert,nl,MF,,Nice,Ligue 1,22,1999,20.8,19,9,6,12,1,5,21,23.8,16,13,1,12,14,33,6
1388,Lukas Klünter,de,DF,,Hertha BSC,Bundesliga,25,1996,2.2,1,1,1,0,0,1,5,20.0,4,1,0,1,2,3,2
1389,Ansgar Knauff,de,FW,MF,Dortmund,Bundesliga,19,2002,1.3,3,1,1,1,1,0,4,0.0,4,2,0,2,0,3,4
1390,Ansgar Knauff,de,DF,MF,Eint Frankfurt,Bundesliga,19,2002,8.4,18,14,8,5,5,8,15,53.3,7,11,1,10,8,26,6
1391,Robin Knoche,de,DF,,Union Berlin,Bundesliga,29,1992,33.0,50,24,38,12,0,30,53,56.6,23,45,26,19,49,99,151
1392,Gregor Kobel,ch,GK,,Dortmund,Bundesliga,23,1997,28.5,0,0,0,0,0,0,2,0.0,2,0,0,0,1,1,20
1393,Robin Koch,de,MF,DF,Leeds United,Premier League,25,1996,17.5,21,13,9,10,2,9,34,26.5,25,26,10,16,20,41,44
1394,Samuel Koeberlé,fr,FW,,Reims,Ligue 1,16,2004,0.0,0,0,0,0,0,0,0,,0,0,0,0,0,0,0
1395,Philippe Koffi,ci,FW,,Reims,Ligue 1,19,2002,4.2,4,0,0,3,1,0,2,0.0,2,2,1,1,3,7,3
1396,Dominik Kohr,de,MF,,Mainz 05,Bundesliga,27,1994,17.9,40,20,18,19,3,16,42,38.1,26,21,2,19,35,75,22
1397,Koba Koindredi,fr,MF,,Valencia,La Liga,19,2001,2.0,4,3,2,1,1,2,6,33.3,4,3,0,3,4,8,5
1398,Koke,es,MF,,Atlético Madrid,La Liga,29,1992,27.9,55,30,19,29,7,26,63,41.3,37,21,5,16,24,79,31
1399,Aleksandr Kokorin,ru,FW,MF,Fiorentina,Serie A,30,1991,0.6,1,1,1,0,0,0,0,,0,1,0,1,0,1,0
1400,Aleksandar Kolarov,rs,DF,,Inter,Serie A,35,1985,0.5,1,1,1,0,0,1,1,100.0,0,0,0,0,1,2,2
1401,Sead Kolašinac,ba,DF,,Arsenal,Premier League,28,1993,1.0,0,0,0,0,0,0,0,,0,0,0,0,4,4,1
1402,Sead Kolašinac,ba,DF,,Marseille,Ligue 1,28,1993,4.9,7,6,2,3,2,5,8,62.5,3,4,0,4,0,7,7
1403,Luca Koleosho,it,FW,,Espanyol,La Liga,16,2004,0.0,0,0,0,0,0,0,0,,0,0,0,0,0,0,0
1404,Randal Kolo Muani,fr,FW,MF,Nantes,Ligue 1,22,1998,32.8,28,14,7,10,11,10,25,40.0,15,14,3,11,6,34,31
1405,Timothée Kolodziejczak,fr,DF,,Saint-Étienne,Ligue 1,29,1991,28.5,43,24,22,14,7,20,36,55.6,16,29,7,22,60,103,72
1406,Ghislain Konan,ci,DF,,Reims,Ligue 1,25,1995,26.9,35,19,19,15,1,16,30,53.3,14,35,8,27,28,63,45
1407,Ibrahima Konaté,fr,DF,,Liverpool,Premier League,22,1999,11.0,16,10,9,6,1,7,10,70.0,3,13,9,4,16,32,37
1408,Geoffrey Kondogbia,cf,MF,DF,Atlético Madrid,La Liga,28,1993,20.9,74,44,25,40,9,21,49,42.9,28,16,5,11,44,118,24
1409,Ibrahima Koné,ml,FW,,Lorient,Ligue 1,22,1999,8.1,7,4,0,3,4,2,3,66.7,1,8,3,5,1,8,3
1410,Manu Koné,fr,MF,,Gladbach,Bundesliga,20,2001,24.3,60,37,29,28,3,25,42,59.5,17,27,4,23,34,94,12
1411,Youssouf Koné,ml,DF,,Troyes,Ligue 1,26,1995,10.9,30,18,21,8,1,19,30,63.3,11,8,3,5,10,40,25
1412,Ezri Konsa,eng,DF,,Aston Villa,Premier League,23,1997,27.5,25,15,13,11,1,10,13,76.9,3,31,22,9,15,40,86
1413,Teun Koopmeiners,nl,MF,,Atalanta,Serie A,23,1998,23.6,40,24,10,19,11,22,54,40.7,32,31,2,29,15,55,19
1414,Laurent Koscielny,fr,DF,,Bordeaux,Ligue 1,35,1985,10.4,14,9,10,3,1,8,13,61.5,5,17,12,5,12,26,39
1415,Odilon Kossounou,ci,DF,,Leverkusen,Bundesliga,20,2001,19.9,23,17,16,6,1,15,25,60.0,10,36,14,22,26,49,66
1416,Filip Kostić,rs,DF,FW,Eint Frankfurt,Bundesliga,28,1992,28.0,44,17,26,9,9,20,53,37.7,33,24,1,23,15,59,24
1417,Rominigue Kouamé,ml,MF,,Troyes,Ligue 1,24,1996,33.0,47,22,24,20,3,19,58,32.8,39,33,5,28,46,93,22
1418,Kalidou Koulibaly,sn,DF,,Napoli,Serie A,30,1991,26.7,39,23,31,6,2,25,38,65.8,13,41,25,16,29,68,90
1419,Jules Koundé,fr,DF,,Sevilla,La Liga,22,1998,30.4,40,17,27,10,3,18,28,64.3,10,33,18,15,21,61,101
1420,Christos Kourfalidis,gr,MF,FW,Cagliari,Serie A,18,2002,0.2,0,0,0,0,0,0,1,0.0,1,1,0,1,0,0,0
1421,Boubakar Kouyaté,ml,DF,,Metz,Ligue 1,24,1997,29.6,84,50,56,28,0,48,77,62.3,29,63,33,30,79,163,217
1422,Cheikhou Kouyaté,sn,MF,,Crystal Palace,Premier League,31,1989,21.9,52,38,28,22,2,18,39,46.2,21,40,14,26,38,90,39
1423,Mateo Kovačić,hr,MF,,Chelsea,Premier League,27,1994,17.3,51,31,14,26,11,17,35,48.6,18,19,4,15,7,58,9
1424,Viktor Kovalenko,ua,MF,,Spezia,Serie A,25,1996,14.7,16,10,7,8,1,9,21,42.9,12,16,3,13,13,29,8
1425,Emil Krafth,se,DF,,Newcastle Utd,Premier League,26,1994,18.2,37,16,25,11,1,27,36,75.0,9,16,10,6,25,62,56
1426,Alex Král,cz,MF,,West Ham,Premier League,23,1998,0.0,0,0,0,0,0,0,0,,0,0,0,0,0,0,0
1427,Andrej Kramarić,hr,FW,MF,Hoffenheim,Bundesliga,30,1991,30.1,8,4,1,5,2,7,17,41.2,10,10,0,10,9,17,7
1428,Christoph Kramer,de,MF,,Gladbach,Bundesliga,30,1991,8.3,28,11,15,10,3,12,28,42.9,16,18,5,13,12,40,9
1429,Jean-Philippe Krasso,ci,FW,,Saint-Étienne,Ligue 1,24,1997,5.0,7,5,0,5,2,2,10,20.0,8,7,1,6,0,7,1
1430,Julian Kristoffersen,no,FW,,Salernitana,Serie A,24,1997,0.1,0,0,0,0,0,0,0,,0,0,0,0,0,0,0
1431,Toni Kroos,de,MF,,Real Madrid,La Liga,31,1990,23.4,34,26,13,17,4,14,36,38.9,22,16,3,13,12,46,13
1432,Florian Krüger,de,FW,MF,Arminia,Bundesliga,22,1999,12.5,3,1,0,3,0,2,10,20.0,8,12,1,11,2,5,13
1433,Tim Krul,nl,GK,,Norwich City,Premier League,33,1988,29.0,1,1,1,0,0,1,4,25.0,3,0,0,0,0,1,10
1434,Rade Krunić,ba,MF,FW,Milan,Serie A,27,1993,15.7,33,18,16,14,3,15,31,48.4,16,19,2,17,16,49,17
1435,Max Kruse,de,MF,FW,Wolfsburg,Bundesliga,33,1988,12.5,9,3,4,4,1,5,12,41.7,7,2,0,2,3,12,4
1436,Max Kruse,de,FW,MF,Union Berlin,Bundesliga,33,1988,14.1,4,1,0,3,1,2,16,12.5,14,12,0,12,3,7,2
1437,Lukas Kübler,de,DF,MF,Freiburg,Bundesliga,28,1992,25.9,62,35,38,16,8,28,49,57.1,21,24,8,16,44,106,70
1438,Takefusa Kubo,jp,FW,MF,Mallorca,La Liga,20,2001,17.8,31,19,12,14,5,10,24,41.7,14,24,3,21,8,39,4
1439,Juraj Kucka,sk,MF,,Watford,Premier League,34,1987,21.3,59,39,32,25,2,27,73,37.0,46,30,9,21,27,86,46
1440,Mykola Kukharevych,ua,FW,,Troyes,Ligue 1,20,2001,0.2,0,0,0,0,0,0,0,,0,0,0,0,0,0,0
1441,Dejan Kulusevski,se,MF,FW,Tottenham,Premier League,21,2000,14.0,19,13,7,10,2,5,23,21.7,18,14,0,14,13,32,3
1442,Dejan Kulusevski,se,FW,MF,Juventus,Serie A,21,2000,8.6,15,12,9,6,0,8,21,38.1,13,14,0,14,5,20,5
1443,Marash Kumbulla,al,DF,,Roma,Serie A,21,2000,11.4,21,13,13,7,1,8,15,53.3,7,17,8,9,16,37,26
1444,Fabian Kunze,de,MF,,Arminia,Bundesliga,23,1998,14.0,35,21,14,20,1,15,32,46.9,17,17,2,15,19,54,27
1445,Enock Kwateng,fr,DF,,Bordeaux,Ligue 1,24,1997,22.2,54,35,31,19,4,33,72,45.8,39,17,4,13,43,97,48
1446,Grejohn Kyei,fr,FW,,Clermont Foot,Ligue 1,25,1995,4.4,3,2,1,1,1,0,6,0.0,6,6,0,6,0,3,1
1447,Giorgos Kyriakopoulos,gr,DF,FW,Sassuolo,Serie A,25,1996,21.9,30,14,19,7,4,19,38,50.0,19,32,9,23,11,41,52
1448,Andrea La Mantia,it,FW,MF,Empoli,Serie A,30,1991,5.4,2,0,0,0,2,1,2,50.0,1,3,1,2,1,3,6
1449,Gaëtan Laborde,fr,FW,,Montpellier,Ligue 1,27,1994,3.8,2,2,1,1,0,2,4,50.0,2,3,0,3,5,7,5
1450,Gaëtan Laborde,fr,FW,,Rennes,Ligue 1,27,1994,30.3,19,7,5,8,6,3,22,13.6,19,29,3,26,8,27,16
1451,Alexandre Lacazette,fr,FW,,Arsenal,Premier League,30,1991,19.8,27,10,8,13,6,7,21,33.3,14,12,1,11,5,32,6
1452,Tom Lacoux,fr,DF,MF,Bordeaux,Ligue 1,19,2002,10.1,18,13,11,5,2,9,24,37.5,15,14,4,10,9,27,20
1453,Lenny Lacroix,fr,DF,,Metz,Ligue 1,18,2003,2.2,9,7,8,1,0,5,8,62.5,3,5,1,4,10,19,5
1454,Maxence Lacroix,fr,DF,,Wolfsburg,Bundesliga,21,2000,27.7,59,33,41,16,2,29,40,72.5,11,35,16,19,60,119,144
1455,Alban Lafont,fr,GK,,Nantes,Ligue 1,22,1999,38.0,3,3,3,0,0,3,8,37.5,5,1,0,1,1,4,25
1456,Víctor Laguardia,es,DF,,Alavés,La Liga,31,1989,33.8,29,16,21,8,0,19,30,63.3,11,36,24,12,27,56,151
1457,Konrad Laimer,at,MF,,RB Leipzig,Bundesliga,24,1997,13.8,38,24,11,22,5,24,53,45.3,29,29,3,26,4,42,9
1458,Stefan Lainer,at,DF,,Gladbach,Bundesliga,28,1992,16.3,19,11,9,7,3,12,28,42.9,16,24,5,19,14,33,31
1459,Diego Lainez,mx,FW,,Betis,La Liga,21,2000,1.6,1,1,0,1,0,0,3,0.0,3,3,0,3,1,2,0
1460,Adam Lallana,eng,MF,,Brighton,Premier League,33,1988,17.3,34,17,14,14,6,12,41,29.3,29,16,6,10,16,50,13
1461,Vassilis Lambropoulos,gr,DF,,Bochum,Bundesliga,31,1990,13.0,18,12,13,3,2,11,25,44.0,14,21,10,11,17,35,56
1462,Érik Lamela,ar,FW,MF,Sevilla,La Liga,29,1992,11.3,31,18,12,14,5,10,29,34.5,19,11,0,11,5,36,3
1463,Mohamed Lamine Bayo,gn,FW,,Clermont Foot,Ligue 1,23,1998,26.8,12,5,4,3,5,3,24,12.5,21,7,1,6,7,19,14
1464,Didier Lamkel Zé,cm,FW,,Metz,Ligue 1,24,1996,6.7,3,1,1,0,2,1,3,33.3,2,3,1,2,1,4,7
1465,Sam Lammers,nl,FW,MF,Atalanta,Serie A,24,1997,0.4,1,0,0,0,1,0,0,,0,0,0,0,0,1,0
1466,Sam Lammers,nl,FW,MF,Eint Frankfurt,Bundesliga,24,1997,5.7,4,4,0,2,2,2,6,33.3,4,9,2,7,2,6,4
1467,Tariq Lamptey,gh,DF,FW,Brighton,Premier League,20,2000,17.3,36,25,14,17,5,15,25,60.0,10,13,3,10,21,57,23
1468,Manuel Lanzini,ar,MF,FW,West Ham,Premier League,28,1993,19.8,28,15,10,11,7,10,35,28.6,25,16,0,16,19,47,10
1469,Aymeric Laporte,es,DF,,Manchester City,Premier League,27,1994,31.4,33,15,22,10,1,14,20,70.0,6,15,10,5,20,53,64
1470,Julien Laporte,fr,DF,,Lorient,Ligue 1,27,1993,32.1,63,45,35,26,2,32,64,50.0,32,37,22,15,54,117,174
1471,Yasser Larouci,dz,DF,,Troyes,Ligue 1,20,2001,3.8,6,5,2,4,0,3,3,100.0,0,1,0,1,7,13,5
1472,Kevin Lasagna,it,MF,FW,Hellas Verona,Serie A,28,1992,13.2,13,7,4,5,4,4,15,26.7,11,16,0,16,3,16,7
1473,Jamaal Lascelles,eng,DF,,Newcastle Utd,Premier League,27,1993,22.9,15,7,9,5,1,4,12,33.3,8,38,28,10,22,37,121
1474,Bryan Lasme,fr,FW,,Arminia,Bundesliga,22,1998,9.7,6,6,1,2,3,0,3,0.0,3,7,0,7,1,7,9
1475,Paul Lasne,fr,MF,,Brest,Ligue 1,32,1989,9.4,26,12,6,16,4,8,18,44.4,10,11,2,9,24,50,10
1476,Juanmi Latasa,es,FW,,Real Madrid,La Liga,20,2001,0.1,0,0,0,0,0,0,0,,0,0,0,0,0,0,0
1477,Toni Lato,es,DF,,Valencia,La Liga,23,1997,6.6,17,12,12,3,2,9,16,56.3,7,6,0,6,8,25,14
1478,Armand Lauriente,fr,FW,MF,Lorient,Ligue 1,22,1998,27.5,33,18,9,16,8,11,30,36.7,19,27,2,25,15,48,3
1479,Darko Lazović,rs,DF,,Hellas Verona,Serie A,30,1990,30.7,36,23,20,8,8,21,39,53.8,18,28,4,24,19,55,49
1480,Manuel Lazzari,it,DF,,Lazio,Serie A,27,1993,18.5,28,14,13,15,0,16,26,61.5,10,10,2,8,12,40,16
1481,Théo Le Bris,fr,MF,,Lorient,Ligue 1,18,2002,0.7,2,1,1,1,0,1,2,50.0,1,2,0,2,0,2,1
1482,Jérémy Le Douaron,fr,FW,MF,Brest,Ligue 1,23,1998,16.1,11,5,4,4,3,1,17,5.9,16,15,0,15,4,15,14
1483,Enzo Le Fée,fr,MF,FW,Lorient,Ligue 1,21,2000,24.4,70,44,25,36,9,41,90,45.6,49,25,1,24,29,99,18
1484,Vincent Le Goff,fr,DF,,Lorient,Ligue 1,31,1989,34.0,61,38,38,19,4,37,62,59.7,25,18,3,15,37,98,50
1485,Maxime Le Marchand,fr,DF,,Strasbourg,Ligue 1,31,1989,9.6,17,8,16,1,0,8,10,80.0,2,9,5,4,14,31,32
1486,Robin Le Normand,es,DF,,Real Sociedad,La Liga,24,1996,37.0,49,32,36,8,5,28,36,77.8,8,34,22,12,48,97,125
1487,Patrick Leal,us,FW,,Venezia,Serie A,18,2003,0.0,0,0,0,0,0,0,1,0.0,1,0,0,0,0,0,0
1488,Rafael Leão,pt,FW,,Milan,Serie A,22,1999,28.9,17,7,3,9,5,10,20,50.0,10,12,1,11,12,29,8
1489,Jean-Louis Leca,fr,GK,,Lens,Ligue 1,35,1985,25.7,0,0,0,0,0,0,0,,0,1,0,1,1,1,11
1490,Jeremías Ledesma,ar,GK,,Cádiz,La Liga,28,1993,38.0,3,1,3,0,0,3,4,75.0,1,0,0,0,1,4,21
1491,Pierre Lees-Melou,fr,MF,,Norwich City,Premier League,28,1993,25.2,58,36,23,29,6,25,92,27.2,67,37,11,26,25,83,23
1492,Wu Lei,cn,FW,MF,Espanyol,La Liga,29,1991,5.3,3,2,1,2,0,3,8,37.5,5,4,0,4,4,7,3
1493,Maxim Leitsch,de,DF,,Bochum,Bundesliga,23,1998,17.1,18,10,9,7,2,10,15,66.7,5,31,19,12,31,49,74
1494,Lucas Leiva,br,MF,,Lazio,Serie A,34,1987,18.9,55,30,26,25,4,15,53,28.3,38,27,10,17,28,83,37
1495,Florian Lejeune,fr,DF,,Alavés,La Liga,30,1991,30.0,33,24,22,10,1,12,20,60.0,8,30,19,11,31,64,158
1496,Iñigo Lekue,es,DF,,Athletic Club,La Liga,28,1993,21.4,32,23,16,12,4,22,44,50.0,22,37,12,25,23,55,63
1497,Thomas Lemar,fr,MF,,Atlético Madrid,La Liga,25,1995,16.0,24,14,9,12,3,8,23,34.8,15,18,0,18,8,32,11
1498,Félix Lemaréchal,fr,MF,,Monaco,Ligue 1,17,2003,0.1,0,0,0,0,0,0,1,0.0,1,0,0,0,0,0,0
1499,Mario Lemina,ga,MF,,Nice,Ligue 1,27,1993,21.9,62,35,25,33,4,28,38,73.7,10,32,9,23,48,110,37
1500,Fabien Lemoine,fr,MF,,Lorient,Ligue 1,34,1987,12.4,35,22,20,14,1,17,41,41.5,24,21,4,17,14,49,24
1501,Tim Lemperle,de,FW,MF,Köln,Bundesliga,19,2002,1.7,4,1,2,1,1,1,3,33.3,2,1,0,1,2,6,2
1502,Ruben Lendinez,es,DF,,Valencia,La Liga,18,2003,1.5,3,3,1,2,0,3,8,37.5,5,4,0,4,2,5,6
1503,Clément Lenglet,fr,DF,,Barcelona,La Liga,26,1995,9.2,20,11,11,7,2,8,13,61.5,5,7,3,4,13,33,21
1504,Aaron Lennon,eng,MF,FW,Burnley,Premier League,34,1987,17.2,33,17,10,13,10,10,34,29.4,24,26,4,22,9,42,14
1505,Bernd Leno,de,GK,,Arsenal,Premier League,29,1992,4.0,1,1,1,0,0,1,1,100.0,0,0,0,0,0,1,1
1506,Christopher Lenz,de,DF,,Eint Frankfurt,Bundesliga,26,1994,7.4,29,15,22,6,1,12,21,57.1,9,9,4,5,7,36,21
1507,Léo Leroy,fr,MF,,Montpellier,Ligue 1,21,2000,7.0,31,21,17,11,3,12,34,35.3,22,20,4,16,8,39,8
1508,Alexandre Letellier,fr,GK,,Paris S-G,Ligue 1,30,1990,0.1,0,0,0,0,0,0,0,,0,0,0,0,0,0,0
1509,Robert Lewandowski,pl,FW,,Bayern Munich,Bundesliga,32,1988,32.7,10,3,0,6,4,5,17,29.4,12,17,2,15,6,16,8
1510,Jamie Leweling,de,FW,MF,Greuther Fürth,Bundesliga,20,2001,21.8,13,8,3,7,3,3,16,18.8,13,9,0,9,13,26,5
1511,Jamal Lewis,nir,DF,,Newcastle Utd,Premier League,23,1998,2.9,8,6,6,1,1,3,4,75.0,1,3,2,1,3,11,8
1512,Luca Lezzerini,it,GK,,Venezia,Serie A,26,1995,5.5,0,0,0,0,0,0,0,,0,1,0,1,0,0,0
1513,Ben Lhassine Kone,ci,MF,,Torino,Serie A,21,2000,0.9,3,3,1,2,0,1,2,50.0,1,0,0,0,1,4,1
1514,Yanis Lhery,fr,FW,MF,Saint-Étienne,Ligue 1,18,2003,0.8,0,0,0,0,0,0,0,,0,4,0,4,0,0,0
1515,Dimitri Liénard,fr,DF,MF,Strasbourg,Ligue 1,33,1988,22.7,71,43,40,21,10,46,77,59.7,31,12,0,12,21,92,28
1516,Philipp Lienhart,at,DF,,Freiburg,Bundesliga,25,1996,31.9,24,13,17,6,1,13,24,54.2,11,33,23,10,50,74,158
1517,Matthijs de Ligt,nl,DF,,Juventus,Serie A,21,1999,29.7,34,19,21,13,0,15,18,83.3,3,31,21,10,26,60,103
1518,Isaac Lihadji,fr,MF,FW,Lille,Ligue 1,19,2002,2.6,3,3,1,1,1,1,5,20.0,4,1,0,1,2,5,0
1519,Anderson Lima,br,MF,,Lazio,Serie A,21,1999,0.7,2,0,1,1,0,0,2,0.0,2,1,0,1,2,4,1
1520,Andreas Linde,se,GK,,Greuther Fürth,Bundesliga,28,1993,12.0,0,0,0,0,0,0,0,,0,0,0,0,1,1,1
1521,Victor Lindelöf,se,DF,,Manchester Utd,Premier League,27,1994,26.2,16,11,9,7,0,9,14,64.3,5,26,17,9,25,41,96
1522,Jesper Lindstrøm,dk,MF,FW,Eint Frankfurt,Bundesliga,21,2000,22.0,28,13,6,13,9,12,36,33.3,24,30,0,30,24,52,11
1523,Karol Linetty,pl,MF,FW,Torino,Serie A,26,1995,10.0,14,8,3,4,7,6,18,33.3,12,8,0,8,3,17,2
1524,Jesse Lingard,eng,FW,MF,Manchester Utd,Premier League,28,1992,4.1,9,7,4,3,2,2,6,33.3,4,4,0,4,0,9,1
1525,Pol Lirola,es,DF,FW,Marseille,Ligue 1,23,1997,19.7,28,16,15,9,4,13,28,46.4,15,15,0,15,13,41,22
1526,Valentino Livramento,eng,DF,,Southampton,Premier League,18,2002,24.5,54,28,30,18,6,27,45,60.0,18,23,9,14,47,101,50
1527,Dejan Ljubicic,at,MF,FW,Köln,Bundesliga,23,1997,21.9,33,19,12,13,8,13,49,26.5,36,19,1,18,15,48,11
1528,Javier Llabrés,es,FW,MF,Mallorca,La Liga,18,2002,1.5,2,1,0,1,1,1,2,50.0,1,1,0,1,0,2,0
1529,Diego Llorente,es,DF,,Leeds United,Premier League,27,1993,26.0,53,31,32,19,2,33,47,70.2,14,35,17,18,40,93,77
1530,Marcos Llorente,es,MF,DF,Atlético Madrid,La Liga,26,1995,27.2,51,23,25,22,4,28,43,65.1,15,33,10,23,27,78,44
1531,Hugo Lloris,fr,GK,,Tottenham,Premier League,34,1986,38.0,1,1,1,0,0,1,2,50.0,1,0,0,0,1,2,24
1532,Giovani Lo Celso,ar,MF,FW,Tottenham,Premier League,25,1996,2.6,8,4,4,2,2,4,10,40.0,6,6,1,5,1,9,0
1533,Giovani Lo Celso,ar,FW,MF,Villarreal,La Liga,25,1996,11.0,22,12,8,10,4,9,22,40.9,13,4,0,4,5,27,3
1534,Julen Lobete,es,FW,MF,Real Sociedad,La Liga,20,2000,3.2,4,3,3,0,1,1,2,50.0,1,6,1,5,1,5,1
1535,Stanislav Lobotka,sk,MF,,Napoli,Serie A,26,1994,18.7,39,24,16,20,3,14,36,38.9,22,9,1,8,12,51,13
1536,Jürgen Locadia,cw,MF,FW,Brighton,Premier League,27,1993,0.3,0,0,0,0,0,0,0,,0,0,0,0,0,0,0
1537,Jürgen Locadia,cw,FW,MF,Bochum,Bundesliga,27,1993,4.9,4,2,1,0,3,1,1,100.0,0,1,0,1,1,5,2
1538,Manuel Locatelli,it,MF,,Juventus,Serie A,23,1998,24.0,44,25,21,16,7,21,47,44.7,26,43,21,22,22,66,33
1539,Bradley Locko,fr,MF,DF,Reims,Ligue 1,19,2002,11.2,28,19,13,11,4,14,24,58.3,10,20,8,12,14,42,15
1540,Renan Lodi,br,DF,,Atlético Madrid,La Liga,23,1998,13.1,31,18,14,13,4,11,27,40.7,16,22,4,18,13,44,19
1541,Ruben Loftus-Cheek,eng,MF,DF,Chelsea,Premier League,25,1996,15.5,29,10,16,11,2,10,19,52.6,9,15,6,9,11,40,17
1542,Kevin Long,ie,DF,,Burnley,Premier League,30,1990,4.6,3,2,1,2,0,1,2,50.0,1,4,1,3,1,4,20
1543,Shane Long,ie,FW,,Southampton,Premier League,34,1987,3.4,9,5,2,4,3,1,1,100.0,0,4,0,4,0,9,2
1544,Sean Longstaff,eng,MF,,Newcastle Utd,Premier League,23,1997,16.3,54,34,18,31,5,24,65,36.9,41,18,6,12,9,63,18
1545,Ademola Lookman,ng,FW,MF,Leicester City,Premier League,23,1997,16.1,32,14,10,13,9,10,28,35.7,18,19,1,18,10,42,4
1546,Anthony Lopes,pt,GK,,Lyon,Ligue 1,30,1990,33.1,0,0,0,0,0,0,0,,0,0,0,0,3,3,12
1547,David López,es,MF,DF,Espanyol,La Liga,31,1989,8.3,18,13,9,8,1,9,16,56.3,7,10,8,2,10,28,25
1548,Diego López,es,GK,,Espanyol,La Liga,39,1981,35.3,0,0,0,0,0,0,2,0.0,2,0,0,0,1,1,21
1549,Javi López,es,DF,,Alavés,La Liga,19,2002,5.1,8,6,6,2,0,4,6,66.7,2,7,1,6,4,12,15
1550,Maxime Lopez,fr,MF,,Sassuolo,Serie A,23,1997,32.6,69,36,40,27,2,35,87,40.2,52,33,7,26,42,111,38
1551,Pau López,es,GK,,Marseille,Ligue 1,26,1994,29.0,0,0,0,0,0,0,1,0.0,1,0,0,0,0,0,12
1552,Unai López,es,MF,,Rayo Vallecano,La Liga,25,1995,12.9,19,9,6,10,3,10,33,30.3,23,7,0,7,10,29,8
1553,Dion Lopy,sn,MF,,Reims,Ligue 1,19,2002,18.2,53,29,22,24,7,21,53,39.6,32,20,4,16,22,75,17
1554,Samuel Loric,fr,DF,,Lorient,Ligue 1,21,2000,3.0,7,5,2,3,2,5,8,62.5,3,2,0,2,5,12,9
1555,Anthony Losilla,fr,MF,,Bochum,Bundesliga,35,1986,32.6,65,39,29,30,6,34,69,49.3,35,32,9,23,70,135,53
1556,Jonas Lössl,dk,GK,,Brentford,Premier League,32,1989,2.0,0,0,0,0,0,0,0,,0,0,0,0,0,0,1
1557,Marcel Lotka,pl,GK,,Hertha BSC,Bundesliga,20,2001,9.8,1,0,1,0,0,1,1,100.0,0,0,0,0,1,2,3
1558,Jordan Lotomba,ch,DF,,Nice,Ligue 1,22,1998,19.8,33,17,21,9,3,16,30,53.3,14,17,4,13,12,45,28
1559,Johaneko Louisjean,fr,DF,,Bordeaux,Ligue 1,17,2004,0.1,0,0,0,0,0,0,0,,0,0,0,0,0,0,0
1560,Mamadou Loum,sn,MF,,Alavés,La Liga,24,1996,25.7,49,22,26,22,1,17,45,37.8,28,30,11,19,37,86,68
1561,Imran Louza,ma,MF,,Watford,Premier League,22,1999,15.7,41,21,18,20,3,16,38,42.1,22,28,6,22,42,83,20
1562,Matteo Lovato,it,DF,,Atalanta,Serie A,21,2000,3.4,5,4,4,1,0,0,1,0.0,1,4,2,2,7,12,8
1563,Matteo Lovato,it,DF,,Cagliari,Serie A,21,2000,13.8,23,15,13,10,0,8,20,40.0,12,21,10,11,28,51,43
1564,Eduard Löwen,de,MF,,Bochum,Bundesliga,24,1997,15.7,28,22,12,11,5,10,43,23.3,33,17,2,15,9,37,15
1565,Matthew Lowton,eng,DF,,Burnley,Premier League,32,1989,19.7,38,24,20,10,8,20,37,54.1,17,25,11,14,26,64,68
1566,Anthony Lozano,hn,FW,MF,Cádiz,La Liga,28,1993,18.6,8,4,2,3,3,5,18,27.8,13,16,2,14,2,10,7
1567,Hirving Lozano,mx,FW,,Napoli,Serie A,26,1995,17.9,28,20,12,11,5,8,30,26.7,22,24,0,24,9,37,9
1568,Jean Lucas,br,MF,,Monaco,Ligue 1,23,1998,16.1,43,25,14,24,5,17,40,42.5,23,15,5,10,13,56,4
1569,Anderson Lucoqui,ao,DF,,Mainz 05,Bundesliga,24,1997,8.3,22,10,11,6,5,11,22,50.0,11,15,3,12,11,33,10
1570,Florentino Luís,pt,MF,,Getafe,La Liga,21,1999,11.0,42,25,22,17,3,17,35,48.6,18,21,2,19,21,63,11
1571,José Luis Gayà,es,DF,,Valencia,La Liga,26,1995,20.8,35,21,24,10,1,16,34,47.1,18,17,3,14,19,54,37
1572,José Luis Morales,es,FW,MF,Levante,La Liga,34,1987,30.2,27,17,6,9,12,12,42,28.6,30,29,0,29,4,31,7
1573,José Luis Palomino,ar,DF,,Atalanta,Serie A,31,1990,29.7,78,40,42,33,3,32,50,64.0,18,43,21,22,100,178,80
1574,Luismi,es,FW,MF,Sevilla,La Liga,20,2001,0.1,0,0,0,0,0,0,0,,0,0,0,0,0,0,0
1575,Douglas Luiz,br,MF,,Aston Villa,Premier League,23,1998,30.2,59,39,30,24,5,21,72,29.2,51,30,7,23,34,93,28
1576,Romelu Lukaku,be,FW,,Chelsea,Premier League,28,1993,17.7,2,1,0,1,1,1,5,20.0,4,11,1,10,0,2,20
1577,Castello Lukeba,fr,DF,,Lyon,Ligue 1,18,2002,23.3,34,19,27,7,0,15,23,65.2,8,18,9,9,38,72,64
1578,Dodi Lukebakio,be,FW,,Hertha BSC,Bundesliga,23,1997,2.0,2,1,2,0,0,1,3,33.3,2,2,0,2,2,4,0
1579,Dodi Lukebakio,be,FW,MF,Wolfsburg,Bundesliga,23,1997,9.8,7,4,3,2,2,1,10,10.0,9,5,0,5,13,20,4
1580,Saša Lukić,rs,MF,,Torino,Serie A,24,1996,33.1,51,34,17,27,7,19,43,44.2,24,34,6,28,24,75,41
1581,Levi Lumeka,eng,DF,FW,Troyes,Ligue 1,22,1998,0.7,0,0,0,0,0,0,2,0.0,2,0,0,0,0,0,2
1582,Andriy Lunin,ua,GK,,Real Madrid,La Liga,22,1999,2.0,0,0,0,0,0,0,0,,0,0,0,0,0,0,2
1583,Andrey Lunyov,ru,GK,,Leverkusen,Bundesliga,29,1991,1.0,0,0,0,0,0,0,0,,0,0,0,0,0,0,0
1584,Sebastiano Luperto,it,DF,,Empoli,Serie A,24,1996,21.8,29,17,17,10,2,10,20,50.0,10,32,26,6,45,74,132
1585,Andreas Luthe,de,GK,,Union Berlin,Bundesliga,34,1987,27.0,0,0,0,0,0,0,1,0.0,1,0,0,0,0,0,11
1586,Lyanco,br,DF,,Southampton,Premier League,24,1997,10.1,18,15,11,7,0,10,18,55.6,8,18,13,5,13,31,50
1587,Charalambos Lykogiannis,gr,DF,FW,Cagliari,Serie A,27,1993,20.2,19,12,16,1,2,11,20,55.0,9,18,8,10,31,50,73
1588,Yannis M'Bemba,ga,DF,FW,Nantes,Ligue 1,20,2001,0.1,0,0,0,0,0,0,0,,0,0,0,0,0,0,1
1589,Alexis Mac Allister,ar,MF,FW,Brighton,Premier League,22,1998,23.6,65,40,23,30,12,29,68,42.6,39,37,7,30,13,78,22
1590,Deiver Machado,co,DF,MF,Lens,Ligue 1,27,1993,5.8,16,14,11,1,4,12,14,85.7,2,9,1,8,3,19,12
1591,Darwin Machís,ve,MF,FW,Granada,La Liga,28,1993,15.3,23,13,11,8,4,9,23,39.1,14,10,0,10,15,38,17
1592,Yvann Macon,fr,DF,,Saint-Étienne,Ligue 1,22,1998,17.0,41,22,24,14,3,16,42,38.1,26,18,4,14,18,59,27
1593,James Maddison,eng,MF,FW,Leicester City,Premier League,24,1996,27.3,40,20,8,24,8,14,46,30.4,32,18,3,15,11,51,12
1594,Niki Mäenpää,fi,GK,,Venezia,Serie A,36,1985,16.5,0,0,0,0,0,0,0,,0,0,0,0,0,0,8
1595,Pablo Maffeo,es,DF,,Mallorca,La Liga,24,1997,32.7,84,47,48,28,8,38,69,55.1,31,30,13,17,46,130,74
1596,Louis Mafouta,cf,FW,,Metz,Ligue 1,27,1994,5.8,0,0,0,0,0,0,5,0.0,5,1,0,1,0,0,4
1597,Gabriel Magalhães,br,DF,,Arsenal,Premier League,23,1997,34.0,50,30,36,12,2,30,41,73.2,11,34,26,8,13,63,112
1598,Giulio Maggiore,it,MF,,Spezia,Serie A,23,1998,31.3,58,32,20,32,6,31,77,40.3,46,30,5,25,29,87,33
1599,Matej Maglica,hr,MF,,Stuttgart,Bundesliga,22,1998,0.1,0,0,0,0,0,0,1,0.0,1,0,0,0,0,0,0
1600,Francesco Magnanelli,it,MF,,Sassuolo,Serie A,36,1984,3.0,5,4,4,1,0,1,9,11.1,8,3,1,2,1,6,3
1601,Giangiacomo Magnani,it,DF,,Hellas Verona,Serie A,25,1995,5.9,10,7,5,5,0,8,16,50.0,8,5,3,2,10,20,46
1602,Giangiacomo Magnani,it,DF,,Sampdoria,Serie A,25,1995,2.7,4,2,4,0,0,1,1,100.0,0,2,2,0,7,11,12
1603,Hugo Magnetti,fr,MF,,Brest,Ligue 1,23,1998,16.3,50,34,27,20,3,22,50,44.0,28,14,3,11,25,75,13
1604,Yohann Magnin,fr,MF,DF,Clermont Foot,Ligue 1,24,1997,19.1,53,31,22,26,5,24,42,57.1,18,17,7,10,20,73,36
1605,Harry Maguire,eng,DF,,Manchester Utd,Premier League,28,1993,27.9,34,21,22,8,4,19,31,61.3,12,36,29,7,32,66,101
1606,Riyad Mahrez,dz,FW,,Manchester City,Premier League,30,1991,16.6,11,3,5,4,2,5,19,26.3,14,15,1,14,6,17,6
1607,Arne Maier,de,MF,,Augsburg,Bundesliga,22,1999,20.7,20,13,6,10,4,8,26,30.8,18,18,1,17,15,35,13
1608,Habib Maïga,ci,MF,,Metz,Ligue 1,25,1996,14.1,47,28,29,13,5,24,48,50.0,24,20,7,13,14,61,18
1609,Mike Maignan,fr,GK,,Milan,Serie A,26,1995,32.0,2,1,2,0,0,2,2,100.0,0,0,0,0,1,3,4
1610,Ainsley Maitland-Niles,eng,MF,,Arsenal,Premier League,23,1997,3.0,8,4,5,3,0,2,4,50.0,2,2,0,2,4,12,4
1611,Ainsley Maitland-Niles,eng,DF,,Roma,Serie A,23,1997,5.4,8,6,5,0,3,5,14,35.7,9,7,0,7,6,14,7
1612,Josh Maja,ng,FW,,Bordeaux,Ligue 1,22,1998,0.1,0,0,0,0,0,0,0,,0,1,0,1,0,0,0
1613,Abdul Majeed Waris,gh,FW,MF,Strasbourg,Ligue 1,29,1991,3.6,5,3,2,3,0,5,10,50.0,5,2,0,2,0,5,1
1614,Lovro Majer,hr,MF,FW,Rennes,Ligue 1,23,1998,20.4,32,21,9,14,9,11,42,26.2,31,26,2,24,11,43,9
1615,Jean-Victor Makengo,fr,MF,,Udinese,Serie A,23,1998,26.1,30,21,7,17,6,15,29,51.7,14,26,6,20,19,49,17
1616,Béni Makouana,cg,FW,MF,Montpellier,Ligue 1,18,2002,3.6,2,2,0,0,2,0,1,0.0,1,1,0,1,3,5,2
1617,Nemanja Maksimović,rs,MF,,Getafe,La Liga,26,1995,32.6,56,32,24,26,6,18,49,36.7,31,42,13,29,71,127,41
1618,Nikola Maksimović,rs,DF,,Genoa,Serie A,29,1991,12.4,14,6,10,4,0,7,9,77.8,2,17,11,6,12,26,61
1619,Kévin Malcuit,ma,DF,MF,Napoli,Serie A,30,1991,3.2,4,2,4,0,0,2,2,100.0,0,3,0,3,8,12,6
1620,Daniel Maldini,it,MF,,Milan,Serie A,19,2001,1.6,8,3,4,3,1,2,6,33.3,4,4,0,4,1,9,0
1621,Youssef Maleh,ma,MF,,Fiorentina,Serie A,22,1998,11.3,27,16,8,13,6,12,25,48.0,13,14,1,13,6,33,2
1622,Donyell Malen,nl,FW,,Dortmund,Bundesliga,22,1999,18.7,13,10,4,5,4,7,13,53.8,6,10,0,10,10,23,11
1623,Ruslan Malinovskyi,ua,MF,FW,Atalanta,Serie A,28,1993,17.7,18,10,3,10,5,5,19,26.3,14,27,3,24,5,23,1
1624,Hugo Mallo,es,DF,,Celta Vigo,La Liga,30,1991,20.3,45,25,24,19,2,16,31,51.6,15,23,9,14,20,65,53
1625,Lennard Maloney,us,DF,,Dortmund,Bundesliga,21,1999,0.1,1,0,1,0,0,1,1,100.0,0,0,0,0,0,1,0
1626,Mickael Malsa,mq,MF,,Levante,La Liga,25,1995,12.7,37,17,16,18,3,15,42,35.7,27,20,8,12,18,55,15
1627,Giorgi Mamardashvili,ge,GK,,Valencia,La Liga,20,2000,18.0,0,0,0,0,0,0,0,,0,0,0,0,0,0,6
1628,Rey Manaj,al,FW,,Spezia,Serie A,24,1997,19.6,19,12,3,11,5,6,26,23.1,20,16,0,16,4,23,13
1629,Hianga Mananga Mbock,fr,MF,,Brest,Ligue 1,21,1999,8.9,18,12,8,7,3,9,21,42.9,12,5,2,3,5,23,6
1630,Vincent Manceau,fr,DF,,Angers,Ligue 1,32,1989,26.2,32,19,18,13,1,14,37,37.8,23,23,6,17,32,64,72
1631,Gianluca Mancini,it,DF,,Roma,Serie A,25,1996,32.0,41,25,22,18,1,18,33,54.5,15,38,19,19,39,80,69
1632,Leonardo Mancuso,it,FW,,Empoli,Serie A,29,1992,4.7,1,1,0,1,0,0,6,0.0,6,2,0,2,1,2,2
1633,Steve Mandanda,fr,GK,,Marseille,Ligue 1,36,1985,9.0,0,0,0,0,0,0,1,0.0,1,1,0,1,1,1,4
1634,Reinildo Mandava,mz,DF,,Atlético Madrid,La Liga,27,1994,14.4,45,25,30,14,1,22,30,73.3,8,18,9,9,21,66,38
1635,Reinildo Mandava,mz,DF,,Lille,Ligue 1,27,1994,16.9,43,23,29,11,3,32,51,62.7,19,13,4,9,37,80,55
1636,Aïssa Mandi,dz,DF,,Villarreal,La Liga,29,1991,15.3,11,5,2,8,1,3,6,50.0,3,17,14,3,13,24,49
1637,Rolando Mandragora,it,MF,,Torino,Serie A,24,1997,14.7,21,10,3,16,2,12,21,57.1,9,18,4,14,10,31,13
1638,Anthony Mandrea,dz,GK,,Angers,Ligue 1,24,1996,10.0,0,0,0,0,0,0,0,,0,0,0,0,0,0,9
1639,Sadio Mané,sn,FW,,Liverpool,Premier League,29,1992,31.3,33,20,7,14,12,8,26,30.8,18,30,1,29,8,41,15
1640,Eliaquim Mangala,fr,DF,,Saint-Étienne,Ligue 1,30,1991,13.1,17,12,12,5,0,8,12,66.7,4,11,8,3,17,34,61
1641,Orel Mangala,be,MF,,Stuttgart,Bundesliga,23,1998,20.6,17,10,5,7,5,11,22,50.0,11,11,4,7,12,29,19
1642,Thomas Mangani,fr,MF,,Angers,Ligue 1,34,1987,24.4,58,30,23,34,1,31,68,45.6,37,38,11,27,36,94,29
1643,Ricardo Mangas,pt,DF,,Bordeaux,Ligue 1,23,1998,26.1,35,22,22,8,5,26,41,63.4,15,18,4,14,25,60,47
1644,Kostas Manolas,gr,DF,,Napoli,Serie A,30,1991,3.5,2,2,1,1,0,2,3,66.7,1,2,1,1,4,6,10
1645,Javier Manquillo,es,DF,,Newcastle Utd,Premier League,27,1994,14.0,39,29,28,10,1,21,36,58.3,15,15,6,9,10,49,32
1646,Myziane Maolida,km,MF,,Nice,Ligue 1,22,1999,0.4,1,0,0,1,0,0,0,,0,1,0,1,0,1,0
1647,Myziane Maolida,km,FW,MF,Hertha BSC,Bundesliga,22,1999,8.6,7,4,5,1,1,3,9,33.3,6,5,0,5,1,8,6
1648,Sekou Mara,fr,FW,MF,Bordeaux,Ligue 1,19,2002,10.1,8,4,1,1,6,1,8,12.5,7,7,0,7,2,10,6
1649,Nikola Maraš,rs,DF,,Rayo Vallecano,La Liga,25,1995,11.6,13,9,12,1,0,9,15,60.0,6,17,13,4,15,28,51
1650,Fernando Marçal,br,MF,DF,Wolves,Premier League,32,1989,16.1,42,22,27,14,1,21,37,56.8,16,25,4,21,28,70,52
1651,Marcelo,br,DF,,Real Madrid,La Liga,33,1988,5.8,8,4,2,3,3,5,10,50.0,5,7,2,5,1,9,11
1652,Marcelo,br,DF,,Bordeaux,Ligue 1,34,1987,10.0,9,5,7,2,0,4,6,66.7,2,4,3,1,13,22,46
1653,Marcelo,br,DF,,Lyon,Ligue 1,34,1987,2.0,4,3,0,4,0,4,6,66.7,2,3,2,1,4,8,10
1654,Solly March,eng,DF,FW,Brighton,Premier League,27,1994,19.4,30,17,11,9,10,7,22,31.8,15,22,3,19,17,47,25
1655,Riccardo Marchizza,it,DF,,Empoli,Serie A,23,1998,15.0,21,15,11,8,2,11,16,68.8,5,15,6,9,10,31,24
1656,Gian Marco Ferrari,it,DF,,Sassuolo,Serie A,29,1992,34.7,16,11,10,6,0,10,23,43.5,13,37,27,10,43,59,114
1657,Iván Marcone,ar,MF,,Elche,La Liga,31,1990,9.0,24,14,17,6,1,12,24,50.0,12,8,3,5,12,36,13
1658,Óscar de Marcos,es,DF,,Athletic Club,La Liga,32,1989,18.7,50,37,24,19,7,28,43,65.1,15,20,3,17,19,69,27
1659,Davide Marfella,it,GK,,Napoli,Serie A,21,1999,0.1,0,0,0,0,0,0,0,,0,0,0,0,0,0,0
1660,José Mari,es,MF,,Cádiz,La Liga,33,1987,4.3,14,7,3,10,1,7,8,87.5,1,4,1,3,7,21,2
1661,Pablo Marí,es,DF,,Arsenal,Premier League,27,1993,2.0,5,3,1,3,1,3,6,50.0,3,5,4,1,3,8,10
1662,Pablo Marí,es,DF,,Udinese,Serie A,27,1993,14.9,16,8,8,6,2,8,16,50.0,8,18,12,6,21,37,72
1663,José María Giménez,uy,DF,,Atlético Madrid,La Liga,26,1995,22.7,18,12,12,6,0,8,16,50.0,8,25,19,6,25,43,96
1664,Mariano,do,FW,,Real Madrid,La Liga,27,1993,3.8,2,0,2,0,0,0,0,,0,2,0,2,1,3,3
1665,Răzvan Marin,ro,MF,,Cagliari,Serie A,25,1996,31.3,42,21,16,22,4,24,54,44.4,30,23,5,18,10,52,17
1666,Guillermo Maripán,cl,DF,,Monaco,Ligue 1,27,1994,20.4,36,24,27,9,0,20,40,50.0,20,21,14,7,25,61,66
1667,Mika Màrmol,es,DF,,Barcelona,La Liga,19,2002,0.0,0,0,0,0,0,0,0,,0,0,0,0,0,0,0
1668,Omar Marmoush,eg,FW,,Wolfsburg,Bundesliga,22,1999,0.3,0,0,0,0,0,0,0,,0,0,0,0,0,0,0
1669,Omar Marmoush,eg,FW,,Stuttgart,Bundesliga,22,1999,17.5,26,17,6,14,6,4,20,20.0,16,9,1,8,7,33,6
1670,Marquinhos,br,DF,,Paris S-G,Ligue 1,27,1994,31.8,37,14,25,11,1,20,35,57.1,15,35,19,16,16,53,102
1671,Roger Martí,es,FW,,Levante,La Liga,30,1991,23.5,23,14,3,13,7,8,30,26.7,22,14,0,14,2,25,8
1672,Anthony Martial,fr,FW,,Manchester Utd,Premier League,25,1995,2.4,0,0,0,0,0,0,1,0.0,1,1,0,1,0,0,1
1673,Anthony Martial,fr,FW,MF,Sevilla,La Liga,25,1995,5.4,2,1,0,0,2,2,6,33.3,4,4,0,4,0,2,3
1674,Martín,es,MF,,Cádiz,La Liga,22,1999,1.3,2,2,0,2,0,0,0,,0,1,0,1,1,3,3
1675,Aarón Martín,es,DF,,Mainz 05,Bundesliga,24,1997,25.5,54,33,32,18,4,24,55,43.6,31,24,4,20,20,74,35
1676,Ander Martin,es,FW,MF,Real Sociedad,La Liga,20,2000,1.0,1,0,0,1,0,1,1,100.0,0,0,0,0,3,4,1
1677,Andrés Martín,es,FW,MF,Rayo Vallecano,La Liga,22,1999,2.1,0,0,0,0,0,0,1,0.0,1,1,0,1,0,0,0
1678,Carlos Martín,es,DF,,Atlético Madrid,La Liga,19,2002,0.1,0,0,0,0,0,0,0,,0,0,0,0,0,0,1
1679,Iván Martín,es,MF,FW,Alavés,La Liga,22,1999,1.8,1,1,1,0,0,0,1,0.0,1,2,0,2,1,2,1
1680,Jonas Martin,fr,MF,,Rennes,Ligue 1,31,1990,23.4,35,20,12,21,2,19,53,35.8,34,17,3,14,22,57,28
1681,Gabriel Martinelli,br,FW,MF,Arsenal,Premier League,20,2001,20.7,27,19,7,14,6,10,29,34.5,19,26,1,25,20,47,15
1682,Emiliano Martínez,ar,GK,,Aston Villa,Premier League,28,1992,36.0,1,1,1,0,0,1,3,33.3,2,0,0,0,0,1,6
1683,Iñigo Martínez,es,DF,,Athletic Club,La Liga,30,1991,26.0,28,13,18,7,3,14,23,60.9,9,22,10,12,39,67,143
1684,Javi Martínez,es,MF,FW,Osasuna,La Liga,21,1999,9.8,21,14,8,11,2,10,29,34.5,19,6,0,6,9,30,10
1685,Josep Martinez,es,GK,,RB Leipzig,Bundesliga,23,1998,1.0,0,0,0,0,0,0,0,,0,0,0,0,0,0,0
1686,Lautaro Martínez,ar,FW,,Inter,Serie A,23,1997,25.4,20,10,3,10,7,6,11,54.5,5,21,1,20,18,38,6
1687,Pablo Martínez,es,MF,,Levante,La Liga,23,1998,7.3,15,8,7,8,0,4,13,30.8,9,6,3,3,15,30,5
1688,Lucas Martínez Quarta,ar,DF,,Fiorentina,Serie A,25,1996,15.9,36,25,23,11,2,21,34,61.8,13,22,9,13,19,55,46
1689,Gelson Martins,pt,MF,FW,Monaco,Ligue 1,26,1995,21.2,42,27,10,26,6,21,59,35.6,38,26,1,25,17,59,4
1690,Adam Marušić,me,DF,,Lazio,Serie A,28,1992,30.2,30,18,16,12,2,13,32,40.6,19,19,8,11,41,71,71
1691,Omar Mascarell,gq,MF,,Elche,La Liga,28,1993,27.7,46,26,16,23,7,24,60,40.0,36,42,14,28,48,94,52
1692,Andrea Masiello,it,DF,,Genoa,Serie A,35,1986,5.7,5,3,4,1,0,4,7,57.1,3,8,4,4,11,16,20
1693,Adam Masina,ma,DF,,Watford,Premier League,27,1994,12.0,24,13,11,10,3,12,29,41.4,17,18,6,12,18,42,45
1694,Erhan Mašović,rs,DF,,Bochum,Bundesliga,22,1998,17.2,35,20,21,13,1,21,33,63.6,12,28,19,9,34,69,64
1695,Roberto Massimo,de,DF,FW,Stuttgart,Bundesliga,20,2000,9.7,14,5,6,7,1,4,16,25.0,12,9,0,9,3,17,6
1696,Arthur Masuaku,cd,DF,FW,West Ham,Premier League,27,1993,7.2,31,23,19,11,1,14,23,60.9,9,9,1,8,9,40,17
1697,Jaime Mata,es,FW,,Getafe,La Liga,32,1988,7.5,7,5,3,1,3,1,9,11.1,8,4,1,3,1,8,5
1698,Juan Mata,es,MF,,Manchester Utd,Premier League,33,1988,2.6,6,4,2,3,1,3,5,60.0,2,1,0,1,1,7,1
1699,Pape Matar Sarr,sn,MF,,Metz,Ligue 1,18,2002,23.7,45,26,21,23,1,18,39,46.2,21,33,3,30,29,74,22
1700,Eliot Matazo,be,MF,,Monaco,Ligue 1,19,2002,8.8,8,7,4,4,0,2,11,18.2,9,11,3,8,13,21,9
1701,Aleš Matějů,cz,DF,,Venezia,Serie A,25,1996,8.1,16,12,10,5,1,13,29,44.8,16,10,6,4,9,25,15
1702,Jean-Philippe Mateta,fr,FW,,Crystal Palace,Premier League,24,1997,12.7,8,4,2,5,1,3,18,16.7,15,11,3,8,4,12,13
1703,Nemanja Matić,rs,MF,,Manchester Utd,Premier League,32,1988,15.4,31,18,19,11,1,15,31,48.4,16,21,6,15,31,62,21
1704,Joël Matip,cm,DF,,Liverpool,Premier League,29,1991,31.0,47,34,23,19,5,20,31,64.5,11,26,14,12,44,91,93
1705,Chrislain Matsima,fr,DF,,Monaco,Ligue 1,19,2002,1.5,3,2,1,2,0,2,7,28.6,5,3,3,0,1,4,6
1706,Azor Matusiwa,nl,MF,,Reims,Ligue 1,23,1998,27.4,58,32,28,26,4,26,55,47.3,29,49,19,30,62,120,43
1707,Neal Maupay,fr,FW,,Brighton,Premier League,24,1996,25.3,17,10,2,6,9,4,18,22.2,14,21,2,19,2,19,2
1708,Stephy Mavididi,eng,FW,MF,Montpellier,Ligue 1,23,1998,25.5,24,13,11,7,6,14,39,35.9,25,23,2,21,8,32,11
1709,Konstantinos Mavropanos,gr,DF,,Stuttgart,Bundesliga,23,1997,30.1,57,39,35,21,1,30,51,58.8,21,46,23,23,69,126,174
1710,Eric Maxim Choupo-Moting,cm,FW,MF,Bayern Munich,Bundesliga,32,1989,4.2,10,9,3,6,1,3,10,30.0,7,1,0,1,5,15,2
1711,Luís Maximiano,pt,GK,,Granada,La Liga,22,1999,34.8,3,1,3,0,0,3,6,50.0,3,0,0,0,1,4,16
1712,Borja Mayoral,es,FW,DF,Roma,Serie A,24,1997,1.1,0,0,0,0,0,0,0,,0,0,0,0,0,0,0
1713,Borja Mayoral,es,FW,,Getafe,La Liga,24,1997,11.6,7,5,2,3,2,1,2,50.0,1,10,4,6,4,11,3
1714,Derek Mazou-Sacko,fr,FW,DF,Troyes,Ligue 1,16,2004,0.0,1,0,0,0,1,1,1,100.0,0,0,0,0,0,1,1
1715,Pasquale Mazzocchi,it,DF,,Venezia,Serie A,26,1995,13.8,18,8,11,4,3,10,26,38.5,16,11,8,3,21,39,31
1716,Pasquale Mazzocchi,it,DF,,Salernitana,Serie A,26,1995,14.1,28,19,15,11,2,14,34,41.2,20,5,0,5,11,39,31
1717,Kevin Mbabu,ch,DF,,Wolfsburg,Bundesliga,26,1995,15.5,31,20,21,5,5,12,23,52.2,11,25,8,17,35,66,35
1718,Kylian Mbappé,fr,FW,,Paris S-G,Ligue 1,22,1998,33.6,11,8,1,4,6,7,13,53.8,6,6,0,6,5,16,13
1719,Ibrahima Mbaye,sn,DF,,Bologna,Serie A,26,1994,1.2,1,1,1,0,0,1,2,50.0,1,1,1,0,1,2,6
1720,Amadou Mbengue,sn,DF,MF,Metz,Ligue 1,19,2002,6.8,19,10,10,9,0,11,22,50.0,11,7,2,5,10,29,19
1721,Bryan Mbeumo,cm,FW,,Brentford,Premier League,21,1999,32.3,28,16,1,12,15,6,20,30.0,14,21,6,15,11,39,20
1722,Jason Mbock,fr,FW,,Angers,Ligue 1,21,1999,0.2,0,0,0,0,0,0,0,,0,0,0,0,0,0,0
1723,Jordi Mboula,es,FW,,Mallorca,La Liga,22,1999,4.8,8,2,3,3,2,5,9,55.6,4,7,1,6,3,11,3
1724,Moustapha Mbow,sn,DF,,Reims,Ligue 1,21,2000,1.0,6,6,3,2,1,3,3,100.0,0,0,0,0,1,7,6
1725,Nathanael Mbuku,cd,FW,MF,Reims,Ligue 1,19,2002,15.8,14,13,4,7,3,2,8,25.0,6,14,0,14,11,25,4
1726,James McArthur,sct,MF,,Crystal Palace,Premier League,33,1987,16.0,33,23,13,19,1,16,44,36.4,28,23,9,14,30,63,27
1727,James Mcatee,eng,MF,FW,Manchester City,Premier League,18,2002,0.2,0,0,0,0,0,0,2,0.0,2,0,0,0,0,0,0
1728,Kasey McAteer,ie,FW,,Leicester City,Premier League,19,2001,0.0,0,0,0,0,0,0,0,,0,0,0,0,0,0,0
1729,Liam McCarron,sct,FW,,Leeds United,Premier League,20,2001,0.1,0,0,0,0,0,0,0,,0,1,0,1,0,0,0
1730,Alex McCarthy,eng,GK,,Southampton,Premier League,31,1989,17.0,0,0,0,0,0,0,0,,0,0,0,0,0,0,4
1731,John McGinn,sct,MF,,Aston Villa,Premier League,26,1994,34.3,106,64,35,55,16,54,104,51.9,50,53,6,47,35,141,34
1732,Weston McKennie,us,MF,,Juventus,Serie A,22,1998,15.2,20,11,11,7,2,8,26,30.8,18,17,8,9,23,43,20
1733,Stuart McKinstry,sct,MF,,Leeds United,Premier League,18,2002,0.0,0,0,0,0,0,0,0,,0,0,0,0,0,0,0
1734,Kenny McLean,sct,MF,,Norwich City,Premier League,29,1992,30.1,42,22,18,20,4,17,59,28.8,42,29,7,22,34,76,54
1735,Dwight McNeil,eng,MF,,Burnley,Premier League,21,1999,34.5,78,49,27,38,13,33,73,45.2,40,64,11,53,35,113,31
1736,Scott McTominay,sct,MF,,Manchester Utd,Premier League,24,1996,26.5,65,33,32,24,9,30,61,49.2,31,45,10,35,31,96,60
1737,Gary Medel,cl,DF,,Bologna,Serie A,33,1987,31.4,39,23,27,11,1,16,36,44.4,20,30,21,9,44,83,112
1738,Facundo Medina,ar,DF,,Lens,Ligue 1,22,1999,28.8,61,42,34,23,4,38,62,61.3,24,24,8,16,37,98,78
1739,Nathan de Medina,be,DF,,Arminia,Bundesliga,23,1997,8.6,17,10,11,6,0,6,10,60.0,4,14,3,11,10,27,28
1740,Ben Mee,eng,DF,,Burnley,Premier League,31,1989,20.4,26,12,16,7,3,12,19,63.2,7,28,22,6,24,50,94
1741,Admir Mehmedi,ch,DF,,Wolfsburg,Bundesliga,30,1991,0.0,0,0,0,0,0,0,0,,0,0,0,0,0,0,0
1742,Hannibal Mejbri,tn,FW,,Manchester Utd,Premier League,18,2003,0.8,2,1,1,1,0,1,1,100.0,0,0,0,0,0,2,0
1743,Farid El Melali,dz,FW,,Angers,Ligue 1,24,1997,0.2,0,0,0,0,0,0,1,0.0,1,1,0,1,0,0,1
1744,Filippo Melegoni,it,MF,FW,Genoa,Serie A,22,1999,10.9,20,12,5,8,7,8,16,50.0,8,10,1,9,11,31,8
1745,Óscar Melendo,es,MF,FW,Espanyol,La Liga,23,1997,11.0,11,5,4,4,3,3,13,23.1,10,4,1,3,1,12,10
1746,Gonzalo Melero,es,MF,,Levante,La Liga,27,1994,18.8,29,16,10,15,4,16,36,44.4,20,21,8,13,7,36,22
1747,Birger Meling,no,DF,,Rennes,Ligue 1,26,1994,20.3,43,27,25,11,7,23,31,74.2,8,23,7,16,22,65,40
1748,Arthur Melo,br,MF,,Juventus,Serie A,24,1996,10.7,25,12,10,14,1,13,24,54.2,11,11,2,9,7,32,8
1749,Memphis,nl,FW,,Barcelona,La Liga,27,1994,20.6,10,4,2,4,4,3,13,23.1,10,9,1,8,3,13,4
1750,Houboulang Mendes,gw,DF,,Lorient,Ligue 1,23,1998,35.8,58,28,37,18,3,40,57,70.2,17,41,21,20,41,99,128
1751,Nuno Mendes,pt,DF,,Paris S-G,Ligue 1,19,2002,18.4,48,29,23,18,7,25,47,53.2,22,27,5,22,21,69,17
1752,Pedro Mendes,pt,DF,,Montpellier,Ligue 1,30,1990,0.2,1,1,1,0,0,0,0,,0,1,1,0,0,1,2
1753,Thiago Mendes,br,MF,DF,Lyon,Ligue 1,29,1992,20.7,36,22,18,16,2,12,30,40.0,18,24,5,19,34,70,56
1754,Tomás Mendes,es,MF,,Alavés,La Liga,16,2004,0.1,0,0,0,0,0,0,0,,0,0,0,0,0,0,1
1755,Brais Méndez,es,MF,,Celta Vigo,La Liga,24,1997,33.6,68,35,24,35,9,26,87,29.9,61,52,6,46,37,105,30
1756,Édgar Méndez,es,FW,MF,Alavés,La Liga,31,1990,17.9,25,14,11,10,4,11,34,32.4,23,16,0,16,4,29,17
1757,Arial Mendy,sn,DF,FW,Clermont Foot,Ligue 1,26,1994,8.8,6,4,4,2,0,2,11,18.2,9,6,1,5,7,13,17
1758,Batista Mendy,fr,MF,DF,Angers,Ligue 1,21,2000,26.8,49,28,21,22,6,23,45,51.1,22,37,6,31,34,83,40
1759,Benjamin Mendy,fr,DF,,Manchester City,Premier League,27,1994,0.9,2,2,1,1,0,2,6,33.3,4,0,0,0,0,2,0
1760,Edouard Mendy,sn,GK,,Chelsea,Premier League,29,1992,34.0,1,0,1,0,0,1,3,33.3,2,0,0,0,0,1,13
1761,Ferland Mendy,fr,DF,,Real Madrid,La Liga,26,1995,19.3,24,14,11,10,3,8,14,57.1,6,8,2,6,18,42,27
1762,Nampalys Mendy,sn,MF,,Leicester City,Premier League,29,1992,11.5,12,6,8,4,0,6,17,35.3,11,7,4,3,11,23,11
1763,Gideon Mensah,gh,DF,,Bordeaux,Ligue 1,23,1998,13.4,37,24,19,12,6,18,38,47.4,20,11,2,9,16,53,21
1764,Jorge Meré,es,DF,,Köln,Bundesliga,24,1997,5.4,9,6,3,6,0,4,7,57.1,3,6,4,2,10,19,19
1765,Alex Meret,it,GK,,Napoli,Serie A,24,1997,6.9,0,0,0,0,0,0,0,,0,0,0,0,0,0,3
1766,Fran Mérida,es,MF,,Espanyol,La Liga,31,1990,3.0,7,3,5,2,0,4,10,40.0,6,1,0,1,6,13,1
1767,Mikel Merino,es,MF,,Real Sociedad,La Liga,25,1996,32.1,71,38,21,40,10,26,67,38.8,41,50,10,40,21,92,56
1768,Quentin Merlin,fr,DF,MF,Nantes,Ligue 1,19,2002,21.4,45,28,19,20,6,26,49,53.1,23,25,4,21,27,72,29
1769,Martín Merquelanz,es,FW,MF,Rayo Vallecano,La Liga,26,1995,1.9,2,1,2,0,0,2,6,33.3,4,2,0,2,0,2,1
1770,Yıldırım Mert Çetin,tr,MF,,Hellas Verona,Serie A,24,1997,0.5,1,0,1,0,0,1,1,100.0,0,0,0,0,0,1,2
1771,Dries Mertens,be,FW,MF,Napoli,Serie A,34,1987,15.4,16,7,1,11,4,3,16,18.8,13,8,2,6,9,25,2
1772,Illan Meslier,fr,GK,,Leeds United,Premier League,21,2000,37.6,1,1,1,0,0,1,1,100.0,0,0,0,0,0,1,27
1773,Lionel Messi,ar,FW,MF,Paris S-G,Ligue 1,34,1987,23.9,10,3,1,5,4,3,13,23.1,10,5,0,5,4,14,0
1774,Junior Messias,br,FW,MF,Milan,Serie A,30,1991,15.9,34,18,11,14,9,15,34,44.1,19,11,1,10,17,51,17
1775,Thomas Meunier,be,DF,,Dortmund,Bundesliga,29,1991,15.6,29,19,13,12,4,16,33,48.5,17,10,2,8,12,41,25
1776,Mexer,mz,DF,,Bordeaux,Ligue 1,32,1988,13.6,14,10,11,3,0,11,17,64.7,6,12,7,5,21,35,60
1777,Marco Meyerhöfer,de,DF,,Greuther Fürth,Bundesliga,25,1995,25.3,53,35,22,22,9,24,37,64.9,13,38,19,19,47,100,64
1778,Matt Miazga,us,DF,,Alavés,La Liga,26,1995,9.3,7,7,3,4,0,2,7,28.6,5,14,12,2,11,18,55
1779,Kingsley Michael,ng,MF,,Bologna,Serie A,21,1999,0.8,4,1,2,2,0,1,2,50.0,1,2,1,1,1,5,1
1780,Sven Michel,de,FW,,Union Berlin,Bundesliga,31,1990,3.8,10,6,5,3,2,2,8,25.0,6,3,0,3,1,11,1
1781,Edouard Michut,fr,MF,,Paris S-G,Ligue 1,18,2003,0.8,0,0,0,0,0,0,2,0.0,2,2,0,2,1,1,2
1782,Miguel,es,FW,MF,Alavés,La Liga,21,1999,9.2,7,3,1,5,1,2,15,13.3,13,6,0,6,1,8,7
1783,Valentin Mihaila,ro,MF,FW,Atalanta,Serie A,21,2000,0.8,1,1,0,1,0,0,1,0.0,1,2,0,2,0,1,0
1784,Mikael,br,FW,MF,Salernitana,Serie A,22,1999,1.0,1,1,0,1,0,0,0,,0,0,0,0,0,1,1
1785,Hilmir Mikaelsson,is,FW,,Venezia,Serie A,17,2004,0.2,2,0,0,1,1,0,0,,0,0,0,0,0,2,0
1786,Georges Mikautadze,ge,FW,,Metz,Ligue 1,20,2000,0.0,0,0,0,0,0,0,0,,0,0,0,0,0,0,0
1787,William Mikelbrencis,fr,DF,,Metz,Ligue 1,17,2004,6.8,11,5,6,4,1,6,9,66.7,3,6,3,3,5,16,9
1788,Nikola Milenković,rs,DF,,Fiorentina,Serie A,23,1997,32.5,54,32,31,20,3,29,34,85.3,5,30,15,15,39,93,94
1789,Arkadiusz Milik,pl,FW,,Marseille,Ligue 1,27,1994,15.7,9,2,0,5,4,4,18,22.2,14,9,1,8,3,12,10
1790,Sergej Milinković-Savić,rs,MF,,Lazio,Serie A,26,1995,34.4,67,44,20,32,15,29,67,43.3,38,50,9,41,34,101,43
1791,Vanja Milinković-Savić,rs,GK,,Torino,Serie A,24,1997,27.0,0,0,0,0,0,0,1,0.0,1,0,0,0,0,0,7
1792,Éder Militão,br,DF,,Real Madrid,La Liga,23,1998,33.7,50,32,30,12,8,20,39,51.3,19,42,20,22,52,102,107
1793,Luka Milivojević,rs,MF,,Crystal Palace,Premier League,30,1991,8.6,18,9,9,6,3,10,16,62.5,6,6,1,5,11,29,15
1794,Luis Milla,es,MF,,Granada,La Liga,26,1994,30.8,59,29,25,30,4,25,64,39.1,39,28,4,24,25,84,34
1795,Pere Milla,es,MF,FW,Elche,La Liga,28,1992,18.3,20,15,14,5,1,8,44,18.2,36,21,1,20,5,25,21
1796,Enzo Millot,fr,MF,,Stuttgart,Bundesliga,19,2002,0.6,2,0,0,2,0,0,1,0.0,1,0,0,0,1,3,1
1797,James Milner,eng,MF,DF,Liverpool,Premier League,35,1986,9.5,28,16,12,11,5,12,29,41.4,17,19,5,14,17,45,20
1798,Santi Mina,es,FW,,Celta Vigo,La Liga,25,1995,26.3,27,17,8,15,4,5,32,15.6,27,28,2,26,6,33,22
1799,Yerry Mina,co,DF,,Everton,Premier League,26,1994,9.4,12,10,12,0,0,10,13,76.9,3,13,9,4,11,23,38
1800,Takumi Minamino,jp,FW,MF,Liverpool,Premier League,26,1995,2.1,3,2,1,1,1,2,8,25.0,6,2,0,2,1,4,2
1801,Tyrone Mings,eng,DF,,Aston Villa,Premier League,28,1993,35.4,23,12,17,3,3,14,22,63.6,8,47,30,17,46,69,153
1802,Óscar Mingueza,es,DF,,Barcelona,La Liga,22,1999,9.9,25,11,12,11,2,16,23,69.6,7,5,0,5,9,34,22
1803,Rafa Mir,es,FW,,Sevilla,La Liga,24,1997,20.1,4,3,1,1,2,0,11,0.0,11,4,3,1,0,4,17
1804,Jorge Miramón,es,DF,,Levante,La Liga,32,1989,22.0,36,19,16,12,8,15,44,34.1,29,15,3,12,35,71,58
1805,Aleksei Miranchuk,ru,MF,FW,Atalanta,Serie A,25,1995,8.6,11,7,3,7,1,4,12,33.3,8,3,0,3,1,12,7
1806,Juan Miranda,es,DF,,Betis,La Liga,21,2000,8.7,21,11,16,4,1,12,22,54.5,10,10,4,6,15,36,22
1807,Fabio Miretti,it,MF,,Juventus,Serie A,17,2003,3.6,4,2,2,2,0,2,9,22.2,7,3,1,2,2,6,3
1808,Tyrick Mitchell,eng,DF,,Crystal Palace,Premier League,21,1999,34.5,104,57,67,26,11,46,67,68.7,21,47,5,42,41,145,101
1809,Stefan Mitrović,rs,DF,,Getafe,La Liga,31,1990,29.6,16,8,12,4,0,8,13,61.5,5,28,18,10,22,38,114
1810,Maximilian Mittelstädt,de,DF,FW,Hertha BSC,Bundesliga,24,1997,16.6,52,33,30,12,10,26,50,52.0,24,28,5,23,46,98,37
1811,Henrikh Mkhitaryan,am,MF,FW,Roma,Serie A,32,1989,27.7,45,29,11,27,7,17,52,32.7,35,33,2,31,22,67,33
1812,Jakub Moder,pl,MF,,Brighton,Premier League,22,1999,18.9,42,25,18,17,7,23,42,54.8,19,25,2,23,10,52,22
1813,Anthony Modeste,fr,FW,,Köln,Bundesliga,33,1988,29.0,10,6,4,5,1,3,18,16.7,15,11,2,9,4,14,29
1814,Marco Modolo,it,DF,,Venezia,Serie A,32,1989,4.4,6,3,4,2,0,2,5,40.0,3,6,6,0,4,10,26
1815,Luka Modrić,hr,MF,,Real Madrid,La Liga,35,1985,22.6,18,10,8,7,3,6,27,22.2,21,10,4,6,20,38,9
1816,Terem Moffi,ng,FW,,Lorient,Ligue 1,22,1999,30.1,17,10,3,12,2,9,32,28.1,23,11,2,9,4,21,22
1817,Kevin Möhwald,de,MF,,Union Berlin,Bundesliga,28,1993,3.9,7,1,3,3,1,1,7,14.3,6,3,0,3,3,10,6
1818,Dion Moise Sahi,ci,FW,MF,Strasbourg,Ligue 1,19,2001,1.4,0,0,0,0,0,0,0,,0,1,0,1,1,1,1
1819,Johan Mojica,co,DF,,Elche,La Liga,28,1992,31.7,46,25,34,7,5,23,31,74.2,8,22,3,19,25,71,61
1820,Clinton Mola,eng,DF,,Stuttgart,Bundesliga,20,2001,1.3,3,1,2,1,0,2,4,50.0,2,5,5,0,3,6,2
1821,Jorge Molina,es,FW,,Granada,La Liga,39,1982,21.8,4,2,2,1,1,2,18,11.1,16,13,2,11,6,10,11
1822,Nahuel Molina,ar,DF,,Udinese,Serie A,23,1998,29.3,41,24,17,21,3,16,48,33.3,32,24,3,21,22,63,44
1823,Cristian Molinaro,it,DF,,Venezia,Serie A,38,1983,6.1,12,9,10,2,0,5,7,71.4,2,7,2,5,6,18,20
1824,Florent Mollet,fr,FW,MF,Montpellier,Ligue 1,29,1991,29.2,31,22,14,12,5,14,57,24.6,43,27,4,23,24,55,13
1825,Jon Moncayola,es,MF,,Osasuna,La Liga,23,1998,32.4,40,20,18,18,4,17,44,38.6,27,26,9,17,20,60,43
1826,Monchu,es,MF,,Granada,La Liga,21,1999,7.4,15,6,5,9,1,5,10,50.0,5,8,3,5,4,19,4
1827,Thomas Monconduit,fr,MF,,Lorient,Ligue 1,30,1991,25.0,41,25,19,17,5,20,57,35.1,37,21,10,11,22,63,51
1828,Gonzalo Montiel,ar,DF,,Sevilla,La Liga,24,1997,11.8,15,4,8,5,2,12,24,50.0,12,8,2,6,10,25,22
1829,Lorenzo Montipò,it,GK,,Hellas Verona,Serie A,25,1996,34.0,0,0,0,0,0,0,0,,0,0,0,0,1,1,16
1830,Ángel Montoro,es,MF,,Granada,La Liga,33,1988,14.8,26,13,16,7,3,17,27,63.0,10,11,1,10,11,37,29
1831,Martín Montoya,es,DF,,Betis,La Liga,30,1991,5.8,20,12,11,7,2,15,26,57.7,11,6,0,6,11,31,20
1832,Wesley Moraes,br,FW,,Aston Villa,Premier League,24,1996,0.0,0,0,0,0,0,0,0,,0,0,0,0,0,0,0
1833,Álvaro Morata,es,FW,,Juventus,Serie A,28,1992,25.6,18,9,4,9,5,8,31,25.8,23,26,1,25,5,23,24
1834,Jan Morávek,cz,MF,,Augsburg,Bundesliga,31,1989,5.2,11,6,3,7,1,6,18,33.3,12,11,2,9,6,17,8
1835,Jon Morcillo,es,MF,FW,Athletic Club,La Liga,22,1998,0.6,3,0,1,2,0,3,4,75.0,1,1,0,1,0,3,0
1836,Jérémy Morel,mg,DF,,Lorient,Ligue 1,37,1984,6.7,13,9,8,4,1,6,6,100.0,0,9,7,2,7,20,31
1837,Alberto Moreno,es,MF,DF,Villarreal,La Liga,29,1992,13.6,13,7,5,7,1,5,18,27.8,13,13,1,12,27,40,15
1838,Álex Moreno,es,DF,,Betis,La Liga,28,1993,26.7,76,40,53,15,8,33,60,55.0,27,28,6,22,34,110,82
1839,Gerard Moreno,es,FW,,Villarreal,La Liga,29,1992,13.2,5,2,2,2,1,1,7,14.3,6,6,1,5,6,11,14
1840,Tete Morente,es,MF,,Elche,La Liga,24,1996,18.1,21,14,13,7,1,7,28,25.0,21,30,1,29,12,33,12
1841,Ilaix Moriba,gn,MF,,Valencia,La Liga,18,2003,9.1,26,18,10,13,3,14,35,40.0,21,15,0,15,12,38,14
1842,Ilaix Moriba,gn,MF,,RB Leipzig,Bundesliga,18,2003,0.4,0,0,0,0,0,0,4,0.0,4,2,0,2,1,1,0
1843,Manu Morlanes,es,MF,,Espanyol,La Liga,22,1999,12.7,36,15,16,17,3,18,43,41.9,25,24,5,19,13,49,17
1844,Raúl Moro,es,FW,,Lazio,Serie A,18,2002,2.2,3,3,0,2,1,1,5,20.0,4,2,0,2,0,3,0
1845,Loren Morón,es,FW,MF,Espanyol,La Liga,27,1993,6.3,6,4,1,3,2,0,12,0.0,12,11,1,10,2,8,9
1846,Loren Morón,es,FW,,Betis,La Liga,27,1993,0.0,1,1,1,0,0,1,1,100.0,0,0,0,0,0,1,0
1847,Tyler Morton,eng,MF,,Liverpool,Premier League,18,2002,0.7,0,0,0,0,0,0,2,0.0,2,0,0,0,3,3,0
1848,Cristhian Mosquera,es,DF,,Valencia,La Liga,17,2004,2.4,4,2,3,0,1,3,6,50.0,3,1,0,1,3,7,1
1849,Lebo Mothiba,za,FW,MF,Troyes,Ligue 1,25,1996,5.8,8,4,4,3,1,2,5,40.0,3,3,0,3,2,10,0
1850,Lebo Mothiba,za,FW,,Strasbourg,Ligue 1,25,1996,0.0,0,0,0,0,0,0,0,,0,0,0,0,0,0,0
1851,Andrei Motoc,md,DF,,Salernitana,Serie A,19,2002,1.0,1,1,0,1,0,0,0,,0,2,2,0,2,3,1
1852,Baptiste Mouazan,fr,MF,,Lorient,Ligue 1,19,2001,1.1,4,3,2,2,0,1,3,33.3,2,3,0,3,1,5,1
1853,Aimen Moueffek,fr,MF,,Saint-Étienne,Ligue 1,20,2001,4.8,7,4,2,3,2,2,8,25.0,6,3,0,3,2,9,4
1854,Youssoufa Moukoko,de,FW,MF,Dortmund,Bundesliga,16,2004,2.5,1,0,0,1,0,0,1,0.0,1,5,0,5,3,4,0
1855,Harold Moukoudi,cm,DF,,Saint-Étienne,Ligue 1,23,1997,18.5,25,12,17,8,0,14,25,56.0,11,27,14,13,35,60,48
1856,Jessy Moulin,fr,GK,,Troyes,Ligue 1,35,1986,7.0,0,0,0,0,0,0,0,,0,0,0,0,1,1,7
1857,Steve Mounié,bj,FW,,Brest,Ligue 1,26,1994,25.7,17,6,3,12,2,4,27,14.8,23,13,1,12,6,23,12
1858,Mason Mount,eng,MF,,Chelsea,Premier League,22,1999,26.3,41,16,10,17,14,10,34,29.4,24,18,1,17,13,54,12
1859,Lucas Moura,br,FW,MF,Tottenham,Premier League,28,1992,19.7,25,10,7,14,4,8,35,22.9,27,19,0,19,18,43,19
1860,Lys Mousset,fr,MF,FW,Salernitana,Serie A,25,1996,1.8,1,0,0,1,0,0,0,,0,2,0,2,0,1,0
1861,João Moutinho,pt,MF,,Wolves,Premier League,34,1986,33.0,74,39,34,27,13,30,106,28.3,76,48,8,40,34,108,36
1862,Samuel Moutoussamy,cd,MF,,Nantes,Ligue 1,24,1996,16.8,48,32,20,20,8,23,62,37.1,39,14,2,12,17,65,16
1863,Toni Moya,es,MF,,Alavés,La Liga,23,1998,15.4,23,10,7,13,3,13,43,30.2,30,18,5,13,20,43,18
1864,Samuel Mráz,sk,FW,,Spezia,Serie A,24,1997,0.6,0,0,0,0,0,0,0,,0,1,0,1,0,0,0
1865,Nordi Mukiele,fr,DF,FW,RB Leipzig,Bundesliga,23,1997,20.5,35,22,23,9,3,14,27,51.9,13,31,5,26,31,66,44
1866,Mert Müldür,tr,DF,,Sassuolo,Serie A,22,1999,22.7,52,35,43,7,2,27,49,55.1,22,25,6,19,24,76,44
1867,Florian Müller,de,GK,,Stuttgart,Bundesliga,23,1997,30.0,0,0,0,0,0,0,1,0.0,1,1,0,1,0,0,13
1868,Thomas Müller,de,MF,,Bayern Munich,Bundesliga,31,1989,28.4,35,20,7,16,12,16,54,29.6,38,32,1,31,15,50,12
1869,Bali Mumba,eng,DF,,Norwich City,Premier League,19,2001,0.5,1,1,1,0,0,0,0,,0,0,0,0,0,1,5
1870,Marshall Munetsi,zw,MF,DF,Reims,Ligue 1,25,1996,20.9,34,17,21,11,2,17,39,43.6,22,39,13,26,43,77,72
1871,Iker Muniain,es,MF,,Athletic Club,La Liga,28,1992,30.9,32,10,8,19,5,12,40,30.0,28,20,1,19,17,49,8
1872,Aihen Muñoz,es,DF,,Real Sociedad,La Liga,23,1997,14.9,28,17,14,13,1,18,29,62.1,11,11,1,10,17,45,34
1873,Luis Muriel,co,FW,MF,Atalanta,Serie A,30,1991,17.1,15,4,2,7,6,3,19,15.8,16,12,0,12,4,19,5
1874,Jeison Murillo,co,DF,,Celta Vigo,La Liga,29,1992,12.4,15,10,13,2,0,9,13,69.2,4,11,8,3,17,32,37
1875,Vedat Muriqi,xk,FW,,Lazio,Serie A,27,1994,2.4,1,0,1,0,0,0,5,0.0,5,0,0,0,0,1,2
1876,Vedat Muriqi,xk,FW,,Mallorca,La Liga,27,1994,16.0,6,3,1,3,2,1,7,14.3,6,12,0,12,6,12,29
1877,Jacob Murphy,eng,FW,DF,Newcastle Utd,Premier League,26,1995,16.4,49,26,34,11,4,26,41,63.4,15,20,2,18,23,72,17
1878,Nicola Murru,it,DF,,Sampdoria,Serie A,26,1994,10.9,22,17,10,11,1,8,13,61.5,5,17,3,14,7,29,20
1879,Yunus Musah,us,MF,FW,Valencia,La Liga,18,2002,14.0,23,13,8,8,7,6,20,30.0,14,19,1,18,14,37,11
1880,Torben Müsel,de,MF,,Gladbach,Bundesliga,22,1999,0.1,0,0,0,0,0,0,0,,0,0,0,0,0,0,0
1881,Jamal Musiala,de,MF,FW,Bayern Munich,Bundesliga,18,2003,16.3,40,26,11,16,13,15,36,41.7,21,25,0,25,19,59,2
1882,Juan Musso,ar,GK,,Atalanta,Serie A,27,1994,32.6,1,1,1,0,0,0,0,,0,0,0,0,0,1,17
1883,Shkodran Mustafi,de,DF,,Levante,La Liga,29,1992,7.3,9,6,6,3,0,5,9,55.6,4,6,3,3,15,24,40
1884,Junior Mwanga,fr,DF,,Bordeaux,Ligue 1,18,2003,1.0,5,2,4,1,0,3,3,100.0,0,1,0,1,0,5,1
1885,Enock Mwepu,zm,MF,,Brighton,Premier League,23,1998,11.1,22,12,10,10,2,5,27,18.5,22,20,2,18,12,34,19
1886,Vitaliy Mykolenko,ua,DF,,Everton,Premier League,22,1999,11.7,25,15,15,7,3,12,21,57.1,9,15,2,13,16,41,37
1887,Joakim Mæhle,dk,DF,MF,Atalanta,Serie A,24,1997,16.3,21,11,6,9,6,12,27,44.4,15,18,2,16,14,35,13
1888,Obite N'Dicka,ci,DF,,Eint Frankfurt,Bundesliga,21,1999,31.7,60,34,29,27,4,44,59,74.6,15,46,20,26,48,108,137
1889,Kévin N'Doram,fr,MF,,Metz,Ligue 1,25,1996,13.7,10,8,3,5,2,3,20,15.0,17,24,5,19,19,29,21
1890,Eric N'Jo,fr,DF,,Troyes,Ligue 1,17,2004,1.1,0,0,0,0,0,0,1,0.0,1,1,1,0,2,2,1
1891,Vital N'Simba,cd,DF,,Clermont Foot,Ligue 1,28,1993,31.0,66,45,38,23,5,36,63,57.1,27,28,7,21,29,95,30
1892,Nacho,es,DF,,Real Madrid,La Liga,31,1990,17.3,18,14,9,9,0,12,22,54.5,10,22,15,7,34,52,50
1893,Mickael Nade,fr,DF,,Saint-Étienne,Ligue 1,22,1999,28.5,57,35,37,18,2,23,38,60.5,15,29,15,14,60,117,84
1894,Marvelous Nakamba,zw,MF,,Aston Villa,Premier League,27,1994,10.0,32,19,18,14,0,12,34,35.3,22,14,4,10,12,44,17
1895,Nahitan Nández,uy,MF,DF,Cagliari,Serie A,25,1995,16.9,39,21,16,15,8,18,33,54.5,15,16,1,15,9,48,15
1896,Nani,pt,MF,FW,Venezia,Serie A,34,1986,3.2,2,1,1,1,0,0,1,0.0,1,1,0,1,2,4,0
1897,Paul Nardi,fr,GK,,Lorient,Ligue 1,27,1994,22.0,1,0,1,0,0,1,2,50.0,1,0,0,0,0,1,10
1898,Nikolas Nartey,dk,MF,DF,Stuttgart,Bundesliga,21,2000,4.5,6,3,0,5,1,3,9,33.3,6,4,2,2,7,13,5
1899,Matija Nastasić,rs,DF,,Fiorentina,Serie A,28,1993,2.4,1,1,1,0,0,1,1,100.0,0,1,1,0,5,6,11
1900,Roberto Navarro,es,MF,FW,Real Sociedad,La Liga,19,2002,2.2,5,3,1,1,3,3,5,60.0,2,2,0,2,2,7,2
1901,Ximo Navarro,es,DF,,Alavés,La Liga,31,1990,15.0,28,19,21,6,1,13,27,48.1,14,11,5,6,22,50,56
1902,Jesús Navas,es,DF,,Sevilla,La Liga,35,1985,19.8,18,13,11,5,2,9,17,52.9,8,15,2,13,17,35,26
1903,Keylor Navas,cr,GK,,Paris S-G,Ligue 1,34,1986,20.6,0,0,0,0,0,0,0,,0,0,0,0,0,0,5
1904,Papa Ndiaga Yade,mr,DF,FW,Metz,Ligue 1,21,2000,7.7,15,10,8,7,0,8,18,44.4,10,4,1,3,10,25,9
1905,Wilfred Ndidi,ng,MF,DF,Leicester City,Premier League,24,1996,18.0,60,32,32,27,1,22,55,40.0,33,36,8,28,42,102,54
1906,Tanguy Ndombele,fr,MF,,Tottenham,Premier League,24,1996,5.4,10,7,3,5,2,1,8,12.5,7,5,0,5,1,11,1
1907,Tanguy Ndombele,fr,MF,,Lyon,Ligue 1,24,1996,7.8,25,14,5,17,3,12,19,63.2,7,8,3,5,3,28,6
1908,Dan Ndoye,ch,FW,MF,Nice,Ligue 1,20,2000,2.3,0,0,0,0,0,0,2,0.0,2,4,0,4,0,0,0
1909,Paul Nebel,de,MF,FW,Mainz 05,Bundesliga,18,2002,2.5,5,3,3,1,1,2,3,66.7,1,0,0,0,0,5,1
1910,Álvaro Negredo,es,FW,,Cádiz,La Liga,35,1985,24.0,5,3,1,4,0,3,6,50.0,3,11,5,6,2,7,23
1911,Reiss Nelson,eng,FW,,Arsenal,Premier League,21,1999,0.2,1,0,0,0,1,0,1,0.0,1,1,0,1,0,1,0
1912,David Nemeth,at,DF,,Mainz 05,Bundesliga,20,2001,3.5,3,2,2,1,0,1,3,33.3,2,5,1,4,6,9,11
1913,Ilija Nestorovski,mk,FW,,Udinese,Serie A,31,1990,2.1,0,0,0,0,0,0,3,0.0,3,0,0,0,0,0,4
1914,Neto,br,GK,,Barcelona,La Liga,32,1989,3.0,0,0,0,0,0,0,0,,0,0,0,0,0,0,2
1915,Pedro Neto,pt,FW,MF,Wolves,Premier League,21,2000,5.2,4,4,2,0,2,0,9,0.0,9,0,0,0,6,10,1
1916,Luca Netz,de,DF,FW,Gladbach,Bundesliga,18,2003,15.5,24,11,12,10,2,11,40,27.5,29,24,4,20,13,37,33
1917,Manuel Neuer,de,GK,,Bayern Munich,Bundesliga,35,1986,27.9,2,1,2,0,0,1,2,50.0,1,0,0,0,0,2,7
1918,Florian Neuhaus,de,MF,,Gladbach,Bundesliga,24,1997,23.6,55,28,24,26,5,27,64,42.2,37,38,6,32,31,86,19
1919,Carlos Neva,es,DF,,Granada,La Liga,25,1996,23.4,31,19,24,7,0,16,28,57.1,12,27,9,18,32,63,81
1920,Rúben Neves,pt,MF,,Wolves,Premier League,24,1997,29.6,68,37,23,41,4,24,87,27.6,63,39,5,34,41,109,49
1921,Neymar,br,FW,MF,Paris S-G,Ligue 1,29,1992,20.6,29,19,5,12,12,12,36,33.3,24,9,1,8,4,33,2
1922,Yvan Neyou,cm,MF,,Saint-Étienne,Ligue 1,24,1997,10.4,29,13,14,12,3,9,27,33.3,18,8,3,5,23,52,13
1923,Jeremy Ngakia,eng,DF,,Watford,Premier League,20,2000,10.0,31,18,23,5,3,11,26,42.3,15,11,4,7,12,43,32
1924,Jessic Ngankam,de,FW,,Greuther Fürth,Bundesliga,21,2000,3.8,3,1,1,1,1,1,2,50.0,1,3,0,3,0,3,1
1925,Opa Nguette,sn,FW,MF,Metz,Ligue 1,27,1994,11.6,21,14,9,6,6,5,14,35.7,9,13,3,10,2,23,9
1926,Aurélien Nguiamba,fr,MF,,Spezia,Serie A,22,1999,0.6,3,2,1,2,0,2,3,66.7,1,2,1,1,0,3,1
1927,Sikou Niakaté,ml,DF,,Metz,Ligue 1,22,1999,7.3,8,7,8,0,0,4,11,36.4,7,5,3,2,27,35,34
1928,Moussa Niakhate,sn,DF,,Mainz 05,Bundesliga,25,1996,28.5,40,23,25,13,2,20,33,60.6,13,37,11,26,50,90,69
1929,Ibrahima Niane,sn,FW,,Metz,Ligue 1,22,1999,17.6,1,1,0,1,0,0,5,0.0,5,6,1,5,3,4,16
1930,M'Baye Niang,sn,FW,,Bordeaux,Ligue 1,26,1994,8.6,4,0,0,2,2,0,4,0.0,4,9,1,8,1,5,4
1931,Tanguy Nianzou,fr,DF,,Bayern Munich,Bundesliga,19,2002,6.5,11,7,7,3,1,7,11,63.6,4,7,2,5,7,18,17
1932,Cheikh Niasse,sn,FW,MF,Lille,Ligue 1,21,2000,0.5,2,2,0,2,0,2,3,66.7,1,1,1,0,1,3,2
1933,Florian Niederlechner,de,FW,,Augsburg,Bundesliga,30,1990,12.9,6,5,1,3,2,4,13,30.8,9,9,0,9,4,10,7
1934,Håvard Nielsen,no,MF,FW,Greuther Fürth,Bundesliga,28,1993,15.2,17,12,5,11,1,8,21,38.1,13,18,1,17,7,24,22
1935,Saúl Ñíguez,es,DF,MF,Chelsea,Premier League,26,1994,5.3,20,9,11,9,0,9,16,56.3,7,14,3,11,7,27,10
1936,Saúl Ñíguez,es,FW,MF,Atlético Madrid,La Liga,26,1994,2.2,7,2,0,6,1,3,4,75.0,1,7,1,6,0,7,3
1937,Dimitris Nikolaou,gr,DF,,Spezia,Serie A,22,1998,36.0,39,26,29,7,3,22,34,64.7,12,48,24,24,49,88,132
1938,Joakim Nilsson,se,DF,,Arminia,Bundesliga,27,1994,30.4,37,19,24,13,0,20,26,76.9,6,36,23,13,56,93,143
1939,Casimir Ninga,td,FW,,Angers,Ligue 1,28,1993,4.5,5,1,1,4,0,2,5,40.0,3,2,0,2,1,6,0
1940,Fernando Niño,es,FW,,Mallorca,La Liga,20,2000,9.8,10,4,3,2,5,2,12,16.7,10,9,2,7,3,13,15
1941,Eddie Nketiah,eng,FW,,Arsenal,Premier League,22,1999,9.3,9,4,1,4,4,1,4,25.0,3,9,2,7,4,13,5
1942,Nicolas Nkoulou,cm,DF,,Watford,Premier League,31,1990,1.9,1,0,0,1,0,0,0,,0,2,1,1,2,3,8
1943,Christopher Nkunku,fr,FW,MF,RB Leipzig,Bundesliga,23,1997,30.3,23,10,10,11,2,9,35,25.7,26,23,2,21,15,38,15
1944,Felix Nmecha,de,MF,FW,Wolfsburg,Bundesliga,20,2000,3.6,3,1,1,1,1,0,2,0.0,2,2,0,2,7,10,6
1945,Lukas Nmecha,de,FW,MF,Wolfsburg,Bundesliga,22,1998,18.1,12,5,5,5,2,5,19,26.3,14,9,1,8,4,16,10
1946,Mark Noble,eng,MF,,West Ham,Premier League,34,1987,3.7,8,2,7,1,0,5,11,45.5,6,4,1,3,4,12,2
1947,Peru Nolaskoain,es,DF,,Athletic Club,La Liga,22,1998,0.0,0,0,0,0,0,0,0,,0,0,0,0,0,0,0
1948,Nolito,es,MF,,Celta Vigo,La Liga,34,1986,15.4,25,15,14,7,4,13,47,27.7,34,20,1,19,9,34,5
1949,Arnaud Nordin,fr,FW,MF,Saint-Étienne,Ligue 1,23,1998,20.8,21,11,8,8,5,8,22,36.4,14,19,0,19,6,27,8
1950,Håvard Nordtveit,no,DF,,Hoffenheim,Bundesliga,31,1990,3.4,7,6,2,4,1,4,4,100.0,0,2,1,1,10,17,11
1951,Mathias Normann,no,MF,,Norwich City,Premier League,25,1996,18.3,34,21,19,14,1,17,46,37.0,29,17,8,9,19,53,43
1952,Connor Noß,ie,MF,,Gladbach,Bundesliga,20,2001,0.6,1,0,0,1,0,0,1,0.0,1,1,1,0,0,1,0
1953,Hugo Novoa,es,MF,FW,RB Leipzig,Bundesliga,18,2003,1.5,4,4,2,0,2,2,7,28.6,5,2,0,2,1,5,0
1954,Soma Novothny,hu,FW,MF,Bochum,Bundesliga,27,1994,0.9,1,1,1,0,0,0,1,0.0,1,1,0,1,0,1,2
1955,Jean-Pierre Nsame,cm,FW,,Venezia,Serie A,28,1993,2.7,1,1,0,0,1,0,0,,0,0,0,0,0,1,1
1956,Randy Nteka,ao,FW,MF,Rayo Vallecano,La Liga,23,1997,16.2,24,13,9,11,4,8,19,42.1,11,21,1,20,8,32,12
1957,Alexander Nübel,de,GK,,Monaco,Ligue 1,24,1996,38.0,0,0,0,0,0,0,1,0.0,1,0,0,0,0,0,11
1958,Kasim Nuhu,gh,DF,,Hoffenheim,Bundesliga,26,1995,0.1,0,0,0,0,0,0,1,0.0,1,0,0,0,0,0,1
1959,Unai Núñez,es,DF,,Athletic Club,La Liga,24,1997,6.9,4,4,2,2,0,3,6,50.0,3,9,8,1,8,12,26
1960,Hans Nunoo Sarpei,gh,DF,MF,Greuther Fürth,Bundesliga,22,1998,7.1,16,11,9,7,0,10,14,71.4,4,8,5,3,14,30,21
1961,Bram Nuytinck,nl,DF,,Udinese,Serie A,31,1990,22.6,38,24,24,13,1,15,34,44.1,19,42,31,11,22,60,101
1962,Simeon Nwankwo,ng,FW,,Salernitana,Serie A,29,1992,9.4,5,5,0,4,1,4,10,40.0,6,8,3,5,3,8,10
1963,Gerzino Nyamsi,fr,DF,,Strasbourg,Ligue 1,24,1997,33.2,35,21,24,9,2,20,27,74.1,7,25,16,9,25,60,90
1964,Allan Nyom,cm,DF,,Getafe,La Liga,33,1988,2.7,3,1,2,1,0,2,2,100.0,0,2,1,1,2,5,7
1965,M'Bala Nzola,ao,FW,,Spezia,Serie A,24,1996,11.9,2,2,0,0,2,1,6,16.7,5,8,0,8,0,2,13
1966,Christian Nørgaard,dk,MF,,Brentford,Premier League,27,1994,33.9,109,60,42,58,9,52,101,51.5,49,48,9,39,64,173,58
1967,Adam Obert,sk,DF,MF,Cagliari,Serie A,18,2002,3.0,8,5,6,2,0,5,6,83.3,1,6,4,2,4,12,11
1968,Joel Obi,ng,MF,DF,Salernitana,Serie A,30,1991,12.7,23,14,5,14,4,5,12,41.7,7,17,6,11,10,33,7
1969,Jan Oblak,si,GK,,Atlético Madrid,La Liga,28,1993,38.0,0,0,0,0,0,0,0,,0,0,0,0,1,1,10
1970,Lucas Ocampos,ar,FW,,Sevilla,La Liga,27,1994,23.6,45,24,23,18,4,23,55,41.8,32,35,1,34,9,54,24
1971,Bastian Oczipka,de,DF,,Union Berlin,Bundesliga,32,1989,10.4,24,15,15,7,2,10,13,76.9,3,10,2,8,12,36,21
1972,Brian Oddei,it,FW,,Sassuolo,Serie A,18,2002,0.1,0,0,0,0,0,0,0,,0,0,0,0,0,0,0
1973,Álvaro Odriozola,es,DF,,Fiorentina,Serie A,25,1995,19.3,25,15,12,6,7,15,32,46.9,17,17,6,11,8,33,25
1974,Angelo Ogbonna,it,DF,,West Ham,Premier League,33,1988,10.2,7,4,5,2,0,3,7,42.9,4,5,4,1,11,18,29
1975,Florent Ogier,fr,DF,,Clermont Foot,Ligue 1,32,1989,27.0,31,17,18,12,1,17,31,54.8,14,41,27,14,37,68,89
1976,Stefano Okaka,it,FW,,Udinese,Serie A,31,1989,0.2,0,0,0,0,0,0,0,,0,2,0,2,0,0,1
1977,David Okereke,ng,FW,MF,Venezia,Serie A,23,1997,22.8,16,10,4,9,3,3,20,15.0,17,19,3,16,10,26,20
1978,Masaya Okugawa,jp,MF,FW,Arminia,Bundesliga,25,1996,28.1,46,25,18,22,6,12,37,32.4,25,29,1,28,20,66,13
1979,Lucas Olaza,uy,DF,,Elche,La Liga,27,1994,3.3,5,3,3,1,1,1,1,100.0,0,5,1,4,4,9,6
1980,Oier Olazábal,es,GK,,Espanyol,La Liga,31,1989,1.5,0,0,0,0,0,0,0,,0,0,0,0,0,0,0
1981,Mathias Olesen,lu,MF,FW,Köln,Bundesliga,20,2001,0.2,0,0,0,0,0,0,0,,0,0,0,0,1,1,0
1982,Michael Olise,fr,FW,MF,Crystal Palace,Premier League,19,2001,12.7,22,18,8,11,3,7,24,29.2,17,17,0,17,6,28,6
1983,Christian Oliva,uy,MF,,Cagliari,Serie A,25,1996,0.5,2,2,2,0,0,1,4,25.0,3,0,0,0,0,2,0
1984,Brian Oliván,es,DF,,Mallorca,La Liga,27,1994,24.3,33,20,22,9,2,12,23,52.2,11,17,7,10,28,61,63
1985,Sérgio Oliveira,pt,MF,,Roma,Serie A,29,1992,9.9,27,14,11,14,2,15,30,50.0,15,13,0,13,10,37,7
1986,Mathías Olivera,uy,DF,,Getafe,La Liga,23,1997,31.1,79,47,39,34,6,40,69,58.0,29,45,4,41,55,134,67
1987,Dani Olmo,es,MF,FW,RB Leipzig,Bundesliga,23,1998,8.3,14,6,5,7,2,5,18,27.8,13,5,1,4,4,18,1
1988,Robin Olsen,se,GK,,Aston Villa,Premier League,31,1990,1.0,0,0,0,0,0,0,0,,0,0,0,0,0,0,0
1989,Warmed Omari,km,DF,,Rennes,Ligue 1,21,2000,31.1,33,17,22,10,1,15,23,65.2,8,20,13,7,31,64,94
1990,Jonas Omlin,ch,GK,,Montpellier,Ligue 1,27,1994,28.7,2,1,2,0,0,2,3,66.7,1,0,0,0,0,2,12
1991,Andrew Omobamidele,ie,DF,,Norwich City,Premier League,19,2002,4.2,8,6,5,3,0,5,11,45.5,6,8,8,0,5,13,13
1992,Amadou Onana,be,MF,,Lille,Ligue 1,19,2001,15.1,48,31,17,27,4,18,25,72.0,7,10,3,7,30,78,19
1993,Jean Onana,cm,MF,,Bordeaux,Ligue 1,21,2000,20.4,70,49,33,33,4,35,86,40.7,51,37,5,32,36,106,23
1994,Karim Onisiwo,at,FW,,Mainz 05,Bundesliga,29,1992,26.2,18,10,4,6,8,7,22,31.8,15,27,2,25,7,25,8
1995,Javier Ontiveros,es,FW,MF,Osasuna,La Liga,23,1997,0.4,0,0,0,0,0,0,2,0.0,2,0,0,0,1,1,0
1996,Tyler Onyango,eng,MF,,Everton,Premier League,18,2003,0.3,0,0,0,0,0,0,0,,0,0,0,0,0,0,1
1997,Frank Onyeka,ng,MF,,Brentford,Premier League,23,1998,11.6,25,17,13,9,3,8,27,29.6,19,16,2,14,14,39,13
1998,Willi Orban,hu,DF,,RB Leipzig,Bundesliga,28,1992,29.4,32,22,20,11,1,13,25,52.0,12,40,24,16,44,76,123
1999,Divock Origi,be,FW,,Liverpool,Premier League,26,1995,1.5,0,0,0,0,0,0,2,0.0,2,1,0,1,1,1,2
2000,Riccardo Orsolini,it,FW,MF,Bologna,Serie A,24,1997,19.8,21,13,9,11,1,13,29,44.8,16,9,4,5,5,26,14
2001,Stefan Ortega,de,GK,,Arminia,Bundesliga,28,1992,33.0,1,0,1,0,0,1,2,50.0,1,2,0,2,0,1,5
2002,Pedro Ortiz,es,MF,,Sevilla,La Liga,20,2000,0.1,0,0,0,0,0,0,0,,0,0,0,0,0,0,1
2003,Victor Osimhen,ng,FW,,Napoli,Serie A,22,1998,22.0,10,5,1,2,7,2,6,33.3,4,16,3,13,3,13,17
2004,Milutin Osmajić,me,FW,MF,Cádiz,La Liga,22,1999,2.9,1,1,0,1,0,0,0,,0,0,0,0,1,2,3
2005,David Ospina,co,GK,,Napoli,Serie A,32,1988,31.0,0,0,0,0,0,0,0,,0,0,0,0,1,1,11
2006,Patrick Osterhage,de,MF,,Bochum,Bundesliga,21,2000,6.7,9,6,3,5,1,3,7,42.9,4,7,1,6,11,20,8
2007,Tomáš Ostrák,cz,MF,FW,Köln,Bundesliga,21,2000,0.3,1,0,0,0,1,1,3,33.3,2,0,0,0,1,2,0
2008,Otávio,br,MF,,Bordeaux,Ligue 1,27,1994,12.7,36,23,13,21,2,16,39,41.0,23,9,3,6,18,54,11
2009,Paulo Otávio,br,DF,MF,Wolfsburg,Bundesliga,26,1994,4.0,14,10,7,4,3,8,15,53.3,7,11,6,5,4,18,9
2010,Dango Ouattara,bf,MF,FW,Lorient,Ligue 1,19,2002,9.0,21,15,9,11,1,11,23,47.8,12,10,1,9,14,35,15
2011,Remi Oudin,fr,MF,FW,Bordeaux,Ligue 1,24,1996,19.3,34,18,19,13,2,18,32,56.3,14,14,3,11,27,61,21
2012,Alexandre Oukidja,dz,GK,,Metz,Ligue 1,33,1988,20.8,0,0,0,0,0,0,1,0.0,1,1,0,1,1,1,17
2013,Azzedine Ounahi,ma,MF,,Angers,Ligue 1,21,2000,18.1,39,22,16,22,1,11,40,27.5,29,19,1,18,26,65,13
2014,Adam Ounas,dz,MF,FW,Napoli,Serie A,24,1996,3.6,6,1,0,3,3,3,7,42.9,4,3,0,3,2,8,3
2015,Jesús Owono,gq,GK,,Alavés,La Liga,20,2001,1.0,0,0,0,0,0,0,0,,0,0,0,0,0,0,1
2016,Reece Oxford,eng,DF,,Augsburg,Bundesliga,22,1998,29.9,27,14,16,9,2,15,31,48.4,16,42,33,9,72,99,172
2017,Alex Oxlade-Chamberlain,eng,MF,FW,Liverpool,Premier League,27,1993,8.7,15,11,2,8,5,3,14,21.4,11,12,2,10,6,21,5
2018,Mikel Oyarzabal,es,FW,MF,Real Sociedad,La Liga,24,1997,18.6,18,10,7,7,4,7,21,33.3,14,18,2,16,10,28,16
2019,Ambroise Oyongo,cm,DF,,Montpellier,Ligue 1,30,1991,7.3,13,4,7,4,2,9,15,60.0,6,5,1,4,6,19,17
2020,Salih Özcan,tr,MF,,Köln,Bundesliga,23,1998,25.7,42,30,14,23,5,22,51,43.1,29,37,5,32,51,93,35
2021,Levin Öztunalı,de,MF,,Union Berlin,Bundesliga,25,1996,6.4,14,11,6,5,3,7,17,41.2,10,3,0,3,4,18,12
2022,Fernando Pacheco,es,GK,,Alavés,La Liga,29,1992,33.9,2,1,2,0,0,2,2,100.0,0,0,0,0,0,2,18
2023,Jon Pacheco,es,DF,,Real Sociedad,La Liga,20,2001,4.2,6,4,4,2,0,3,3,100.0,0,6,4,2,6,12,18
2024,Gonçalo Paciência,pt,FW,,Eint Frankfurt,Bundesliga,26,1994,5.7,4,2,2,1,1,1,3,33.3,2,2,0,2,1,5,4
2025,Daniele Padelli,it,GK,,Udinese,Serie A,35,1985,3.0,0,0,0,0,0,0,0,,0,0,0,0,0,0,2
2026,Simone Pafundi,it,FW,,Udinese,Serie A,15,2006,0.3,0,0,0,0,0,0,1,0.0,1,0,0,0,0,0,0
2027,Vincent Pajot,fr,MF,,Metz,Ligue 1,30,1990,25.7,86,56,35,47,4,20,46,43.5,26,33,6,27,51,137,38
2028,Exequiel Palacios,ar,MF,,Leverkusen,Bundesliga,22,1998,12.2,30,19,12,14,4,15,38,39.5,23,20,1,19,28,58,11
2029,Helibelton Palacios,co,DF,,Elche,La Liga,28,1993,21.5,69,38,56,10,3,37,55,67.3,18,21,8,13,18,87,61
2030,Isaac Palazón Camacho,es,FW,MF,Rayo Vallecano,La Liga,26,1994,25.4,42,28,20,19,3,18,59,30.5,41,31,3,28,13,55,22
2031,Nicolas Pallois,fr,DF,,Nantes,Ligue 1,33,1987,27.2,51,33,40,11,0,34,59,57.6,25,40,19,21,53,104,116
2032,Cole Palmer,eng,FW,MF,Manchester City,Premier League,19,2002,1.4,2,1,1,1,0,0,2,0.0,2,3,0,3,1,3,0
2033,Erik Palmer-Brown,us,DF,,Troyes,Ligue 1,24,1997,19.3,37,22,29,8,0,20,26,76.9,6,26,18,8,34,71,87
2034,Emerson Palmieri,it,DF,,Chelsea,Premier League,26,1994,0.1,0,0,0,0,0,0,0,,0,0,0,0,0,0,0
2035,Emerson Palmieri,it,DF,,Lyon,Ligue 1,26,1994,25.2,46,25,16,22,8,22,34,64.7,12,23,8,15,27,73,66
2036,Martin Palumbo,no,FW,,Juventus,Serie A,19,2002,0.1,0,0,0,0,0,0,1,0.0,1,0,0,0,0,0,0
2037,Goran Pandev,mk,FW,MF,Genoa,Serie A,38,1983,9.4,2,0,1,0,1,0,9,0.0,9,3,1,2,2,4,0
2038,Ivor Pandur,hr,GK,,Hellas Verona,Serie A,21,2000,3.0,0,0,0,0,0,0,0,,0,0,0,0,0,0,2
2039,Miloš Pantović,rs,MF,FW,Bochum,Bundesliga,25,1996,17.0,19,10,8,7,4,6,25,24.0,19,26,4,22,18,37,14
2040,Antonios Papadopoulos,de,DF,MF,Dortmund,Bundesliga,21,1999,0.2,0,0,0,0,0,0,0,,0,1,0,1,0,0,0
2041,Merveille Papela,de,MF,,Mainz 05,Bundesliga,20,2001,0.9,3,2,2,1,0,2,3,66.7,1,2,0,2,2,5,0
2042,Lucas Paquetá,br,MF,FW,Lyon,Ligue 1,23,1997,30.0,68,38,24,26,18,17,51,33.3,34,43,5,38,9,77,22
2043,Rubén Pardo,es,MF,,Bordeaux,Ligue 1,28,1992,0.1,0,0,0,0,0,0,0,,0,0,0,0,0,0,0
2044,Kevin Paredes,us,FW,DF,Wolfsburg,Bundesliga,18,2003,0.2,1,0,0,0,1,0,0,,0,1,0,1,0,1,0
2045,Leandro Paredes,ar,MF,,Paris S-G,Ligue 1,27,1994,9.3,23,13,9,11,3,12,24,50.0,12,10,6,4,10,33,5
2046,Daniel Parejo,es,MF,,Villarreal,La Liga,32,1989,30.0,43,29,15,15,13,20,52,38.5,32,32,7,25,29,72,19
2047,Fabiano Parisi,it,DF,,Empoli,Serie A,20,2000,16.4,35,19,25,5,5,13,31,41.9,18,30,10,20,22,57,42
2048,Raúl Parra,es,DF,,Cádiz,La Liga,21,1999,1.0,2,1,2,0,0,1,3,33.3,2,0,0,0,0,2,5
2049,Thomas Partey,gh,MF,,Arsenal,Premier League,28,1993,22.5,43,29,22,17,4,18,44,40.9,26,22,4,18,23,66,35
2050,Mario Pašalić,hr,MF,FW,Atalanta,Serie A,26,1995,22.2,27,12,8,13,6,12,30,40.0,18,27,6,21,20,47,14
2051,Felix Passlack,de,DF,,Dortmund,Bundesliga,23,1998,5.2,13,9,8,4,1,6,12,50.0,6,5,1,4,4,17,7
2052,Javier Pastore,ar,MF,FW,Elche,La Liga,32,1989,5.8,7,3,3,2,2,3,12,25.0,9,5,1,4,4,11,2
2053,Patric,es,DF,,Lazio,Serie A,28,1993,18.3,21,15,17,4,0,9,20,45.0,11,22,11,11,12,33,44
2054,Rui Patrício,pt,GK,,Roma,Serie A,33,1988,38.0,0,0,0,0,0,0,0,,0,1,0,1,0,0,10
2055,Paulinho,br,FW,MF,Leverkusen,Bundesliga,21,2000,13.5,22,13,6,13,3,13,27,48.1,14,14,1,13,6,28,7
2056,Gabriel Paulista,br,DF,,Valencia,La Liga,30,1990,17.7,21,12,16,5,0,14,20,70.0,6,18,12,6,39,60,88
2057,Benjamin Pavard,fr,DF,,Bayern Munich,Bundesliga,25,1996,23.1,35,20,21,13,1,19,29,65.5,10,28,16,12,36,71,50
2058,Strahinja Pavlović,rs,DF,,Monaco,Ligue 1,20,2001,5.0,23,16,8,13,2,8,12,66.7,4,5,3,2,9,32,15
2059,Leonardo Pavoletti,it,FW,,Cagliari,Serie A,32,1988,16.9,10,6,2,5,3,3,9,33.3,6,9,5,4,2,12,12
2060,Dimitri Payet,fr,FW,MF,Marseille,Ligue 1,34,1987,28.8,16,8,4,10,2,7,31,22.6,24,9,0,9,9,25,3
2061,Mads Pedersen,dk,MF,DF,Augsburg,Bundesliga,24,1996,15.5,28,21,8,15,5,12,27,44.4,15,13,4,9,15,43,30
2062,Alfonso Pedraza,es,DF,,Villarreal,La Liga,25,1996,18.9,34,16,17,12,5,10,28,35.7,18,12,3,9,31,65,32
2063,Pedri,es,MF,,Barcelona,La Liga,18,2002,9.8,20,12,9,8,3,7,20,35.0,13,13,0,13,5,25,7
2064,Pedro,es,FW,,Lazio,Serie A,34,1987,22.6,36,23,8,19,9,16,47,34.0,31,18,2,16,6,42,8
2065,João Pedro,it,FW,,Cagliari,Serie A,29,1992,36.9,15,12,2,8,5,4,18,22.2,14,23,5,18,8,23,18
2066,Adrià Pedrosa,es,DF,,Espanyol,La Liga,23,1998,30.2,58,30,38,14,6,26,57,45.6,31,25,7,18,25,83,92
2067,Gianluca Pegolo,it,GK,,Sassuolo,Serie A,40,1981,1.0,0,0,0,0,0,0,0,,0,0,0,0,0,0,0
2068,Peter Pekarík,sk,DF,,Hertha BSC,Bundesliga,34,1986,24.8,45,29,33,11,1,32,46,69.6,14,28,10,18,29,74,58
2069,Pietro Pellegri,it,FW,,Torino,Serie A,20,2001,2.4,1,1,0,1,0,0,4,0.0,4,0,0,0,0,1,5
2070,Pietro Pellegri,it,FW,,Milan,Serie A,20,2001,1.5,2,2,0,1,1,0,1,0.0,1,0,0,0,0,2,1
2071,Lorenzo Pellegrini,it,MF,,Roma,Serie A,25,1996,25.4,35,14,10,17,8,16,60,26.7,44,29,1,28,27,62,20
2072,Luca Pellegrini,it,DF,,Juventus,Serie A,22,1999,12.3,23,10,13,5,5,12,19,63.2,7,9,1,8,5,28,23
2073,Facundo Pellistri,uy,MF,FW,Alavés,La Liga,19,2001,7.5,9,5,4,3,2,1,10,10.0,9,13,2,11,6,15,7
2074,Federico Peluso,it,DF,,Sassuolo,Serie A,37,1984,0.1,1,1,0,1,0,1,1,100.0,0,0,0,0,0,1,0
2075,Timothee Pembele,fr,DF,,Bordeaux,Ligue 1,18,2002,15.7,20,8,8,10,2,10,29,34.5,19,12,3,9,16,36,24
2076,Rubén Peña,es,MF,FW,Villarreal,La Liga,30,1991,1.5,2,0,1,1,0,2,6,33.3,4,1,0,1,5,7,2
2077,Philipp Pentke,de,GK,,Hoffenheim,Bundesliga,36,1985,1.0,0,0,0,0,0,0,0,,0,0,0,0,0,0,0
2078,Nicolas Pépé,ci,FW,MF,Arsenal,Premier League,26,1995,7.7,8,5,3,5,0,3,9,33.3,6,9,1,8,8,16,2
2079,Ricardo Pepi,us,FW,MF,Augsburg,Bundesliga,18,2003,5.3,4,2,1,3,0,1,8,12.5,7,7,0,7,3,7,8
2080,Alberto Perea,es,MF,,Cádiz,La Liga,30,1990,8.6,19,9,7,9,3,6,20,30.0,14,15,1,14,9,28,4
2081,Brayann Pereira,fr,DF,MF,Lens,Ligue 1,18,2003,0.2,1,1,1,0,0,1,1,100.0,0,0,0,0,0,1,1
2082,Danilo Pereira,pt,MF,,Paris S-G,Ligue 1,29,1991,22.6,33,17,10,20,3,14,28,50.0,14,19,10,9,37,70,29
2083,Mathias Pereira Lage,pt,DF,,Angers,Ligue 1,24,1996,11.6,21,7,10,7,4,8,30,26.7,22,18,7,11,21,42,22
2084,Ricardo Pereira,pt,DF,,Leicester City,Premier League,27,1993,11.0,37,20,19,13,5,21,40,52.5,19,13,1,12,17,54,39
2085,Gastón Pereiro,uy,FW,MF,Cagliari,Serie A,26,1995,10.8,13,5,7,4,2,5,18,27.8,13,12,1,11,1,14,8
2086,Luan Peres Petroni,br,DF,,Marseille,Ligue 1,27,1994,29.8,65,35,33,25,7,36,52,69.2,16,26,12,14,43,108,64
2087,Dor Peretz,il,MF,,Venezia,Serie A,26,1995,6.5,27,18,8,16,3,13,25,52.0,12,8,4,4,8,35,11
2088,Roberto Pereyra,ar,MF,FW,Udinese,Serie A,30,1991,19.9,18,12,7,6,5,7,23,30.4,16,26,5,21,12,30,11
2089,Ayoze Pérez,es,MF,FW,Leicester City,Premier League,28,1993,4.9,4,2,0,3,1,0,13,0.0,13,11,1,10,2,6,5
2090,Carles Pérez,es,MF,FW,Roma,Serie A,23,1998,6.2,8,3,3,1,4,3,12,25.0,9,10,0,10,2,10,2
2091,Iñigo Pérez,es,MF,,Osasuna,La Liga,33,1988,3.8,3,2,2,1,0,2,4,50.0,2,1,0,1,0,3,3
2092,Juan Pérez,es,GK,,Osasuna,La Liga,25,1996,2.0,0,0,0,0,0,0,1,0.0,1,0,0,0,0,0,1
2093,Kike Pérez,es,MF,FW,Elche,La Liga,24,1997,5.8,8,6,1,3,4,0,10,0.0,10,6,1,5,3,11,4
2094,Lucas Pérez,es,FW,,Elche,La Liga,32,1988,14.1,4,1,2,1,1,3,10,30.0,7,2,0,2,3,7,4
2095,Lucas Pérez,es,FW,MF,Cádiz,La Liga,32,1988,11.8,3,3,2,1,0,0,10,0.0,10,3,1,2,0,3,1
2096,Nehuén Pérez,ar,DF,,Udinese,Serie A,21,2000,18.8,44,21,21,21,2,16,25,64.0,9,27,9,18,21,65,47
2097,Mattia Perin,it,GK,,Juventus,Serie A,28,1992,4.5,0,0,0,0,0,0,0,,0,0,0,0,0,0,3
2098,Ivan Perišić,hr,DF,,Inter,Serie A,32,1989,31.3,38,22,18,11,9,28,50,56.0,22,39,7,32,47,85,42
2099,Sonny Perkins,eng,MF,,West Ham,Premier League,17,2004,0.0,0,0,0,0,0,0,0,,0,0,0,0,0,0,0
2100,Diego Perotti,ar,MF,FW,Salernitana,Serie A,33,1988,3.2,11,5,7,1,3,4,13,30.8,9,1,0,1,2,13,6
2101,Romain Perraud,fr,DF,,Southampton,Premier League,23,1997,18.0,34,22,18,14,2,16,29,55.2,13,24,6,18,17,51,42
2102,Lucas Perrin,fr,DF,,Strasbourg,Ligue 1,22,1998,27.8,43,32,24,17,2,26,45,57.8,19,28,11,17,42,85,67
2103,Mario Perrone,it,DF,,Salernitana,Serie A,18,2003,0.2,0,0,0,0,0,0,0,,0,0,0,0,0,0,0
2104,Pavao Pervan,at,GK,,Wolfsburg,Bundesliga,33,1987,6.0,0,0,0,0,0,0,0,,0,0,0,0,0,0,3
2105,Matteo Pessina,it,MF,FW,Atalanta,Serie A,24,1997,16.0,27,14,10,11,6,14,33,42.4,19,22,3,19,13,40,7
2106,Andrea Petagna,it,FW,,Napoli,Serie A,26,1995,6.5,3,3,0,3,0,1,4,25.0,3,1,0,1,0,3,5
2107,Nils Petersen,de,FW,,Freiburg,Bundesliga,32,1988,6.4,5,3,2,3,0,1,13,7.7,12,7,0,7,2,7,17
2108,Danijel Petković,me,GK,,Angers,Ligue 1,28,1993,15.0,0,0,0,0,0,0,1,0.0,1,0,0,0,1,1,9
2109,Léo Pétrot,fr,DF,,Lorient,Ligue 1,24,1997,20.2,31,17,23,8,0,21,29,72.4,8,33,17,16,22,53,86
2110,Njegoš Petrović,rs,MF,,Granada,La Liga,22,1999,10.2,24,11,4,19,1,8,14,57.1,6,16,4,12,9,33,11
2111,Jens Petter Hauge,no,MF,FW,Eint Frankfurt,Bundesliga,21,1999,11.6,14,5,6,7,1,7,23,30.4,16,7,0,7,3,17,5
2112,Alex Petxa,es,DF,MF,Athletic Club,La Liga,24,1997,4.6,12,9,4,7,1,4,8,50.0,4,8,2,6,4,16,6
2113,Germán Pezzella,ar,DF,,Betis,La Liga,30,1991,22.1,21,9,16,5,0,16,29,55.2,13,29,18,11,39,60,106
2114,Giuseppe Pezzella,it,DF,MF,Atalanta,Serie A,23,1997,11.9,28,13,15,7,6,8,18,44.4,10,13,5,8,9,37,16
2115,Immanuel Pherai,sr,MF,,Dortmund,Bundesliga,20,2001,0.0,0,0,0,0,0,0,0,,0,0,0,0,0,0,0
2116,Maximilian Philipp,de,MF,,Wolfsburg,Bundesliga,27,1994,10.7,15,11,6,7,2,5,21,23.8,16,12,1,11,4,19,5
2117,Romain Philippoteaux,fr,MF,,Brest,Ligue 1,33,1988,0.3,1,1,0,1,0,0,0,,0,0,0,0,0,1,0
2118,Kalvin Phillips,eng,MF,,Leeds United,Premier League,25,1995,17.7,54,25,24,25,5,24,57,42.1,33,37,9,28,24,78,18
2119,Jaden Philogene Bidace,eng,FW,,Aston Villa,Premier League,19,2002,0.1,0,0,0,0,0,0,0,,0,0,0,0,0,0,0
2120,Jérôme Phojo,fr,DF,,Clermont Foot,Ligue 1,28,1993,0.1,0,0,0,0,0,0,0,,0,0,0,0,0,0,1
2121,Krzysztof Piątek,pl,FW,,Fiorentina,Serie A,26,1995,8.1,5,4,1,1,3,2,3,66.7,1,6,0,6,2,7,8
2122,Krzysztof Piątek,pl,FW,,Hertha BSC,Bundesliga,26,1995,3.9,2,2,0,1,1,0,1,0.0,1,0,0,0,0,2,6
2123,Pablo Piatti,ar,MF,FW,Elche,La Liga,32,1989,3.5,9,4,5,3,1,3,8,37.5,5,5,1,4,2,11,3
2124,Cristiano Piccini,it,DF,,Valencia,La Liga,28,1992,3.6,14,8,9,5,0,5,7,71.4,2,3,2,1,1,15,11
2125,Roberto Piccoli,it,FW,,Genoa,Serie A,20,2001,2.4,1,1,0,1,0,0,0,,0,0,0,0,1,2,1
2126,Roberto Piccoli,it,FW,,Atalanta,Serie A,20,2001,2.2,2,0,0,0,2,0,2,0.0,2,1,0,1,0,2,0
2127,Jordan Pickford,eng,GK,,Everton,Premier League,27,1994,35.0,1,1,1,0,0,0,1,0.0,1,1,0,1,1,2,14
2128,Jérémy Pied,fr,DF,FW,Lille,Ligue 1,32,1989,0.1,0,0,0,0,0,0,0,,0,0,0,0,1,1,0
2129,Amos Pieper,de,DF,,Arminia,Bundesliga,23,1998,26.4,58,29,38,19,1,32,51,62.7,19,37,23,14,50,108,132
2130,Ronaël Pierre-Gabriel,fr,DF,,Brest,Ligue 1,23,1998,28.3,79,45,52,21,6,42,73,57.5,31,22,7,15,48,127,74
2131,Erik Pieters,nl,DF,,Burnley,Premier League,32,1988,8.1,28,15,15,11,2,17,28,60.7,11,18,7,11,10,38,38
2132,Tomás Pina Isla,es,MF,,Alavés,La Liga,33,1987,16.0,28,16,13,11,4,14,29,48.3,15,12,3,9,22,50,23
2133,Andrea Pinamonti,it,FW,,Empoli,Serie A,22,1999,31.9,11,6,0,7,4,2,18,11.1,16,24,3,21,7,18,23
2134,Orbelín Pineda,mx,MF,FW,Celta Vigo,La Liga,25,1996,1.1,4,1,4,0,0,1,2,50.0,1,0,0,0,0,4,1
2135,Ethan Pinnock,jm,DF,,Brentford,Premier League,28,1993,29.9,51,35,37,12,2,25,38,65.8,13,30,11,19,44,95,154
2136,Yeremi Pino,es,MF,FW,Villarreal,La Liga,18,2002,18.6,32,14,14,8,10,10,24,41.7,14,33,4,29,6,38,12
2137,Carlo Pinsoglio,it,GK,,Juventus,Serie A,31,1990,0.5,0,0,0,0,0,0,0,,0,0,0,0,0,0,0
2138,Riccardo Pinzi,it,FW,,Udinese,Serie A,17,2003,0.0,0,0,0,0,0,0,0,,0,0,0,0,0,0,0
2139,Gerard Piqué,es,DF,,Barcelona,La Liga,34,1987,23.2,22,12,18,4,0,11,14,78.6,3,19,16,3,34,56,86
2140,Marko Pjaca,hr,MF,,Torino,Serie A,26,1995,12.8,7,4,1,4,2,3,8,37.5,5,10,2,8,4,11,2
2141,Marvin Plattenhardt,de,DF,,Hertha BSC,Bundesliga,29,1992,18.2,25,11,18,6,1,15,27,55.6,12,18,3,15,17,42,52
2142,Alassane Pléa,fr,MF,FW,Gladbach,Bundesliga,28,1993,23.0,18,14,6,9,3,7,20,35.0,13,9,1,8,4,22,9
2143,Tommaso Pobega,it,MF,,Torino,Serie A,22,1999,24.9,48,30,17,20,11,21,40,52.5,19,32,3,29,25,73,38
2144,Daniel Podence,pt,FW,MF,Wolves,Premier League,25,1995,16.5,18,11,10,5,3,4,17,23.5,13,8,1,7,10,28,1
2145,Suf Podgoreanu,il,FW,,Spezia,Serie A,19,2002,1.3,2,0,1,1,0,1,4,25.0,3,2,0,2,1,3,3
2146,Paul Pogba,fr,MF,FW,Manchester Utd,Premier League,28,1993,15.0,13,9,5,7,1,6,28,21.4,22,11,0,11,13,26,16
2147,Joel Pohjanpalo,fi,FW,,Leverkusen,Bundesliga,26,1994,0.1,0,0,0,0,0,0,0,,0,0,0,0,0,0,0
2148,Matteo Politano,it,FW,,Napoli,Serie A,27,1993,18.3,24,12,8,11,5,15,54,27.8,39,11,2,9,13,37,5
2149,Julian Pollersbeck,de,GK,,Lyon,Ligue 1,26,1994,4.8,0,0,0,0,0,0,0,,0,0,0,0,1,1,1
2150,Sebastian Polter,de,FW,,Bochum,Bundesliga,30,1991,26.0,9,3,1,4,4,2,11,18.2,9,15,5,10,2,11,24
2151,Ezequiel Ponce,ar,FW,,Elche,La Liga,24,1997,7.4,5,4,1,3,1,3,10,30.0,7,5,0,5,1,6,7
2152,Marin Pongračić,hr,DF,,Dortmund,Bundesliga,23,1997,9.2,17,10,13,4,0,6,10,60.0,4,11,5,6,17,34,32
2153,Pere Pons,es,MF,,Alavés,La Liga,28,1993,15.2,26,18,4,20,2,7,21,33.3,14,10,1,9,6,32,11
2154,Nick Pope,eng,GK,,Burnley,Premier League,29,1992,36.0,0,0,0,0,0,0,2,0.0,2,0,0,0,2,2,30
2155,Manolo Portanova,it,FW,MF,Genoa,Serie A,21,2000,14.7,46,28,9,26,11,14,34,41.2,20,26,2,24,17,63,22
2156,Portu,es,FW,MF,Real Sociedad,La Liga,29,1992,17.7,16,7,2,6,8,3,19,15.8,16,21,3,18,7,23,8
2157,Stefan Posch,at,DF,,Hoffenheim,Bundesliga,24,1997,24.4,48,30,20,26,2,22,39,56.4,17,43,18,25,28,76,71
2158,Sergio Postigo,es,DF,,Levante,La Liga,32,1988,9.4,11,7,8,2,1,4,8,50.0,4,7,5,2,7,18,45
2159,Yussuf Poulsen,dk,FW,MF,RB Leipzig,Bundesliga,27,1994,12.0,13,4,3,6,4,3,13,23.1,10,13,0,13,3,16,9
2160,Gaëtan Poussin,fr,GK,,Bordeaux,Ligue 1,22,1999,13.0,1,1,1,0,0,1,1,100.0,0,0,0,0,0,1,15
2161,Darío Poveda,es,FW,MF,Getafe,La Liga,24,1997,4.2,2,0,1,0,1,0,5,0.0,5,7,1,6,1,3,1
2162,José Pozo,es,MF,DF,Rayo Vallecano,La Liga,25,1996,0.8,2,2,0,2,0,2,3,66.7,1,1,0,1,0,2,1
2163,Dennis Praet,be,MF,,Torino,Serie A,27,1994,17.1,19,10,6,8,5,8,22,36.4,14,12,1,11,3,22,4
2164,Mateusz Praszelik,pl,MF,,Hellas Verona,Serie A,20,2000,0.3,0,0,0,0,0,0,0,,0,0,0,0,0,0,0
2165,Abdón Prats,es,FW,,Mallorca,La Liga,28,1992,7.1,2,2,1,0,1,1,5,20.0,4,5,0,5,1,3,6
2166,Sanjin Prcić,ba,MF,,Strasbourg,Ligue 1,27,1993,24.3,47,28,14,27,6,14,29,48.3,15,18,3,15,47,94,19
2167,Nicolas de Préville,fr,FW,MF,Metz,Ligue 1,30,1991,21.9,17,8,7,8,2,3,19,15.8,16,12,4,8,5,22,11
2168,Isaac Price,nir,MF,,Everton,Premier League,17,2003,0.2,0,0,0,0,0,0,0,,0,1,0,1,0,0,0
2169,Manuel Prietl,at,MF,,Arminia,Bundesliga,29,1991,23.6,59,26,23,31,5,23,60,38.3,37,28,3,25,39,98,33
2170,Alejandro Primo,es,GK,,Levante,La Liga,17,2004,1.0,0,0,0,0,0,0,0,,0,0,0,0,0,0,0
2171,Grischa Prömel,de,MF,,Union Berlin,Bundesliga,26,1995,26.9,36,22,14,17,5,22,52,42.3,30,18,3,15,23,59,22
2172,Nick Proschwitz,de,FW,,Hoffenheim,Bundesliga,34,1986,0.3,0,0,0,0,0,0,0,,0,0,0,0,0,0,0
2173,Ivan Provedel,it,GK,,Spezia,Serie A,27,1994,30.7,0,0,0,0,0,0,1,0.0,1,0,0,0,2,2,10
2174,Javi Puado,es,MF,FW,Espanyol,La Liga,23,1998,24.9,24,14,18,5,1,12,37,32.4,25,18,2,16,11,35,24
2175,Marc Pubill,es,DF,MF,Levante,La Liga,18,2003,5.7,12,6,10,2,0,4,8,50.0,4,7,2,5,4,16,8
2176,Antonio Puertas,es,MF,FW,Granada,La Liga,29,1992,25.1,34,20,18,12,4,17,44,38.6,27,33,3,30,11,45,36
2177,Riqui Puig,es,MF,,Barcelona,La Liga,21,1999,5.4,6,3,2,4,0,2,14,14.3,12,5,0,5,3,9,0
2178,Teemu Pukki,fi,FW,,Norwich City,Premier League,31,1990,36.1,23,11,2,14,7,6,29,20.7,23,21,1,20,4,27,3
2179,Erick Pulgar,cl,MF,,Fiorentina,Serie A,27,1994,3.8,6,6,4,2,0,4,9,44.4,5,5,1,4,5,11,2
2180,Christian Pulisic,us,MF,FW,Chelsea,Premier League,22,1998,14.3,10,7,6,3,1,3,17,17.6,14,12,0,12,5,15,10
2181,Afimico Pululu,fr,FW,MF,Greuther Fürth,Bundesliga,22,1999,0.8,1,0,1,0,0,1,2,50.0,1,1,0,1,0,1,0
2182,Ignacio Pussetto,ar,FW,MF,Udinese,Serie A,25,1995,13.4,17,9,2,9,6,2,10,20.0,8,18,2,16,4,21,13
2183,Niklas Pyyhtiä,fi,MF,,Bologna,Serie A,17,2003,0.2,0,0,0,0,0,0,1,0.0,1,0,0,0,0,0,0
2184,Przemysław Płacheta,pl,FW,MF,Norwich City,Premier League,23,1998,5.6,4,3,3,1,0,2,7,28.6,5,3,1,2,2,6,5
2185,Yacine Qasmi,ma,FW,,Rayo Vallecano,La Liga,30,1991,0.0,0,0,0,0,0,0,0,,0,0,0,0,0,0,0
2186,Fabio Quagliarella,it,FW,,Sampdoria,Serie A,38,1983,18.5,6,2,2,2,2,2,15,13.3,13,14,1,13,3,9,12
2187,Quini,es,DF,,Granada,La Liga,31,1989,25.6,73,34,48,21,4,42,79,53.2,37,28,10,18,36,109,62
2188,Dani Raba,es,MF,FW,Villarreal,La Liga,25,1995,1.0,1,0,0,1,0,1,2,50.0,1,2,0,2,0,1,2
2189,Dani Raba,es,MF,FW,Granada,La Liga,25,1995,0.3,2,2,1,0,1,2,3,66.7,1,0,0,0,1,3,0
2190,Adrien Rabiot,fr,MF,,Juventus,Serie A,26,1995,25.4,64,43,32,24,8,15,34,44.1,19,34,8,26,20,84,41
2191,Uroš Račić,rs,MF,,Valencia,La Liga,23,1998,13.4,32,18,9,19,4,12,33,36.4,21,16,6,10,16,48,21
2192,Nemanja Radoja,rs,MF,,Levante,La Liga,28,1993,13.5,25,8,9,13,3,8,20,40.0,12,16,9,7,22,47,16
2193,Nemanja Radonjić,rs,FW,,Marseille,Ligue 1,25,1996,0.2,0,0,0,0,0,0,0,,0,0,0,0,0,0,0
2194,Ivan Radovanović,rs,DF,MF,Salernitana,Serie A,32,1988,11.7,11,7,8,3,0,7,19,36.8,12,14,7,7,7,18,29
2195,Ionuț Radu,ro,GK,,Inter,Serie A,24,1997,1.0,0,0,0,0,0,0,0,,0,0,0,0,0,0,0
2196,Ștefan Radu,ro,DF,,Lazio,Serie A,34,1986,6.2,9,6,3,6,0,5,9,55.6,4,7,2,5,5,14,15
2197,Boris Radunović,rs,GK,,Cagliari,Serie A,25,1996,3.0,0,0,0,0,0,0,0,,0,0,0,0,0,0,0
2198,Sidney Raebiger,de,MF,,RB Leipzig,Bundesliga,16,2005,0.0,0,0,0,0,0,0,0,,0,0,0,0,0,0,0
2199,Rafinha,br,MF,,Real Sociedad,La Liga,28,1993,11.7,43,27,17,20,6,16,28,57.1,12,21,2,19,12,55,4
2200,Rafinha,br,FW,MF,Paris S-G,Ligue 1,28,1993,2.4,14,8,3,9,2,7,11,63.6,4,3,0,3,4,18,0
2201,Antonio Raillo,es,DF,,Mallorca,La Liga,29,1991,17.0,16,7,10,4,2,5,6,83.3,1,17,14,3,18,34,81
2202,Antonio Raimondo,it,FW,,Bologna,Serie A,17,2004,0.8,0,0,0,0,0,0,1,0.0,1,1,0,1,0,0,1
2203,Predrag Rajković,rs,GK,,Reims,Ligue 1,25,1995,38.0,2,2,2,0,0,2,3,66.7,1,1,0,1,1,3,21
2204,Jesurun Rak Sakyi,eng,FW,MF,Crystal Palace,Premier League,18,2002,0.9,0,0,0,0,0,0,1,0.0,1,3,0,3,1,1,0
2205,Ivan Rakitić,hr,MF,,Sevilla,La Liga,33,1988,24.2,40,22,12,23,5,13,40,32.5,27,31,8,23,23,63,35
2206,Diant Ramaj,de,GK,,Eint Frankfurt,Bundesliga,19,2001,1.0,0,0,0,0,0,0,0,,0,0,0,0,0,0,3
2207,Jonás Ramalho,es,DF,,Osasuna,La Liga,28,1993,2.7,4,2,2,2,0,2,3,66.7,1,4,1,3,3,7,9
2208,Adil Rami,fr,DF,,Troyes,Ligue 1,35,1985,13.0,10,9,6,4,0,7,8,87.5,1,17,9,8,16,26,43
2209,Sandro Ramírez,es,FW,,Getafe,La Liga,26,1995,16.2,7,3,1,3,3,1,12,8.3,11,14,3,11,2,9,3
2210,Guilherme Ramos,pt,DF,,Arminia,Bundesliga,23,1997,10.1,25,15,17,8,0,12,19,63.2,7,21,8,13,27,52,52
2211,Sergio Ramos,es,DF,,Paris S-G,Ligue 1,35,1986,8.9,12,5,6,6,0,8,15,53.3,7,4,2,2,8,20,27
2212,Aaron Ramsdale,eng,GK,,Arsenal,Premier League,23,1998,34.0,2,1,2,0,0,1,2,50.0,1,0,0,0,0,2,26
2213,Aaron Ramsey,wls,MF,,Juventus,Serie A,30,1990,1.1,0,0,0,0,0,0,0,,0,0,0,0,1,1,0
2214,Jacob Ramsey,eng,MF,,Aston Villa,Premier League,20,2001,27.4,67,44,31,28,8,30,69,43.5,39,36,7,29,24,91,28
2215,Luca Ranieri,it,DF,,Salernitana,Serie A,22,1999,23.4,38,21,23,11,4,19,33,57.6,14,18,8,10,22,60,67
2216,Andrea Ranocchia,it,DF,,Inter,Serie A,33,1988,3.8,8,4,5,1,2,1,3,33.3,2,4,3,1,4,12,16
2217,Raphinha,br,FW,MF,Leeds United,Premier League,24,1996,32.4,51,29,25,14,12,22,71,31.0,49,43,0,43,29,80,28
2218,Tobias Raschl,de,MF,,Greuther Fürth,Bundesliga,21,2000,6.6,12,9,4,8,0,5,7,71.4,2,10,1,9,3,15,1
2219,Elba Rashani,xk,FW,MF,Clermont Foot,Ligue 1,28,1993,19.5,40,21,15,21,4,17,55,30.9,38,34,3,31,11,51,20
2220,Marcus Rashford,eng,FW,MF,Manchester Utd,Premier League,23,1997,13.7,6,5,1,4,1,2,13,15.4,11,10,1,9,5,11,5
2221,Milot Rashica,xk,FW,MF,Norwich City,Premier League,25,1996,24.8,31,19,12,12,7,11,30,36.7,19,22,3,19,15,46,23
2222,Giacomo Raspadori,it,MF,FW,Sassuolo,Serie A,21,2000,30.4,29,18,5,15,9,11,38,28.9,27,29,3,26,9,38,11
2223,Raúl,es,FW,DF,Betis,La Liga,20,2000,0.0,0,0,0,0,0,0,0,,0,0,0,0,0,0,0
2224,David Raum,de,DF,FW,Hoffenheim,Bundesliga,23,1998,30.6,52,29,30,10,12,30,64,46.9,34,38,5,33,27,79,39
2225,Nicola Ravaglia,it,GK,,Sampdoria,Serie A,32,1988,0.1,0,0,0,0,0,0,0,,0,0,0,0,0,0,0
2226,David Raya,es,GK,,Brentford,Premier League,25,1995,24.0,0,0,0,0,0,0,0,,0,1,0,1,0,0,10
2227,Ante Rebić,hr,FW,,Milan,Serie A,27,1993,9.9,14,8,3,6,5,7,20,35.0,13,14,0,14,3,17,3
2228,Arkadiusz Reca,pl,DF,,Spezia,Serie A,26,1995,19.7,31,19,21,3,7,20,30,66.7,10,20,7,13,32,63,47
2229,Lluís Recasens,es,DF,,Espanyol,La Liga,19,2002,0.5,2,0,2,0,0,1,1,100.0,0,0,0,0,2,4,2
2230,Nathan Redmond,eng,MF,FW,Southampton,Premier League,27,1994,20.4,22,14,9,9,4,7,30,23.3,23,21,2,19,8,30,16
2231,Sergio Reguilón,es,DF,MF,Tottenham,Premier League,24,1996,21.3,40,24,15,18,7,22,43,51.2,21,20,8,12,31,71,45
2232,Manolo Reina,es,GK,,Mallorca,La Liga,36,1985,21.0,0,0,0,0,0,0,0,,0,0,0,0,1,1,6
2233,Pepe Reina,es,GK,,Lazio,Serie A,38,1982,15.0,0,0,0,0,0,0,1,0.0,1,0,0,0,0,0,1
2234,Jeff Reine-Adélaïde,fr,MF,DF,Lyon,Ligue 1,23,1998,2.2,5,3,4,1,0,4,5,80.0,1,2,0,2,0,5,0
2235,Reinier,br,FW,MF,Dortmund,Bundesliga,19,2002,1.8,5,3,4,0,1,1,1,100.0,0,3,0,3,0,5,0
2236,Karim Rekik,nl,DF,,Sevilla,La Liga,26,1994,12.2,11,8,4,6,1,2,9,22.2,7,11,6,5,9,20,19
2237,Álex Remiro,es,GK,,Real Sociedad,La Liga,26,1995,35.0,0,0,0,0,0,0,0,,0,0,0,0,1,1,24
2238,Panagiotis Retsos,gr,DF,,Hellas Verona,Serie A,22,1998,0.6,0,0,0,0,0,0,2,0.0,2,0,0,0,2,2,3
2239,Panagiotis Retsos,gr,DF,FW,Leverkusen,Bundesliga,22,1998,0.4,0,0,0,0,0,0,0,,0,0,0,0,1,1,0
2240,Marco Reus,de,MF,FW,Dortmund,Bundesliga,32,1989,27.8,45,30,13,21,11,16,42,38.1,26,23,6,17,12,57,41
2241,Elvis Rexhbeçaj,xk,MF,,Bochum,Bundesliga,23,1997,28.2,41,20,17,19,5,19,40,47.5,21,41,6,35,27,68,15
2242,Gio Reyna,us,MF,,Dortmund,Bundesliga,18,2002,4.9,7,4,2,4,1,3,9,33.3,6,6,0,6,1,8,3
2243,Bryan Reynolds,us,DF,,Roma,Serie A,20,2001,0.0,0,0,0,0,0,0,1,0.0,1,0,0,0,0,0,1
2244,Nico Ribaudo,es,MF,FW,Espanyol,La Liga,20,2001,12.4,15,6,9,5,1,11,34,32.4,23,14,2,12,7,22,3
2245,Tiago Ribeiro,pt,FW,,Monaco,Ligue 1,19,2002,0.0,0,0,0,0,0,0,0,,0,0,0,0,0,0,0
2246,Franck Ribéry,fr,MF,FW,Salernitana,Serie A,38,1983,15.8,17,10,6,6,5,8,13,61.5,5,12,0,12,3,20,1
2247,Samuele Ricci,it,MF,,Torino,Serie A,19,2001,8.0,8,4,4,2,2,2,5,40.0,3,7,1,6,14,22,9
2248,Samuele Ricci,it,MF,,Empoli,Serie A,19,2001,17.0,33,19,17,13,3,20,34,58.8,14,24,5,19,31,64,18
2249,Declan Rice,eng,MF,,West Ham,Premier League,22,1999,35.3,80,42,45,32,3,38,71,53.5,33,45,21,24,63,143,52
2250,Chris Richards,us,DF,,Hoffenheim,Bundesliga,21,2000,14.5,26,15,10,15,1,11,18,61.1,7,21,9,12,22,48,50
2251,Chris Richards,us,DF,,Bayern Munich,Bundesliga,21,2000,0.0,0,0,0,0,0,0,0,,0,1,0,1,0,0,0
2252,Omar Richards,eng,DF,,Bayern Munich,Bundesliga,23,1998,4.9,19,12,11,5,3,11,16,68.8,5,7,1,6,4,23,7
2253,Taylor Richards,eng,MF,,Brighton,Premier League,20,2000,0.3,1,0,0,1,0,1,2,50.0,1,0,0,0,0,1,0
2254,Richarlison,br,FW,,Everton,Premier League,24,1997,28.0,40,23,18,15,7,15,31,48.4,16,42,4,38,12,52,34
2255,Marco Richter,de,FW,MF,Hertha BSC,Bundesliga,23,1997,18.9,30,16,14,10,6,13,36,36.1,23,30,4,26,16,46,24
2256,Diego Rico,es,DF,,Real Sociedad,La Liga,28,1993,18.3,41,20,19,17,5,22,45,48.9,23,29,4,25,30,71,54
2257,Sergio Rico,es,GK,,Mallorca,La Liga,27,1993,14.0,0,0,0,0,0,0,0,,0,0,0,0,0,0,5
2258,Sergio Rico,es,GK,,Paris S-G,Ligue 1,27,1993,0.3,0,0,0,0,0,0,0,,0,0,0,0,0,0,1
2259,Jaïro Riedewald,nl,MF,,Crystal Palace,Premier League,24,1996,1.3,1,1,0,1,0,1,2,50.0,1,1,0,1,1,2,2
2260,Manuel Riemann,de,GK,,Bochum,Bundesliga,32,1988,31.0,1,0,1,0,0,1,4,25.0,3,0,0,0,1,2,12
2261,Tomás Rincón,ve,MF,,Torino,Serie A,33,1988,1.8,2,2,2,0,0,0,3,0.0,3,3,1,2,2,4,4
2262,Tomás Rincón,ve,MF,,Sampdoria,Serie A,33,1988,13.0,22,13,9,10,3,13,34,38.2,21,15,2,13,18,40,11
2263,Luis Rioja,es,MF,FW,Alavés,La Liga,27,1993,34.6,28,15,11,10,7,14,58,24.1,44,22,1,21,25,53,20
2264,Renaud Ripart,fr,MF,FW,Troyes,Ligue 1,28,1993,21.0,38,21,18,15,5,18,50,36.0,32,21,1,20,19,57,21
2265,Mihailo Ristić,rs,DF,,Montpellier,Ligue 1,25,1995,20.0,44,32,26,16,2,25,43,58.1,18,16,6,10,17,61,48
2266,Matt Ritchie,sct,DF,,Newcastle Utd,Premier League,31,1989,14.9,22,15,10,10,2,10,27,37.0,17,10,2,8,13,35,26
2267,Maxence Rivera,fr,FW,,Saint-Étienne,Ligue 1,19,2002,0.1,0,0,0,0,0,0,0,,0,0,0,0,0,0,0
2268,Rober,es,DF,,Levante,La Liga,26,1995,22.3,36,20,27,7,2,23,39,59.0,16,25,15,10,30,66,90
2269,Sergi Roberto,es,MF,DF,Barcelona,La Liga,29,1992,4.4,5,1,2,3,0,3,5,60.0,2,2,0,2,4,9,6
2270,Connor Roberts,wls,DF,,Burnley,Premier League,25,1995,18.8,20,13,10,7,3,10,15,66.7,5,25,5,20,22,42,62
2271,Patrick Roberts,eng,MF,,Troyes,Ligue 1,24,1997,0.2,0,0,0,0,0,0,0,,0,0,0,0,0,0,0
2272,Tyler Roberts,wls,MF,FW,Leeds United,Premier League,22,1999,11.0,16,7,6,7,3,9,16,56.3,7,11,1,10,5,21,11
2273,Andrew Robertson,sct,DF,,Liverpool,Premier League,27,1994,28.2,36,21,16,15,5,20,35,57.1,15,24,3,21,23,59,61
2274,Marc Roca,es,MF,,Bayern Munich,Bundesliga,24,1996,4.2,9,7,2,4,3,2,8,25.0,6,6,0,6,6,15,4
2275,Rubén Rochina,es,MF,FW,Granada,La Liga,30,1991,8.3,21,13,7,8,6,8,28,28.6,20,11,1,10,6,27,5
2276,Cimo Röcker,de,DF,,Hertha BSC,Bundesliga,27,1994,0.2,0,0,0,0,0,0,0,,0,0,0,0,2,2,0
2277,Enzo Roco,cl,DF,,Elche,La Liga,28,1992,28.4,36,20,24,11,1,15,24,62.5,9,38,27,11,28,64,110
2278,Stian Rode Gregersen,no,DF,,Bordeaux,Ligue 1,26,1995,21.7,39,26,23,12,4,18,33,54.5,15,26,16,10,38,77,103
2279,Sebastian Rode,de,MF,,Eint Frankfurt,Bundesliga,30,1990,8.4,15,7,5,8,2,5,17,29.4,12,11,1,10,13,28,8
2280,Joe Rodon,wls,DF,,Tottenham,Premier League,23,1997,1.0,0,0,0,0,0,0,0,,0,2,1,1,0,0,7
2281,Rodri,es,MF,,Manchester City,Premier League,25,1996,32.0,72,43,24,38,10,32,59,54.2,27,28,5,23,28,100,45
2282,Rodri,es,FW,,Betis,La Liga,21,2000,9.8,10,7,4,5,1,5,22,22.7,17,11,0,11,3,13,4
2283,Rodrigo,es,MF,FW,Leeds United,Premier League,30,1991,25.2,20,9,7,6,7,4,32,12.5,28,12,0,12,11,31,27
2284,Gerson Rodrigues,lu,FW,MF,Troyes,Ligue 1,26,1995,9.4,12,9,2,6,4,1,17,5.9,16,8,1,7,0,12,2
2285,Kévin Rodrigues,pt,DF,FW,Rayo Vallecano,La Liga,27,1994,4.8,15,11,8,7,0,6,10,60.0,4,10,1,9,7,22,6
2286,Ángel Rodríguez,es,FW,MF,Mallorca,La Liga,34,1987,17.2,15,9,6,7,2,4,21,19.0,17,15,1,14,3,18,13
2287,Óscar Rodríguez Arnaiz,es,MF,FW,Getafe,La Liga,23,1998,10.5,16,11,6,8,2,4,12,33.3,8,7,1,6,11,27,6
2288,Óscar Rodríguez Arnaiz,es,FW,MF,Sevilla,La Liga,23,1998,4.6,4,3,1,3,0,2,3,66.7,1,2,0,2,5,9,7
2289,Dani Rodríguez,es,MF,FW,Mallorca,La Liga,33,1988,31.5,53,31,20,24,9,15,46,32.6,31,28,3,25,20,73,27
2290,Guido Rodríguez,ar,MF,,Betis,La Liga,27,1994,28.1,97,53,46,45,6,54,98,55.1,44,55,12,43,31,128,56
2291,Jay Rodriguez,eng,FW,,Burnley,Premier League,32,1989,15.4,20,12,8,8,4,4,14,28.6,10,19,1,18,4,24,12
2292,Ricardo Rodríguez,ch,DF,,Torino,Serie A,28,1992,27.5,36,21,11,23,2,18,33,54.5,15,22,8,14,41,77,48
2293,Rodrygo,br,FW,,Real Madrid,La Liga,20,2001,16.9,18,14,7,4,7,3,18,16.7,15,21,0,21,11,29,3
2294,Mads Roerslev,dk,DF,,Brentford,Premier League,22,1999,13.8,23,12,19,2,2,14,32,43.8,18,14,5,9,16,39,29
2295,Marko Rog,hr,MF,,Cagliari,Serie A,26,1995,3.5,5,3,1,2,2,1,8,12.5,7,6,1,5,1,6,3
2296,Rogério,br,DF,,Sassuolo,Serie A,23,1998,19.2,21,13,12,5,4,15,22,68.2,7,20,8,12,18,39,42
2297,Alessio Romagnoli,it,DF,,Milan,Serie A,26,1995,15.7,24,14,14,10,0,14,18,77.8,4,21,12,9,19,43,45
2298,Simone Romagnoli,it,DF,,Empoli,Serie A,31,1990,16.6,28,12,14,12,2,15,20,75.0,5,34,28,6,9,37,86
2299,Leo Román,es,GK,,Mallorca,La Liga,21,2000,2.0,0,0,0,0,0,0,0,,0,0,0,0,0,0,2
2300,Cristian Romero,ar,DF,,Tottenham,Premier League,23,1998,20.5,62,39,39,21,2,22,34,64.7,12,46,21,25,33,95,74
2301,Iván Romero,es,FW,,Sevilla,La Liga,20,2001,2.0,2,2,0,2,0,0,0,,0,1,0,1,2,4,0
2302,Luka Romero,ar,FW,,Lazio,Serie A,16,2004,0.9,2,1,0,1,1,0,2,0.0,2,0,0,0,1,3,0
2303,Sergio Romero,ar,GK,,Venezia,Serie A,34,1987,16.0,2,2,2,0,0,2,2,100.0,0,0,0,0,1,3,10
2304,Oriol Romeu,es,MF,,Southampton,Premier League,29,1991,32.1,77,39,25,45,7,28,73,38.4,45,39,8,31,51,128,43
2305,Cristiano Ronaldo,pt,FW,,Manchester Utd,Premier League,36,1985,27.3,8,6,1,5,2,2,6,33.3,4,8,0,8,2,10,29
2306,Cristiano Ronaldo,pt,FW,,Juventus,Serie A,36,1985,0.3,1,0,0,1,0,1,1,100.0,0,0,0,0,0,1,0
2307,Salomón Rondón,ve,FW,,Everton,Premier League,31,1989,8.8,6,1,1,2,3,4,14,28.6,10,5,0,5,0,6,10
2308,Valentin Rongier,fr,MF,DF,Marseille,Ligue 1,26,1994,24.4,77,51,36,36,5,28,60,46.7,32,26,5,21,33,110,14
2309,Marten de Roon,nl,MF,DF,Atalanta,Serie A,30,1991,28.3,69,42,33,29,7,34,62,54.8,28,36,2,34,45,114,41
2310,Unai Ropero,es,MF,,Alavés,La Liga,19,2001,0.1,0,0,0,0,0,0,0,,0,0,0,0,1,1,0
2311,Pablo Rosario,nl,MF,,Nice,Ligue 1,24,1997,30.3,59,37,18,32,9,26,66,39.4,40,33,7,26,38,97,43
2312,Romario Rösch,de,MF,,Mainz 05,Bundesliga,22,1999,0.0,0,0,0,0,0,0,0,,0,0,0,0,0,0,0
2313,Danny Rose,eng,DF,,Watford,Premier League,31,1990,7.7,16,10,11,4,1,10,24,41.7,14,8,5,3,14,30,11
2314,Francesco Rossi,it,GK,,Atalanta,Serie A,30,1991,0.4,0,0,0,0,0,0,0,,0,0,0,0,0,0,0
2315,Tom Rothe,de,DF,,Dortmund,Bundesliga,16,2004,1.0,4,3,2,2,0,3,6,50.0,3,2,0,2,2,6,3
2316,Jérôme Roussillon,fr,DF,,Wolfsburg,Bundesliga,28,1993,19.7,14,9,8,6,0,10,16,62.5,6,24,5,19,14,28,34
2317,Nicolò Rovella,it,MF,,Genoa,Serie A,19,2001,16.3,37,26,16,14,7,15,40,37.5,25,21,1,20,20,57,20
2318,Jon Rowe,eng,FW,MF,Norwich City,Premier League,18,2003,2.5,3,2,2,1,0,2,3,66.7,1,7,0,7,3,6,1
2319,Amir Rrahmani,xk,DF,,Napoli,Serie A,27,1994,32.5,21,11,15,5,1,15,19,78.9,4,36,25,11,19,40,89
2320,Ruan,br,DF,,Sassuolo,Serie A,22,1999,2.4,7,4,7,0,0,3,4,75.0,1,6,5,1,2,9,24
2321,Rubén,es,DF,,Espanyol,La Liga,20,2001,1.7,6,1,4,2,0,4,7,57.1,3,0,0,0,2,8,4
2322,John Ruddy,eng,GK,,Wolves,Premier League,34,1986,1.5,0,0,0,0,0,0,0,,0,0,0,0,0,0,3
2323,Antonio Rüdiger,de,DF,,Chelsea,Premier League,28,1993,33.7,48,28,29,15,4,36,48,75.0,12,20,11,9,28,76,91
2324,Sebastian Rudy,de,MF,,Hoffenheim,Bundesliga,31,1990,8.6,22,12,9,13,0,11,21,52.4,10,8,3,5,11,33,8
2325,Daniele Rugani,it,DF,,Juventus,Serie A,27,1994,9.8,8,5,4,4,0,4,7,57.1,3,9,4,5,11,19,47
2326,Matteo Ruggeri,it,DF,,Salernitana,Serie A,19,2002,7.5,8,4,5,2,1,7,10,70.0,3,6,1,5,2,10,25
2327,Mário Rui,pt,DF,,Napoli,Serie A,30,1991,33.2,68,43,32,28,8,39,84,46.4,45,31,7,24,40,108,50
2328,Aitor Ruibal,es,FW,DF,Betis,La Liga,25,1996,9.5,21,15,13,3,5,10,34,29.4,24,8,0,8,8,29,6
2329,Isma Ruiz,es,MF,,Granada,La Liga,20,2001,3.1,3,1,3,0,0,1,9,11.1,8,5,2,3,3,6,2
2330,Fabián Ruiz Peña,es,MF,,Napoli,Serie A,25,1996,26.5,55,33,22,29,4,29,67,43.3,38,34,1,33,22,77,32
2331,Víctor Ruiz,es,DF,,Betis,La Liga,32,1989,15.8,11,9,7,2,2,6,9,66.7,3,18,13,5,29,40,71
2332,Gerónimo Rulli,ar,GK,,Villarreal,La Liga,29,1992,32.0,0,0,0,0,0,0,4,0.0,4,0,0,0,1,1,15
2333,Lukas Rupp,de,MF,,Norwich City,Premier League,30,1991,8.5,9,4,5,3,1,4,15,26.7,11,11,1,10,9,18,7
2334,Alessandro Russo,it,MF,,Salernitana,Serie A,17,2003,0.3,1,0,1,0,0,0,1,0.0,1,0,0,0,0,1,1
2335,Franco Russo,ar,DF,,Mallorca,La Liga,26,1994,16.3,19,10,10,9,0,13,31,41.9,18,14,9,5,27,46,73
2336,Georginio Rutter,fr,FW,MF,Hoffenheim,Bundesliga,19,2002,17.9,18,13,4,8,6,6,17,35.3,11,29,1,28,6,24,11
2337,Mathew Ryan,au,GK,,Real Sociedad,La Liga,29,1992,3.0,0,0,0,0,0,0,0,,0,0,0,0,0,0,2
2338,Julian Ryerson,no,DF,,Union Berlin,Bundesliga,23,1997,15.9,27,15,11,12,4,17,25,68.0,8,12,4,8,16,43,32
2339,Frederik Rønnow,dk,GK,,Union Berlin,Bundesliga,28,1992,7.0,0,0,0,0,0,0,0,,0,0,0,0,0,0,1
2340,José Sá,pt,GK,,Wolves,Premier League,28,1993,36.5,2,1,2,0,0,2,4,50.0,2,0,0,0,2,4,19
2341,Roli Pereira de Sa,fr,MF,,Nantes,Ligue 1,24,1996,6.4,12,4,3,5,4,3,20,15.0,17,6,0,6,6,18,3
2342,Youssouf Sabaly,sn,DF,,Betis,La Liga,28,1993,8.8,12,10,11,0,1,7,13,53.8,6,11,4,7,13,25,16
2343,Mathys Saban,fr,FW,MF,Saint-Étienne,Ligue 1,19,2002,0.8,4,2,2,2,0,1,1,100.0,0,1,0,1,0,4,0
2344,Stefano Sabelli,it,DF,,Genoa,Serie A,28,1993,3.9,6,3,3,2,1,3,9,33.3,6,5,1,4,3,9,12
2345,Abdelhamid Sabiri,ma,MF,FW,Sampdoria,Serie A,24,1996,9.9,34,18,10,15,9,7,25,28.0,18,10,2,8,7,41,3
2346,Marcel Sabitzer,at,MF,FW,RB Leipzig,Bundesliga,27,1994,0.5,2,1,1,1,0,1,1,100.0,0,0,0,0,1,3,0
2347,Marcel Sabitzer,at,MF,DF,Bayern Munich,Bundesliga,27,1994,10.1,18,7,8,8,2,9,19,47.4,10,7,0,7,9,27,10
2348,Falaye Sacko,ml,DF,,Saint-Étienne,Ligue 1,26,1995,7.4,15,10,14,1,0,13,16,81.3,3,11,7,4,4,19,18
2349,Alexis Saelemaekers,be,FW,,Milan,Serie A,22,1999,20.7,43,22,12,17,14,15,51,29.4,36,19,0,19,15,58,8
2350,Rafiki Said,km,MF,FW,Brest,Ligue 1,21,2000,1.4,4,3,1,2,1,3,4,75.0,1,2,0,2,0,4,0
2351,Wesley Saïd,fr,FW,MF,Lens,Ligue 1,26,1995,7.3,10,5,1,8,1,1,9,11.1,8,4,0,4,2,12,0
2352,Allan Saint-Maximin,fr,FW,MF,Newcastle Utd,Premier League,24,1997,31.2,13,8,6,4,3,3,17,17.6,14,13,2,11,11,24,3
2353,Romain Saïss,ma,DF,,Wolves,Premier League,31,1990,30.1,40,27,28,11,1,19,33,57.6,14,41,21,20,58,98,158
2354,Bukayo Saka,eng,FW,MF,Arsenal,Premier League,19,2001,33.1,40,21,12,17,11,13,39,33.3,26,28,2,26,22,62,23
2355,Mamadou Sakho,fr,DF,,Montpellier,Ligue 1,31,1990,28.6,34,22,26,8,0,16,26,61.5,10,41,34,7,41,75,134
2356,Bakary Sako,ml,FW,MF,Saint-Étienne,Ligue 1,33,1988,1.7,0,0,0,0,0,0,1,0.0,1,3,1,2,0,0,0
2357,Jacopo Sala,it,MF,,Spezia,Serie A,29,1991,9.8,22,11,10,10,2,13,30,43.3,17,6,0,6,14,36,11
2358,Mohamed Salah,eg,FW,,Liverpool,Premier League,29,1992,30.7,17,8,5,9,3,6,19,31.6,13,7,1,6,6,23,5
2359,Eddie Salcedo,it,MF,FW,Spezia,Serie A,19,2001,4.8,1,1,0,0,1,0,1,0.0,1,2,1,1,0,1,7
2360,William Saliba,fr,DF,,Marseille,Ligue 1,20,2001,36.0,54,32,36,16,2,27,35,77.1,8,24,16,8,48,102,85
2361,Romain Salin,fr,GK,,Rennes,Ligue 1,37,1984,1.0,0,0,0,0,0,0,0,,0,0,0,0,0,0,0
2362,Mohammed Salisu,gh,DF,,Southampton,Premier League,22,1999,33.0,80,47,54,22,4,40,65,61.5,25,49,26,23,78,158,158
2363,Roland Sallai,hu,MF,FW,Freiburg,Bundesliga,24,1997,17.2,22,16,8,11,3,7,23,30.4,16,12,0,12,11,33,12
2364,Yoann Salmier,gf,DF,,Troyes,Ligue 1,28,1992,29.6,58,33,44,11,3,26,34,76.5,8,30,14,16,40,98,94
2365,Salvi,es,MF,FW,Cádiz,La Liga,30,1991,15.5,20,10,9,8,3,8,20,40.0,12,17,2,15,6,26,11
2366,Lazar Samardzic,rs,MF,FW,Udinese,Serie A,19,2002,5.4,13,9,4,7,2,7,26,26.9,19,6,0,6,2,15,2
2367,Diadie Samassékou,ml,MF,,Hoffenheim,Bundesliga,25,1996,18.4,41,26,14,21,6,21,44,47.7,23,27,11,16,28,69,26
2368,Mama Samba Baldé,gw,MF,FW,Troyes,Ligue 1,25,1995,19.1,40,28,16,14,10,8,26,30.8,18,32,1,31,5,45,9
2369,Albert Sambi Lokonga,be,MF,,Arsenal,Premier League,21,1999,12.6,22,18,11,9,2,12,14,85.7,2,12,7,5,13,35,12
2370,Junior Sambia,fr,DF,FW,Montpellier,Ligue 1,24,1996,17.0,22,13,12,7,3,13,22,59.1,9,22,3,19,21,43,31
2371,Luigi Samele,it,FW,,Sassuolo,Serie A,19,2002,0.1,0,0,0,0,0,0,0,,0,0,0,0,0,0,1
2372,Fede San Emeterio,es,MF,,Cádiz,La Liga,24,1997,9.2,16,5,5,8,3,5,15,33.3,10,5,0,5,8,24,6
2373,Antonio Sanabria,py,FW,,Torino,Serie A,25,1996,20.0,3,2,0,1,2,1,4,25.0,3,11,4,7,2,5,10
2374,Oihan Sancet,es,FW,,Athletic Club,La Liga,21,2000,15.8,12,7,2,8,2,5,20,25.0,15,2,0,2,5,17,13
2375,Renato Sanches,pt,MF,FW,Lille,Ligue 1,23,1997,18.3,19,7,8,10,1,9,26,34.6,17,14,3,11,14,33,7
2376,Alexis Sánchez,cl,FW,,Inter,Serie A,32,1988,9.8,9,8,0,6,3,2,11,18.2,9,4,0,4,2,11,3
2377,Antonio Sánchez,es,MF,FW,Mallorca,La Liga,24,1997,18.0,53,24,29,17,7,19,49,38.8,30,32,2,30,32,85,32
2378,Davinson Sánchez,co,DF,,Tottenham,Premier League,25,1996,18.1,41,22,25,14,2,19,28,67.9,9,24,16,8,30,71,54
2379,Germán Sánchez,es,DF,,Granada,La Liga,34,1986,25.5,27,19,18,9,0,11,20,55.0,9,19,16,3,28,55,137
2380,Manu Sánchez,es,DF,,Osasuna,La Liga,20,2000,25.1,72,34,41,22,9,43,79,54.4,36,28,3,25,18,90,43
2381,Robert Sánchez,es,GK,,Brighton,Premier League,23,1997,37.0,2,1,2,0,0,1,1,100.0,0,1,0,1,0,2,11
2382,Jadon Sancho,eng,FW,MF,Manchester Utd,Premier League,21,2000,21.1,14,8,9,4,1,8,22,36.4,14,19,0,19,15,29,5
2383,Philippe Sandler,nl,DF,,Troyes,Ligue 1,24,1997,0.8,0,0,0,0,0,0,0,,0,1,1,0,3,3,6
2384,Alex Sandro,br,DF,,Juventus,Serie A,30,1991,19.8,27,16,15,9,3,11,25,44.0,14,17,6,11,27,54,40
2385,Leroy Sané,de,FW,MF,Bayern Munich,Bundesliga,25,1996,22.0,28,16,5,19,4,9,24,37.5,15,18,0,18,12,40,2
2386,Oier Sanjurjo,es,MF,,Osasuna,La Liga,35,1986,8.4,10,6,3,7,0,2,19,10.5,17,8,3,5,1,11,9
2387,Mohamed Sankoh,nl,FW,,Stuttgart,Bundesliga,17,2003,0.0,0,0,0,0,0,0,0,,0,0,0,0,0,0,0
2388,Morgan Sanson,fr,MF,,Aston Villa,Premier League,26,1994,4.0,12,8,7,2,3,3,7,42.9,4,13,0,13,10,22,2
2389,Nicola Sansone,it,FW,MF,Bologna,Serie A,29,1991,10.0,13,7,5,6,2,3,15,20.0,12,1,0,1,4,17,2
2390,Baptiste Santamaria,fr,MF,DF,Rennes,Ligue 1,26,1995,28.0,52,27,15,31,6,24,44,54.5,20,33,12,21,33,85,42
2391,Baptiste Santamaria,fr,MF,,Freiburg,Bundesliga,26,1995,0.2,0,0,0,0,0,0,1,0.0,1,0,0,0,1,1,1
2392,Federico Santander,py,FW,DF,Bologna,Serie A,30,1991,0.7,2,1,1,1,0,1,1,100.0,0,0,0,0,0,2,0
2393,Jesús Santiago,es,MF,,Valencia,La Liga,17,2004,0.9,2,2,1,1,0,0,2,0.0,2,1,0,1,0,2,1
2394,Samir Santos,br,DF,,Watford,Premier League,26,1994,18.6,24,11,18,6,0,8,19,42.1,11,21,11,10,43,67,85
2395,Samir Santos,br,DF,,Udinese,Serie A,26,1994,15.8,36,16,22,13,1,15,25,60.0,10,21,7,14,42,78,62
2396,Sergio Santos,es,DF,,Real Madrid,La Liga,20,2001,0.1,0,0,0,0,0,0,0,,0,0,0,0,0,0,0
2397,Alvaro Sanz,es,MF,,Barcelona,La Liga,20,2001,0.3,0,0,0,0,0,0,1,0.0,1,0,0,0,0,0,0
2398,Riccardo Saponara,it,FW,,Fiorentina,Serie A,29,1991,14.3,10,2,1,6,3,6,16,37.5,10,5,0,5,1,11,3
2399,Pablo Sarabia,es,FW,,Paris S-G,Ligue 1,29,1992,0.2,0,0,0,0,0,0,1,0.0,1,0,0,0,0,0,0
2400,Marcelo Saracchi,uy,DF,,Levante,La Liga,23,1998,2.1,8,5,6,1,1,2,4,50.0,2,3,0,3,4,12,7
2401,Josh Sargent,us,FW,MF,Norwich City,Premier League,21,2000,17.5,26,14,15,7,4,14,39,35.9,25,29,2,27,11,37,18
2402,Jeremy Sarmiento,ec,FW,MF,Brighton,Premier League,19,2002,0.5,1,1,0,0,1,0,2,0.0,2,2,0,2,0,1,0
2403,Bouna Sarr,sn,DF,,Bayern Munich,Bundesliga,29,1992,0.7,4,4,2,1,1,4,5,80.0,1,2,1,1,6,10,1
2404,Ismaila Sarr,sn,FW,MF,Watford,Premier League,23,1998,20.7,12,7,4,3,5,5,19,26.3,14,10,1,9,9,21,10
2405,Malang Sarr,fr,DF,,Chelsea,Premier League,22,1999,6.1,14,7,10,2,2,7,12,58.3,5,6,3,3,11,25,20
2406,Joan Sastre Vanrell,es,DF,,Mallorca,La Liga,24,1997,2.9,6,3,5,0,1,3,4,75.0,1,3,0,3,2,8,10
2407,Giacomo Satalino,it,GK,,Sassuolo,Serie A,22,1999,0.1,0,0,0,0,0,0,0,,0,0,0,0,0,0,0
2408,Martin Satriano,uy,FW,MF,Inter,Serie A,20,2001,0.4,1,0,0,0,1,1,1,100.0,0,0,0,0,0,1,0
2409,Martin Satriano,uy,FW,,Brest,Ligue 1,20,2001,10.4,5,2,1,1,3,2,7,28.6,5,8,0,8,2,7,3
2410,Téji Savanier,fr,MF,,Montpellier,Ligue 1,29,1991,26.8,46,27,18,19,9,21,59,35.6,38,23,1,22,25,71,12
2411,Esteban Saveljich,me,DF,,Rayo Vallecano,La Liga,30,1991,18.9,18,11,11,7,0,9,15,60.0,6,20,12,8,16,34,69
2412,Stefan Savić,me,DF,,Atlético Madrid,La Liga,30,1991,27.1,46,20,25,20,1,29,43,67.4,14,19,12,7,37,83,102
2413,Joe Scally,us,DF,,Gladbach,Bundesliga,18,2002,21.2,40,30,21,14,5,17,41,41.5,24,27,4,23,22,62,38
2414,Giorgio Scalvini,it,DF,MF,Atalanta,Serie A,17,2003,8.5,22,11,13,8,1,9,19,47.4,10,12,1,11,22,44,16
2415,Gianluca Scamacca,it,FW,,Sassuolo,Serie A,22,1999,23.8,19,14,2,5,12,5,21,23.8,16,16,1,15,5,24,22
2416,Dane Scarlett,eng,MF,,Tottenham,Premier League,17,2004,0.0,0,0,0,0,0,0,0,,0,0,0,0,0,0,0
2417,Kevin Schade,de,MF,FW,Freiburg,Bundesliga,19,2001,9.2,9,7,6,2,1,3,10,30.0,7,15,3,12,3,12,16
2418,András Schäfer,hu,MF,,Union Berlin,Bundesliga,22,1999,2.7,4,1,3,1,0,0,5,0.0,5,7,1,6,2,6,4
2419,Fabian Schär,ch,DF,,Newcastle Utd,Premier League,29,1991,24.0,16,11,11,3,2,8,16,50.0,8,27,18,9,32,48,95
2420,Louis Schaub,at,MF,FW,Köln,Bundesliga,26,1994,7.3,16,10,7,7,2,11,20,55.0,9,17,3,14,3,19,3
2421,Andrea Schiavone,it,MF,,Salernitana,Serie A,28,1993,6.3,14,8,5,9,0,10,23,43.5,13,13,3,10,8,22,12
2422,Patrik Schick,cz,FW,,Leverkusen,Bundesliga,25,1996,23.1,5,2,2,2,1,1,9,11.1,8,6,1,5,3,8,28
2423,Kingsley Schindler,gh,DF,FW,Köln,Bundesliga,28,1993,3.9,1,0,0,0,1,1,5,20.0,4,5,1,4,5,6,5
2424,Xaver Schlager,at,MF,,Wolfsburg,Bundesliga,23,1997,11.6,43,20,20,20,3,20,49,40.8,29,25,2,23,9,52,14
2425,Keven Schlotterbeck,de,DF,FW,Freiburg,Bundesliga,24,1997,3.5,11,5,6,5,0,5,6,83.3,1,7,4,3,11,22,24
2426,Nico Schlotterbeck,de,DF,,Freiburg,Bundesliga,21,1999,30.9,72,43,36,34,2,33,48,68.8,15,41,32,9,56,128,154
2427,Jeffrey Schlupp,gh,MF,FW,Crystal Palace,Premier League,28,1992,20.6,46,25,16,23,7,24,50,48.0,26,39,9,30,18,64,32
2428,Kasper Schmeichel,dk,GK,,Leicester City,Premier League,34,1986,37.0,0,0,0,0,0,0,2,0.0,2,0,0,0,1,1,15
2429,Jonathan Schmid,fr,DF,,Freiburg,Bundesliga,31,1990,6.5,12,6,6,3,3,5,7,71.4,2,7,1,6,6,18,15
2430,Benno Schmitz,de,DF,,Köln,Bundesliga,26,1994,26.9,57,37,21,27,9,42,86,48.8,44,44,8,36,39,96,39
2431,David Schnegg,at,DF,,Venezia,Serie A,22,1998,1.6,2,0,1,1,0,1,3,33.3,2,4,0,4,3,5,6
2432,Morgan Schneiderlin,fr,MF,,Nice,Ligue 1,31,1989,7.2,21,12,9,11,1,6,13,46.2,7,8,2,6,20,41,18
2433,Alessandro Schöpf,at,MF,,Arminia,Bundesliga,27,1994,26.6,40,22,19,16,5,14,30,46.7,16,31,5,26,30,70,21
2434,Jerdy Schouten,nl,MF,,Bologna,Serie A,24,1997,15.5,25,17,10,12,3,9,22,40.9,13,22,5,17,33,58,29
2435,Nico Schulz,de,DF,,Dortmund,Bundesliga,28,1993,9.3,21,12,9,7,5,9,21,42.9,12,8,1,7,11,32,8
2436,Marvin Schwäbe,de,GK,,Köln,Bundesliga,26,1995,21.0,0,0,0,0,0,0,0,,0,0,0,0,0,0,8
2437,Alexander Schwolow,de,GK,,Hertha BSC,Bundesliga,29,1992,24.2,0,0,0,0,0,0,1,0.0,1,0,0,0,2,2,18
2438,Valentino Scotta,es,DF,,Sevilla,La Liga,19,2001,0.0,0,0,0,0,0,0,0,,0,0,0,0,0,0,0
2439,Demba Seck,sn,MF,FW,Torino,Serie A,20,2001,1.6,2,1,0,2,0,0,0,,0,0,0,0,0,2,0
2440,Aleksandar Sedlar,rs,DF,MF,Mallorca,La Liga,29,1991,4.5,5,3,4,1,0,3,5,60.0,2,4,4,0,5,10,19
2441,Paul Seguin,de,MF,,Greuther Fürth,Bundesliga,26,1995,23.4,50,31,15,32,3,26,56,46.4,30,27,3,24,19,69,30
2442,Alidu Seidu,gh,DF,,Clermont Foot,Ligue 1,21,2000,15.7,34,20,20,13,1,16,27,59.3,11,25,11,14,34,68,49
2443,Davie Selke,de,FW,,Hertha BSC,Bundesliga,26,1995,11.2,5,4,1,3,1,1,3,33.3,2,6,1,5,1,6,11
2444,Matz Sels,be,GK,,Strasbourg,Ligue 1,29,1992,37.0,1,1,1,0,0,0,0,,0,0,0,0,1,2,22
2445,Ken Sema,se,MF,FW,Watford,Premier League,27,1993,9.5,16,6,11,4,1,9,20,45.0,11,10,0,10,5,21,11
2446,Nélson Semedo,pt,MF,DF,Wolves,Premier League,27,1993,23.7,58,39,39,17,2,25,49,51.0,24,23,4,19,21,79,64
2447,Lion Semić,de,DF,,Dortmund,Bundesliga,17,2003,0.0,0,0,0,0,0,0,0,,0,0,0,0,0,0,0
2448,Adrian Šemper,hr,GK,,Genoa,Serie A,23,1998,1.0,0,0,0,0,0,0,0,,0,0,0,0,0,0,0
2449,Stefano Sensi,it,MF,FW,Sampdoria,Serie A,25,1995,8.4,18,9,10,6,2,10,23,43.5,13,2,0,2,6,24,4
2450,Stefano Sensi,it,MF,FW,Inter,Serie A,25,1995,1.9,4,3,1,3,0,2,4,50.0,2,2,0,2,0,4,2
2451,Luigi Sepe,it,GK,,Salernitana,Serie A,30,1991,15.5,0,0,0,0,0,0,0,,0,0,0,0,1,1,3
2452,Suat Serdar,de,MF,FW,Hertha BSC,Bundesliga,24,1997,24.6,64,30,24,29,11,25,55,45.5,30,32,3,29,20,84,14
2453,Laurens Serpe,it,DF,,Genoa,Serie A,20,2001,0.5,1,0,1,0,0,1,2,50.0,1,0,0,0,0,1,1
2454,Janni Serra,de,FW,,Arminia,Bundesliga,23,1998,12.4,4,2,2,0,2,2,7,28.6,5,8,3,5,5,9,19
2455,Javier Serrano,es,MF,,Atlético Madrid,La Liga,18,2003,0.8,3,1,0,3,0,2,4,50.0,2,0,0,0,3,6,2
2456,Nicolás Serrano,es,MF,FW,Athletic Club,La Liga,18,2003,3.5,9,6,3,5,1,3,10,30.0,7,5,1,4,2,11,3
2457,Zidan Sertdemir,dk,MF,FW,Leverkusen,Bundesliga,16,2005,0.2,2,2,2,0,0,0,0,,0,0,0,0,0,2,0
2458,Ryan Sessegnon,eng,DF,MF,Tottenham,Premier League,21,2000,11.6,25,19,14,7,4,11,22,50.0,11,18,3,15,7,32,26
2459,Nils Seufert,de,MF,,Greuther Fürth,Bundesliga,24,1997,1.1,3,2,1,1,1,0,1,0.0,1,0,0,0,0,3,0
2460,Salva Sevilla,es,MF,,Mallorca,La Liga,37,1984,16.7,18,12,8,8,2,6,17,35.3,11,12,6,6,14,32,11
2461,Stephan El Shaarawy,it,FW,DF,Roma,Serie A,28,1992,11.7,13,8,4,9,0,4,6,66.7,2,10,2,8,11,24,8
2462,Jamie Shackleton,eng,DF,MF,Leeds United,Premier League,21,1999,7.9,27,16,19,7,1,13,25,52.0,12,11,7,4,8,35,12
2463,Xherdan Shaqiri,ch,FW,MF,Lyon,Ligue 1,29,1991,7.5,7,3,0,5,2,2,10,20.0,8,2,0,2,2,9,2
2464,Luke Shaw,eng,DF,,Manchester Utd,Premier League,26,1995,17.8,21,13,9,9,3,12,21,57.1,9,22,11,11,9,30,22
2465,Jonjo Shelvey,eng,MF,,Newcastle Utd,Premier League,29,1992,22.0,30,17,12,18,0,14,34,41.2,20,22,7,15,22,52,20
2466,Aimar Sher,se,MF,,Spezia,Serie A,18,2002,0.5,2,1,1,1,0,0,1,0.0,1,1,0,1,3,5,1
2467,Eldor Shomurodov,uz,FW,MF,Roma,Serie A,26,1995,8.7,5,4,0,4,1,1,10,10.0,9,8,0,8,2,7,5
2468,Shola Shoretire,eng,MF,,Manchester Utd,Premier League,17,2004,0.2,0,0,0,0,0,0,0,,0,0,0,0,0,0,0
2469,Mahame Siby,ml,DF,,Strasbourg,Ligue 1,25,1996,0.2,0,0,0,0,0,0,0,,0,0,0,0,1,1,2
2470,Aboubakar Sidibé,fr,DF,,Clermont Foot,Ligue 1,25,1996,0.1,0,0,0,0,0,0,0,,0,0,0,0,0,0,0
2471,Alassane Sidibe,ci,MF,,Atalanta,Serie A,19,2002,0.1,1,1,1,0,0,0,0,,0,0,0,0,0,1,0
2472,Djibril Sidibé,fr,DF,,Monaco,Ligue 1,29,1992,10.5,24,13,13,8,3,9,24,37.5,15,10,1,9,16,40,13
2473,Kaj Sierhuis,nl,FW,,Reims,Ligue 1,23,1998,0.9,1,1,1,0,0,1,3,33.3,2,0,0,0,0,1,1
2474,Francisco Sierralta,cl,DF,,Watford,Premier League,24,1997,4.7,7,3,7,0,0,5,8,62.5,3,7,2,5,6,13,35
2475,Arnór Sigurðsson,is,FW,MF,Venezia,Serie A,22,1999,2.0,1,1,0,1,0,1,2,50.0,1,2,0,2,1,2,0
2476,Kiliann Sildillia,fr,DF,MF,Freiburg,Bundesliga,19,2002,1.9,7,3,3,4,0,3,6,50.0,3,1,0,1,2,9,7
2477,Adrien Silva,pt,MF,,Sampdoria,Serie A,32,1989,12.0,24,12,14,5,5,9,33,27.3,24,15,5,10,23,47,23
2478,André Silva,pt,FW,,RB Leipzig,Bundesliga,25,1995,23.1,13,9,2,3,8,4,13,30.8,9,20,2,18,2,15,15
2479,Bernardo Silva,pt,MF,FW,Manchester City,Premier League,26,1994,31.7,57,29,19,19,19,31,67,46.3,36,24,2,22,20,77,19
2480,Caio Henrique Oliveira Silva,br,DF,,Monaco,Ligue 1,24,1997,29.6,53,30,31,18,4,28,59,47.5,31,30,6,24,27,80,37
2481,David Silva,es,MF,,Real Sociedad,La Liga,35,1986,19.1,28,17,10,11,7,3,20,15.0,17,13,3,10,7,35,12
2482,Fábio Silva,pt,FW,,Wolves,Premier League,19,2002,6.4,3,2,0,2,1,0,8,0.0,8,2,0,2,1,4,1
2483,Gabriel Silva,br,DF,MF,Saint-Étienne,Ligue 1,30,1991,7.9,12,7,7,2,3,9,13,69.2,4,9,3,6,18,30,13
2484,Jonathan Silva,ar,DF,FW,Getafe,La Liga,27,1994,2.5,10,8,4,4,2,7,12,58.3,5,4,0,4,3,13,7
2485,Rui Silva,pt,GK,,Betis,La Liga,27,1994,21.8,1,0,1,0,0,1,2,50.0,1,0,0,0,1,2,11
2486,Thiago Silva,br,DF,,Chelsea,Premier League,36,1984,29.4,32,21,19,12,1,11,22,50.0,11,54,31,23,44,76,100
2487,Marco Silvestri,it,GK,,Udinese,Serie A,30,1991,35.0,0,0,0,0,0,0,1,0.0,1,0,0,0,1,1,11
2488,Mohamed Simakan,fr,DF,,RB Leipzig,Bundesliga,21,2000,22.3,48,27,25,21,2,27,41,65.9,14,22,11,11,40,88,46
2489,Giovanni Simeone,ar,FW,,Hellas Verona,Serie A,26,1995,29.5,27,15,6,12,9,9,39,23.1,30,37,3,34,6,33,23
2490,Giovanni Simeone,ar,FW,,Cagliari,Serie A,26,1995,0.1,0,0,0,0,0,0,0,,0,0,0,0,0,0,0
2491,Giuliano Simeone,ar,MF,,Atlético Madrid,La Liga,18,2002,0.0,0,0,0,0,0,0,0,,0,0,0,0,0,0,0
2492,Ellis Simms,eng,FW,,Everton,Premier League,20,2001,0.7,0,0,0,0,0,0,0,,0,1,1,0,0,0,1
2493,Moses Simon,ng,FW,MF,Nantes,Ligue 1,26,1995,25.9,17,11,6,5,6,11,23,47.8,12,14,3,11,12,29,5
2494,Unai Simón,es,GK,,Athletic Club,La Liga,24,1997,34.0,0,0,0,0,0,0,0,,0,0,0,0,1,1,5
2495,Xavi Simons,nl,MF,FW,Paris S-G,Ligue 1,18,2003,1.5,1,1,0,1,0,1,2,50.0,1,3,0,3,0,1,0
2496,Wilfried Singo,ci,DF,,Torino,Serie A,20,2000,29.0,55,35,24,24,7,24,34,70.6,10,26,6,20,23,78,47
2497,Daley Sinkgraven,nl,DF,,Leverkusen,Bundesliga,26,1995,3.9,6,2,4,0,2,3,7,42.9,4,3,1,2,3,9,6
2498,Tobias Sippel,de,GK,,Gladbach,Bundesliga,33,1988,1.0,0,0,0,0,0,0,0,,0,0,0,0,0,0,0
2499,Hugo Siquet,be,DF,,Freiburg,Bundesliga,19,2002,0.2,0,0,0,0,0,0,0,,0,0,0,0,0,0,0
2500,Salvatore Sirigu,it,GK,,Genoa,Serie A,34,1987,37.0,1,1,1,0,0,1,2,50.0,1,0,0,0,0,1,19
2501,Issouf Sissokho,ml,MF,,Bordeaux,Ligue 1,19,2002,4.8,17,8,2,13,2,8,17,47.1,9,8,1,7,7,24,0
2502,Ibrahima Sissoko,ml,MF,DF,Strasbourg,Ligue 1,23,1997,25.6,47,23,18,20,9,19,46,41.3,27,32,11,21,35,82,31
2503,Moussa Sissoko,fr,MF,,Watford,Premier League,31,1989,35.8,53,27,27,20,6,28,42,66.7,14,42,13,29,30,83,64
2504,Nelson Sissoko,fr,DF,,Saint-Étienne,Ligue 1,24,1997,0.5,2,0,2,0,0,1,1,100.0,0,0,0,0,0,2,2
2505,Sambou Sissoko,fr,MF,DF,Reims,Ligue 1,22,1999,2.0,12,6,6,4,2,6,8,75.0,2,2,0,2,2,14,7
2506,Antonio Sivera,es,GK,,Alavés,La Liga,24,1996,3.1,0,0,0,0,0,0,1,0.0,1,0,0,0,0,0,0
2507,Ellyes Skhiri,tn,MF,,Köln,Bundesliga,26,1995,20.2,55,33,25,26,4,22,41,53.7,19,41,7,34,37,92,35
2508,Oliver Skipp,eng,MF,,Tottenham,Premier League,20,2000,15.0,33,19,14,18,1,15,31,48.4,16,19,7,12,12,45,10
2509,Leo Skiri Østigård,no,DF,,Genoa,Serie A,21,1999,13.0,16,9,8,7,1,9,11,81.8,2,17,10,7,8,24,55
2510,Łukasz Skorupski,pl,GK,,Bologna,Serie A,30,1991,36.0,0,0,0,0,0,0,1,0.0,1,0,0,0,0,0,17
2511,Andreas Skov Olsen,dk,FW,DF,Bologna,Serie A,21,1999,8.3,12,10,4,4,4,5,11,45.5,6,9,1,8,3,15,11
2512,Robert Skov,dk,FW,DF,Hoffenheim,Bundesliga,25,1996,4.1,3,2,1,1,1,2,9,22.2,7,2,0,2,3,6,3
2513,Milan Škriniar,sk,DF,,Inter,Serie A,26,1995,35.0,47,27,26,17,4,24,42,57.1,18,36,25,11,25,72,90
2514,Islam Slimani,dz,FW,,Lyon,Ligue 1,33,1988,6.4,3,2,0,1,2,1,6,16.7,5,4,0,4,2,5,5
2515,William Smallbone,ie,MF,FW,Southampton,Premier League,21,2000,1.5,4,4,2,2,0,1,3,33.3,2,4,0,4,2,6,0
2516,Chris Smalling,eng,DF,,Roma,Serie A,31,1989,23.2,36,23,28,8,0,18,25,72.0,7,32,24,8,26,62,92
2517,Emile Smith Rowe,eng,MF,FW,Arsenal,Premier League,21,2000,21.3,14,7,7,7,0,4,20,20.0,16,18,1,17,15,29,10
2518,Cédric Soares,pt,DF,,Arsenal,Premier League,29,1991,16.5,38,26,23,9,6,16,25,64.0,9,18,7,11,16,54,31
2519,Danilo Soares,br,DF,,Bochum,Bundesliga,29,1991,28.5,109,71,61,39,9,56,84,66.7,28,63,9,54,62,171,65
2520,Rubén Sobrino,es,MF,,Valencia,La Liga,29,1992,0.2,1,1,1,0,0,1,1,100.0,0,1,0,1,2,3,0
2521,Rubén Sobrino,es,FW,MF,Cádiz,La Liga,29,1992,20.7,28,17,11,10,7,5,35,14.3,30,21,1,20,21,49,18
2522,Alex Sola,es,DF,FW,Real Sociedad,La Liga,22,1999,0.5,1,1,1,0,0,1,3,33.3,2,1,0,1,2,3,3
2523,Augusto Solari,ar,MF,DF,Celta Vigo,La Liga,29,1992,7.9,24,12,9,12,3,12,32,37.5,20,14,4,10,7,31,10
2524,Roberto Soldado,es,FW,,Levante,La Liga,36,1985,7.4,3,1,0,1,2,1,3,33.3,2,4,0,4,1,4,7
2525,Carlos Soler,es,MF,,Valencia,La Liga,24,1997,27.5,29,19,10,15,4,11,37,29.7,26,19,4,15,14,43,28
2526,Yann Sommer,ch,GK,,Gladbach,Bundesliga,32,1988,33.0,0,0,0,0,0,0,2,0.0,2,0,0,0,3,3,8
2527,Son,es,DF,,Levante,La Liga,27,1994,21.9,28,18,16,7,5,17,34,50.0,17,11,5,6,19,47,33
2528,Brandon Soppy,fr,DF,MF,Udinese,Serie A,19,2002,8.6,20,9,8,10,2,11,16,68.8,5,10,2,8,5,25,9
2529,David Soria,es,GK,,Getafe,La Liga,28,1993,37.9,1,0,1,0,0,1,2,50.0,1,0,0,0,0,1,22
2530,Roberto Soriano,it,MF,,Bologna,Serie A,30,1991,29.1,57,30,27,22,8,17,56,30.4,39,37,3,34,22,79,32
2531,Alberto Soro,es,MF,FW,Granada,La Liga,22,1999,6.4,12,10,3,6,3,1,7,14.3,6,21,2,19,3,15,4
2532,Borna Sosa,hr,DF,FW,Stuttgart,Bundesliga,23,1998,27.8,22,12,14,5,3,12,26,46.2,14,30,3,27,26,48,61
2533,Hugo Sotelo,es,FW,,Celta Vigo,La Liga,17,2003,0.0,0,0,0,0,0,0,0,,0,0,0,0,0,0,0
2534,Florian Sotoca,fr,FW,MF,Lens,Ligue 1,30,1990,27.6,31,19,7,20,4,12,51,23.5,39,31,4,27,25,56,41
2535,Riccardo Sottil,it,FW,,Fiorentina,Serie A,22,1999,13.8,9,4,4,4,1,3,9,33.3,6,3,0,3,1,10,2
2536,Tomáš Souček,cz,MF,,West Ham,Premier League,26,1995,34.0,66,32,27,33,6,28,65,43.1,37,34,13,21,52,118,98
2537,Matìas Soulé,ar,FW,,Juventus,Serie A,18,2003,0.1,0,0,0,0,0,0,1,0.0,1,0,0,0,0,0,0
2538,Sambou Soumano,sn,FW,MF,Lorient,Ligue 1,20,2001,5.0,4,1,1,2,1,2,2,100.0,0,3,0,3,1,5,7
2539,Adama Soumaoro,fr,DF,,Bologna,Serie A,29,1992,25.2,15,5,5,8,2,4,9,44.4,5,22,16,6,34,49,95
2540,Boubakary Soumaré,fr,MF,,Leicester City,Premier League,22,1999,12.2,19,13,10,8,1,8,17,47.1,9,13,1,12,14,33,18
2541,Arnaud Souquet,fr,DF,,Montpellier,Ligue 1,29,1992,25.9,56,35,30,17,9,32,65,49.2,33,21,7,14,34,90,60
2542,Djibril Sow,ch,MF,,Eint Frankfurt,Bundesliga,24,1997,26.8,57,33,28,25,4,22,60,36.7,38,35,8,27,50,107,20
2543,Saidou Sow,gn,DF,,Saint-Étienne,Ligue 1,19,2002,11.0,28,17,21,6,1,16,21,76.2,5,15,5,10,23,51,34
2544,Çağlar Söyüncü,tr,DF,,Leicester City,Premier League,25,1996,27.7,47,30,32,12,3,26,42,61.9,16,44,27,17,32,79,115
2545,Leonardo Spinazzola,it,DF,,Roma,Serie A,28,1993,1.4,0,0,0,0,0,0,1,0.0,1,4,1,3,0,0,3
2546,Marco Sportiello,it,GK,,Atalanta,Serie A,29,1992,5.0,0,0,0,0,0,0,0,,0,0,0,0,0,0,2
2547,Tony Springett,ie,MF,FW,Norwich City,Premier League,18,2002,1.6,2,1,1,1,0,1,4,25.0,3,0,0,0,0,2,2
2548,Jerry St. Juste,nl,DF,,Mainz 05,Bundesliga,24,1996,6.7,13,9,7,6,0,7,8,87.5,1,7,3,4,14,27,14
2549,Anton Stach,de,MF,,Mainz 05,Bundesliga,22,1998,20.7,28,19,14,13,1,15,38,39.5,23,24,5,19,51,79,25
2550,Kostas Stafylidis,gr,DF,MF,Bochum,Bundesliga,27,1993,15.4,37,27,22,13,2,20,26,76.9,6,19,6,13,31,68,43
2551,Luca Stanga,it,DF,,Milan,Serie A,19,2002,0.0,1,0,0,1,0,0,0,,0,0,0,0,0,1,0
2552,Josip Stanišić,hr,DF,,Bayern Munich,Bundesliga,21,2000,7.2,21,10,7,12,2,12,18,66.7,6,7,0,7,11,32,10
2553,Niklas Stark,de,DF,,Hertha BSC,Bundesliga,26,1995,22.6,28,16,18,10,0,12,17,70.6,5,27,17,10,36,64,122
2554,Jason Steele,eng,GK,,Brighton,Premier League,30,1990,1.0,0,0,0,0,0,0,0,,0,0,0,0,0,0,0
2555,Jed Steer,eng,GK,,Aston Villa,Premier League,28,1992,1.0,0,0,0,0,0,0,0,,0,0,0,0,0,0,0
2556,Renato Steffen,ch,FW,MF,Wolfsburg,Bundesliga,29,1991,10.7,20,16,10,10,0,9,16,56.3,7,7,0,7,13,33,14
2557,Zack Steffen,us,GK,,Manchester City,Premier League,26,1995,1.0,0,0,0,0,0,0,0,,0,0,0,0,0,0,2
2558,Calvin Stengs,nl,MF,,Nice,Ligue 1,22,1998,11.9,16,7,6,9,1,7,20,35.0,13,10,0,10,8,24,6
2559,Pascal Stenzel,de,DF,,Stuttgart,Bundesliga,25,1996,10.0,24,11,15,5,4,17,33,51.5,16,13,3,10,11,35,25
2560,Dale Stephens,eng,MF,,Burnley,Premier League,32,1989,1.4,4,1,0,3,1,3,8,37.5,5,4,1,3,1,5,1
2561,Jack Stephens,eng,DF,,Southampton,Premier League,27,1994,9.0,19,12,13,5,1,6,16,37.5,10,12,7,5,19,38,42
2562,Raheem Sterling,eng,FW,,Manchester City,Premier League,26,1994,23.6,23,10,3,11,9,10,23,43.5,13,12,0,12,12,35,3
2563,Finley Stevens,wls,DF,,Brentford,Premier League,18,2003,0.2,3,1,0,3,0,1,1,100.0,0,0,0,0,0,3,0
2564,Angelo Stiller,de,MF,,Hoffenheim,Bundesliga,20,2001,18.8,30,17,11,15,4,9,23,39.1,14,32,6,26,9,39,16
2565,Lars Stindl,de,MF,FW,Gladbach,Bundesliga,32,1988,18.1,23,15,6,14,3,9,33,27.3,24,28,2,26,10,33,14
2566,Riccardo Stivanello,it,DF,,Bologna,Serie A,17,2004,0.5,1,1,1,0,0,1,1,100.0,0,2,2,0,0,1,6
2567,Kevin Stöger,at,MF,,Mainz 05,Bundesliga,27,1993,4.7,10,5,5,5,0,4,10,40.0,6,6,0,6,5,15,1
2568,Petar Stojanović,si,DF,,Empoli,Serie A,25,1995,30.4,96,63,55,32,9,59,114,51.8,55,39,13,26,27,123,65
2569,John Stones,eng,DF,,Manchester City,Premier League,27,1994,12.4,5,3,3,2,0,2,3,66.7,1,3,3,0,11,16,27
2570,Thomas Strakosha,al,GK,,Lazio,Serie A,26,1995,23.0,0,0,0,0,0,0,0,,0,0,0,0,0,0,7
2571,Stefan Strandberg,no,DF,,Salernitana,Serie A,31,1990,10.4,13,8,10,3,0,8,11,72.7,3,15,13,2,9,22,49
2572,Dávid Strelec,sk,FW,MF,Spezia,Serie A,20,2001,5.6,4,4,1,2,1,2,9,22.2,7,8,1,7,2,6,1
2573,Tobias Strobl,de,MF,DF,Augsburg,Bundesliga,31,1990,3.6,8,3,3,5,0,3,11,27.3,8,7,2,5,7,15,3
2574,Kevin Strootman,nl,MF,,Cagliari,Serie A,31,1990,7.1,8,4,2,4,2,5,12,41.7,7,11,2,9,10,18,15
2575,Pascal Struijk,nl,DF,MF,Leeds United,Premier League,21,1999,22.8,61,39,34,23,4,30,50,60.0,20,35,23,12,33,94,60
2576,Jens Stryger Larsen,dk,DF,,Udinese,Serie A,30,1991,7.6,5,2,3,1,1,2,3,66.7,1,2,0,2,4,9,17
2577,Leo Štulac,si,MF,,Empoli,Serie A,26,1994,9.3,13,6,5,6,2,7,19,36.8,12,6,2,4,8,21,15
2578,Stefano Sturaro,it,MF,,Genoa,Serie A,28,1993,19.6,43,26,16,16,11,22,48,45.8,26,25,1,24,15,58,29
2579,Damián Suárez,uy,DF,,Getafe,La Liga,33,1988,30.1,74,47,34,30,10,42,91,46.2,49,46,5,41,31,105,30
2580,Denis Suárez,es,MF,,Celta Vigo,La Liga,27,1994,31.3,61,29,20,33,8,25,82,30.5,57,32,4,28,16,77,11
2581,Luis Suárez,uy,FW,,Atlético Madrid,La Liga,34,1987,20.4,8,5,2,4,2,2,10,20.0,8,8,1,7,1,9,14
2582,Mario Suárez,es,DF,,Rayo Vallecano,La Liga,34,1987,7.9,9,4,7,2,0,3,9,33.3,6,6,4,2,7,16,37
2583,Isaac Success,ng,FW,MF,Udinese,Serie A,25,1996,10.1,5,2,0,3,2,1,5,20.0,4,2,0,2,2,7,6
2584,Niklas Süle,de,DF,,Bayern Munich,Bundesliga,25,1995,20.4,29,23,21,7,1,18,24,75.0,6,16,12,4,28,57,49
2585,Kamaldeen Sulemana,gh,MF,FW,Rennes,Ligue 1,19,2002,11.3,23,12,7,9,7,10,17,58.8,7,10,1,9,4,27,5
2586,Crysencio Summerville,nl,MF,FW,Leeds United,Premier League,19,2001,1.4,5,3,1,1,3,2,3,66.7,1,2,0,2,2,7,0
2587,Vladyslav Supriaha,ua,FW,,Sampdoria,Serie A,21,2000,0.2,0,0,0,0,0,0,1,0.0,1,0,0,0,0,0,0
2588,Suso,es,FW,,Sevilla,La Liga,27,1993,4.3,4,3,1,3,0,3,13,23.1,10,4,0,4,0,4,0
2589,Bosko Sutalo,hr,DF,,Hellas Verona,Serie A,21,2000,10.2,20,13,11,6,3,8,16,50.0,8,10,5,5,17,37,39
2590,Mattias Svanberg,se,MF,,Bologna,Serie A,22,1999,28.5,39,15,15,16,8,16,54,29.6,38,31,9,22,28,67,34
2591,Michael Svoboda,at,DF,,Venezia,Serie A,22,1998,13.7,33,17,26,6,1,18,32,56.3,14,27,15,12,10,43,61
2592,Abdoulaye Sylla,gn,DF,,Nantes,Ligue 1,21,2000,1.7,4,4,2,1,1,2,4,50.0,2,5,3,2,1,5,3
2593,Mamadou Sylla,sn,FW,MF,Alavés,La Liga,27,1994,4.4,2,2,0,1,1,0,1,0.0,1,0,0,0,1,3,5
2594,Mamadou Sylla,sn,FW,,Rayo Vallecano,La Liga,27,1994,2.8,1,1,1,0,0,0,1,0.0,1,2,0,2,4,5,3
2595,Ádám Szalai,hu,FW,,Mainz 05,Bundesliga,33,1987,2.9,3,2,0,2,1,0,2,0.0,2,2,0,2,0,3,0
2596,Wojciech Szczęsny,pl,GK,,Juventus,Serie A,31,1990,33.0,1,1,1,0,0,1,2,50.0,1,0,0,0,0,1,8
2597,Dominik Szoboszlai,hu,MF,FW,RB Leipzig,Bundesliga,20,2000,17.1,17,12,5,9,3,8,27,29.6,19,30,3,27,10,27,15
2598,Jakob Sørensen,dk,MF,DF,Norwich City,Premier League,23,1998,6.7,22,11,6,14,2,10,20,50.0,10,7,3,4,10,32,19
2599,Alexander Sørloth,no,FW,,Real Sociedad,La Liga,25,1995,19.6,20,7,4,10,6,7,17,41.2,10,14,1,13,4,24,15
2600,Tachi,es,DF,,Alavés,La Liga,23,1997,2.7,6,3,3,3,0,5,7,71.4,2,4,3,1,1,7,9
2601,Jonathan Tah,de,DF,,Leverkusen,Bundesliga,25,1996,32.0,25,18,19,5,1,17,33,51.5,16,31,20,11,43,68,156
2602,Waniss Taibi,fr,MF,FW,Angers,Ligue 1,19,2002,1.5,8,7,4,4,0,2,4,50.0,2,0,0,0,1,9,1
2603,Flavien Tait,fr,MF,,Rennes,Ligue 1,28,1993,23.6,28,19,13,9,6,13,40,32.5,27,15,4,11,19,47,13
2604,Adrien Tameze,cm,MF,DF,Hellas Verona,Serie A,27,1994,28.6,52,29,24,21,7,20,59,33.9,39,40,5,35,52,104,41
2605,Japhet Tanganga,eng,DF,,Tottenham,Premier League,22,1999,8.2,14,8,7,6,1,9,19,47.4,10,13,5,8,9,23,31
2606,Renato Tapia,pe,MF,,Celta Vigo,La Liga,26,1995,15.7,50,31,15,31,4,20,50,40.0,30,21,5,16,28,78,43
2607,Edmond Tapsoba,bf,DF,,Leverkusen,Bundesliga,22,1999,20.2,35,17,24,10,1,20,32,62.5,12,27,15,12,29,64,72
2608,Florian Tardieu,fr,MF,,Troyes,Ligue 1,29,1992,29.2,58,25,31,21,6,31,71,43.7,40,31,9,22,42,100,38
2609,Matt Targett,eng,DF,,Aston Villa,Premier League,25,1995,15.9,34,18,28,5,1,24,45,53.3,21,16,9,7,23,57,35
2610,Matt Targett,eng,DF,,Newcastle Utd,Premier League,25,1995,16.0,41,26,26,14,1,24,37,64.9,13,15,4,11,25,66,39
2611,Oussama Targhalline,ma,FW,,Marseille,Ligue 1,19,2002,0.1,0,0,0,0,0,0,0,,0,0,0,0,0,0,0
2612,James Tarkowski,eng,DF,,Burnley,Premier League,28,1992,34.5,65,45,47,17,1,33,47,70.2,14,75,61,14,48,113,186
2613,Ciprian Tătărușanu,ro,GK,,Milan,Serie A,35,1986,6.0,0,0,0,0,0,0,1,0.0,1,0,0,0,0,0,2
2614,Niklas Tauer,de,DF,MF,Mainz 05,Bundesliga,20,2001,5.4,16,9,9,7,0,9,14,64.3,5,6,2,4,9,25,14
2615,Nuno Tavares,pt,DF,,Arsenal,Premier League,21,2000,13.1,21,14,10,7,4,8,18,44.4,10,15,5,10,9,30,33
2616,Charlie Taylor,eng,DF,,Burnley,Premier League,27,1993,30.3,45,26,31,11,3,26,44,59.1,18,42,20,22,58,103,95
2617,Loum Tchaouna,fr,FW,MF,Rennes,Ligue 1,17,2003,1.0,3,1,1,2,0,1,5,20.0,4,0,0,0,2,5,0
2618,Enzo Tchato,cm,FW,,Montpellier,Ligue 1,18,2002,0.1,0,0,0,0,0,0,0,,0,0,0,0,0,0,1
2619,Warren Tchimbembé,cg,MF,,Metz,Ligue 1,23,1998,2.3,1,1,0,1,0,0,1,0.0,1,2,1,1,2,3,2
2620,Aurélien Tchouaméni,fr,MF,,Monaco,Ligue 1,21,2000,32.5,86,45,33,49,4,29,55,52.7,26,39,7,32,101,187,34
2621,Mathys Tel,fr,FW,MF,Rennes,Ligue 1,16,2005,0.6,2,1,1,1,0,0,0,,0,0,0,0,1,3,2
2622,Jordan Tell,gp,FW,,Clermont Foot,Ligue 1,24,1997,3.2,5,5,0,3,2,1,4,25.0,3,3,0,3,0,5,1
2623,Nathan Tella,ng,MF,FW,Southampton,Premier League,22,1999,8.9,13,9,5,7,1,6,17,35.3,11,13,0,13,6,19,9
2624,Alex Telles,br,DF,,Manchester Utd,Premier League,28,1992,18.4,48,27,35,9,4,27,43,62.8,16,17,4,13,26,74,45
2625,Cristian Tello,es,FW,,Betis,La Liga,29,1991,9.1,17,11,6,7,4,13,31,41.9,18,9,0,9,10,27,6
2626,Nahuel Tenaglia,ar,DF,,Alavés,La Liga,25,1996,11.9,42,27,30,9,3,24,37,64.9,13,10,2,8,26,68,42
2627,Marc Tenas,es,FW,MF,Alavés,La Liga,20,2001,0.6,1,1,1,0,0,1,1,100.0,0,1,0,1,0,1,0
2628,Marc-André ter Stegen,de,GK,,Barcelona,La Liga,29,1992,35.0,0,0,0,0,0,0,1,0.0,1,0,0,0,1,1,13
2629,Filippo Terracciano,it,DF,,Hellas Verona,Serie A,18,2003,0.1,0,0,0,0,0,0,0,,0,0,0,0,0,0,1
2630,Pietro Terracciano,it,GK,,Fiorentina,Serie A,31,1990,31.8,0,0,0,0,0,0,4,0.0,4,0,0,0,2,2,20
2631,Martin Terrier,fr,FW,MF,Rennes,Ligue 1,24,1997,30.9,55,33,22,16,17,25,43,58.1,18,29,3,26,18,73,17
2632,Aleksa Terzić,rs,DF,,Fiorentina,Serie A,21,1999,3.0,8,5,3,3,2,4,7,57.1,3,7,0,7,4,12,5
2633,Robert Tesche,de,MF,,Bochum,Bundesliga,34,1987,3.9,6,4,4,1,1,5,7,71.4,2,6,2,4,5,11,5
2634,Tanner Tessmann,us,MF,,Venezia,Serie A,19,2001,7.6,11,5,4,6,1,5,14,35.7,9,19,9,10,5,16,22
2635,Tetê,br,FW,MF,Lyon,Ligue 1,21,2000,6.5,10,5,4,5,1,3,13,23.1,10,4,0,4,3,13,1
2636,Cedric Teuchert,de,MF,FW,Union Berlin,Bundesliga,24,1997,1.2,3,2,3,0,0,2,6,33.3,4,1,0,1,0,3,0
2637,Arthur Theate,be,DF,,Bologna,Serie A,21,2000,26.9,33,19,26,3,4,14,31,45.2,17,29,16,13,42,75,69
2638,Jan Thielmann,de,MF,FW,Köln,Bundesliga,19,2002,13.2,24,16,6,12,6,8,23,34.8,15,23,2,21,10,34,11
2639,Sada Thioub,sn,FW,,Angers,Ligue 1,26,1995,0.0,0,0,0,0,0,0,0,,0,0,0,0,0,0,0
2640,Sada Thioub,sn,DF,MF,Saint-Étienne,Ligue 1,26,1995,10.6,13,8,5,8,0,6,14,42.9,8,9,0,9,10,23,8
2641,Luke Thomas,eng,DF,,Leicester City,Premier League,20,2001,21.2,50,31,33,13,4,28,65,43.1,37,35,14,21,40,90,55
2642,Romain Thomas,fr,DF,,Angers,Ligue 1,33,1988,28.5,49,37,28,21,0,30,57,52.6,27,35,19,16,44,93,126
2643,Adrien Thomasson,fr,MF,,Strasbourg,Ligue 1,27,1993,26.5,64,31,18,27,19,30,93,32.3,63,56,4,52,29,93,16
2644,Erik Thommy,de,FW,MF,Stuttgart,Bundesliga,26,1994,3.0,2,0,0,2,0,1,2,50.0,1,3,0,3,4,6,0
2645,Dominic Thompson,eng,DF,,Brentford,Premier League,21,2000,1.6,1,0,1,0,0,0,1,0.0,1,2,2,0,2,3,3
2646,Morten Thorsby,no,MF,,Sampdoria,Serie A,25,1996,32.7,46,26,15,23,8,28,56,50.0,28,37,12,25,25,71,39
2647,Matheus Thuler,br,DF,,Montpellier,Ligue 1,22,1999,9.5,21,12,17,4,0,8,15,53.3,7,9,7,2,9,30,30
2648,Khéphren Thuram,fr,MF,,Nice,Ligue 1,20,2001,21.1,33,19,11,18,4,17,35,48.6,18,31,11,20,28,61,19
2649,Marcus Thuram,fr,FW,,Gladbach,Bundesliga,23,1997,10.9,6,5,0,5,1,1,4,25.0,3,5,0,5,5,11,5
2650,Alexis Tibidi,fr,MF,FW,Stuttgart,Bundesliga,17,2003,4.3,7,3,1,3,3,3,4,75.0,1,4,0,4,3,10,2
2651,Cheikh Tidiane Sabaly,sn,FW,MF,Metz,Ligue 1,22,1999,1.7,6,3,1,4,1,2,2,100.0,0,1,0,1,0,6,1
2652,Youri Tielemans,be,MF,,Leicester City,Premier League,24,1997,29.2,74,38,23,45,6,42,100,42.0,58,47,13,34,21,95,41
2653,Kieran Tierney,sct,DF,,Arsenal,Premier League,24,1997,21.3,18,14,11,7,0,10,11,90.9,1,23,5,18,15,33,54
2654,Steffen Tigges,de,FW,MF,Dortmund,Bundesliga,23,1998,1.2,4,3,1,2,1,2,3,66.7,1,3,1,2,0,4,3
2655,Malik Tillman,us,FW,MF,Bayern Munich,Bundesliga,19,2002,1.2,2,1,0,1,1,0,1,0.0,1,5,1,4,2,4,1
2656,Timmy Tillman,de,MF,,Greuther Fürth,Bundesliga,22,1999,22.3,43,26,17,18,8,19,42,45.2,23,33,4,29,12,55,26
2657,David Timor,es,MF,,Getafe,La Liga,31,1989,3.8,1,1,1,0,0,0,3,0.0,3,3,2,1,1,2,4
2658,Mircea Ţîrlea,ro,DF,,Alavés,La Liga,21,2000,0.2,0,0,0,0,0,0,0,,0,0,0,0,0,0,1
2659,Jean-Clair Todibo,fr,DF,,Nice,Ligue 1,21,1999,34.6,59,37,43,15,1,39,60,65.0,21,45,21,24,51,110,130
2660,Umut Tohumcu,de,MF,,Hoffenheim,Bundesliga,16,2004,0.1,0,0,0,0,0,0,0,,0,0,0,0,0,0,0
2661,Karl Toko Ekambi,cm,FW,,Lyon,Ligue 1,28,1992,25.5,13,7,4,6,3,4,21,19.0,17,26,0,26,20,33,5
2662,Corentin Tolisso,fr,MF,,Bayern Munich,Bundesliga,26,1994,7.8,11,5,1,9,1,7,17,41.2,10,5,1,4,9,20,10
2663,Jeremy Toljan,de,DF,,Sassuolo,Serie A,26,1994,15.5,18,10,12,4,2,13,20,65.0,7,12,5,7,12,30,41
2664,Rafael Tolói,it,DF,,Atalanta,Serie A,30,1990,16.0,38,15,12,15,11,24,39,61.5,15,23,11,12,26,64,35
2665,Raúl de Tomás,es,FW,,Espanyol,La Liga,26,1994,32.4,15,11,6,7,2,6,17,35.3,11,12,3,9,6,21,42
2666,Tiago Tomás,pt,FW,,Stuttgart,Bundesliga,19,2002,11.9,8,4,0,7,1,0,6,0.0,6,3,0,3,4,12,1
2667,Takehiro Tomiyasu,jp,DF,,Arsenal,Premier League,22,1998,18.7,35,17,19,13,3,21,32,65.6,11,22,3,19,24,59,64
2668,Takehiro Tomiyasu,jp,DF,,Bologna,Serie A,22,1998,0.1,0,0,0,0,0,0,0,,0,1,0,1,1,1,0
2669,James Tomkins,eng,DF,,Crystal Palace,Premier League,32,1989,6.1,8,3,6,2,0,6,8,75.0,2,8,8,0,4,12,18
2670,Fikayo Tomori,eng,DF,,Milan,Serie A,23,1997,30.2,73,44,36,34,3,18,26,69.2,8,37,23,14,45,118,84
2671,Sandro Tonali,it,MF,,Milan,Serie A,21,2000,28.9,54,37,23,25,6,21,41,51.2,20,26,8,18,34,88,19
2672,Lorenzo Tonelli,it,DF,,Empoli,Serie A,31,1990,9.7,17,9,11,4,2,6,13,46.2,7,14,8,6,19,36,28
2673,Ivan Toney,eng,FW,,Brentford,Premier League,25,1996,32.3,33,21,5,20,8,12,38,31.6,26,16,2,14,14,47,44
2674,Ernesto Torregrossa,ve,FW,,Sampdoria,Serie A,29,1992,1.3,2,1,1,0,1,1,2,50.0,1,0,0,0,0,2,1
2675,Lucas Torreira,uy,MF,,Fiorentina,Serie A,25,1996,24.4,37,29,13,21,3,18,40,45.0,22,18,1,17,26,63,18
2676,Raúl Torrente,es,DF,,Granada,La Liga,19,2001,14.2,31,21,18,11,2,16,29,55.2,13,14,9,5,12,43,69
2677,Ferrán Torres,es,FW,,Manchester City,Premier League,21,2000,3.4,2,2,0,1,1,0,3,0.0,3,2,0,2,0,2,1
2678,Ferrán Torres,es,FW,,Barcelona,La Liga,21,2000,15.7,10,5,3,4,3,3,7,42.9,4,12,3,9,6,16,7
2679,Óliver Torres,es,MF,FW,Sevilla,La Liga,26,1994,11.2,22,12,8,7,7,8,25,32.0,17,10,1,9,6,28,4
2680,Pau Torres,es,DF,,Villarreal,La Liga,24,1997,31.7,32,19,23,7,2,18,25,72.0,7,32,23,9,19,51,105
2681,Roberto Torres,es,MF,FW,Osasuna,La Liga,32,1989,9.0,7,4,3,1,3,3,15,20.0,12,8,0,8,8,15,4
2682,Lucas Torró,es,MF,,Osasuna,La Liga,27,1994,30.3,71,40,25,38,8,29,57,50.9,28,32,11,21,47,118,55
2683,Jordan Torunarigha,de,DF,,Hertha BSC,Bundesliga,23,1997,5.4,4,1,1,3,0,4,5,80.0,1,4,2,2,17,21,30
2684,Cenk Tosun,tr,MF,,Everton,Premier League,30,1991,0.1,0,0,0,0,0,0,0,,0,0,0,0,0,0,0
2685,Abdoulaye Touré,gn,MF,,Genoa,Serie A,27,1994,4.8,12,4,3,8,1,5,11,45.5,6,6,1,5,4,16,6
2686,Almamy Touré,ml,DF,MF,Eint Frankfurt,Bundesliga,25,1996,5.6,12,9,8,3,1,4,17,23.5,13,10,3,7,5,17,19
2687,Lucas Tousart,fr,MF,,Hertha BSC,Bundesliga,24,1997,21.8,42,25,15,22,5,10,34,29.4,24,30,6,24,35,77,55
2688,Yoann Touzghar,tn,FW,,Troyes,Ligue 1,34,1986,16.2,5,2,1,3,1,1,3,33.3,2,3,1,2,3,8,8
2689,Andros Townsend,eng,MF,FW,Everton,Premier League,30,1991,16.2,31,17,15,6,10,15,40,37.5,25,28,2,26,14,45,6
2690,Adama Traoré,es,FW,MF,Wolves,Premier League,25,1996,11.9,8,3,6,0,2,3,7,42.9,4,4,1,3,2,10,1
2691,Adama Traoré,es,FW,,Barcelona,La Liga,25,1996,4.2,4,2,0,3,1,3,5,60.0,2,2,0,2,4,8,3
2692,Amadou Traore,fr,FW,,Bordeaux,Ligue 1,19,2002,0.2,0,0,0,0,0,0,0,,0,0,0,0,0,0,0
2693,Bertrand Traoré,bf,MF,FW,Aston Villa,Premier League,25,1995,2.4,3,3,0,1,2,1,2,50.0,1,0,0,0,0,3,1
2694,Boubacar Traoré,ml,MF,,Metz,Ligue 1,19,2001,19.2,43,26,18,23,2,10,39,25.6,29,29,5,24,25,68,11
2695,Charles Traore,ml,DF,,Nantes,Ligue 1,29,1992,8.0,16,12,10,4,2,2,13,15.4,11,11,4,7,15,31,30
2696,Hamari Traoré,ml,DF,,Rennes,Ligue 1,29,1992,32.1,63,36,25,26,12,41,59,69.5,18,29,8,21,37,100,81
2697,Ismaël Traoré,ci,DF,,Angers,Ligue 1,34,1986,35.7,28,17,16,11,1,13,28,46.4,15,25,17,8,44,72,122
2698,Kevin Trapp,de,GK,,Eint Frankfurt,Bundesliga,31,1990,32.0,0,0,0,0,0,0,1,0.0,1,0,0,0,1,1,13
2699,Miguel Trauco,pe,DF,MF,Saint-Étienne,Ligue 1,28,1992,12.4,25,18,16,8,1,12,22,54.5,10,13,4,9,23,48,17
2700,Óscar Trejo,ar,MF,,Rayo Vallecano,La Liga,33,1988,22.3,42,24,14,18,10,15,50,30.0,35,26,1,25,13,55,11
2701,Trézéguet,eg,FW,,Aston Villa,Premier League,26,1994,0.1,0,0,0,0,0,0,0,,0,0,0,0,0,0,0
2702,Manu Trigueros,es,MF,FW,Villarreal,La Liga,29,1991,24.2,45,25,16,18,11,23,66,34.8,43,19,3,16,13,58,17
2703,Simone Trimboli,it,MF,,Sampdoria,Serie A,19,2002,0.7,2,1,2,0,0,2,2,100.0,0,0,0,0,2,4,0
2704,Christopher Trimmel,at,DF,FW,Union Berlin,Bundesliga,34,1987,22.1,49,30,25,19,5,26,45,57.8,19,20,3,17,34,83,75
2705,Francisco Trincão,pt,FW,MF,Wolves,Premier League,21,1999,14.8,28,15,9,13,6,3,19,15.8,16,17,1,16,12,40,1
2706,Kieran Trippier,eng,DF,,Newcastle Utd,Premier League,30,1990,4.8,17,10,8,8,1,10,16,62.5,6,10,3,7,10,27,10
2707,Kieran Trippier,eng,DF,FW,Atlético Madrid,La Liga,30,1990,10.8,22,12,12,5,5,12,21,57.1,9,12,1,11,10,32,11
2708,William Troost-Ekong,ng,DF,,Watford,Premier League,27,1993,15.4,18,9,11,6,1,10,15,66.7,5,24,14,10,7,25,82
2709,Leandro Trossard,be,FW,MF,Brighton,Premier League,26,1994,31.2,34,20,12,9,13,4,31,12.9,27,33,4,29,15,49,10
2710,Adrien Truffert,fr,DF,,Rennes,Ligue 1,19,2001,18.2,29,21,17,9,3,11,24,45.8,13,25,5,20,19,48,30
2711,Philipp Tschauner,de,GK,,RB Leipzig,Bundesliga,35,1985,0.0,0,0,0,0,0,0,0,,0,0,0,0,0,0,0
2712,Kostas Tsimikas,gr,DF,,Liverpool,Premier League,25,1996,9.7,27,12,12,8,7,12,16,75.0,4,6,2,4,10,37,22
2713,Axel Tuanzebe,cd,DF,,Aston Villa,Premier League,23,1997,5.6,5,3,3,2,0,2,5,40.0,3,5,4,1,5,10,12
2714,Axel Tuanzebe,cd,DF,,Napoli,Serie A,23,1997,0.1,0,0,0,0,0,0,0,,0,1,1,0,0,0,0
2715,Ozan Tufan,tr,MF,,Watford,Premier League,26,1995,3.7,3,2,1,1,1,1,5,20.0,4,2,0,2,2,5,4
2716,Beñat Turrientes,es,MF,,Real Sociedad,La Liga,19,2002,2.3,0,0,0,0,0,0,4,0.0,4,1,0,1,2,2,2
2717,Tuta,br,DF,,Eint Frankfurt,Bundesliga,22,1999,24.3,46,28,20,22,4,26,47,55.3,21,43,15,28,41,87,76
2718,Christos Tzolis,gr,FW,MF,Norwich City,Premier League,19,2002,3.7,5,3,3,1,1,2,9,22.2,7,3,0,3,1,6,1
2719,Destiny Udogie,it,DF,,Udinese,Serie A,18,2002,27.5,64,40,30,27,7,33,60,55.0,27,39,6,33,27,91,42
2720,Matthieu Udol,fr,DF,,Metz,Ligue 1,25,1996,11.2,23,14,11,10,2,12,18,66.7,6,20,7,13,31,54,29
2721,Ike Ugbo,ca,FW,,Troyes,Ligue 1,22,1998,9.0,3,1,0,1,2,0,1,0.0,1,4,1,3,2,5,1
2722,Lesley Ugochukwu,fr,MF,,Rennes,Ligue 1,17,2004,4.5,13,9,5,5,3,9,19,47.4,10,7,2,5,4,17,2
2723,Hwang Ui-jo,kr,FW,,Bordeaux,Ligue 1,28,1992,27.9,10,4,4,4,2,4,13,30.8,9,9,1,8,5,15,18
2724,Anthony Ujah,ng,FW,MF,Union Berlin,Bundesliga,30,1990,0.4,0,0,0,0,0,0,0,,0,0,0,0,0,0,0
2725,Maximilian Ullmann,at,DF,,Venezia,Serie A,25,1996,2.7,0,0,0,0,0,0,1,0.0,1,4,0,4,2,2,7
2726,Sven Ulreich,de,GK,,Bayern Munich,Bundesliga,32,1988,6.0,0,0,0,0,0,0,0,,0,0,0,0,0,0,1
2727,Samuel Umtiti,fr,DF,,Barcelona,La Liga,27,1993,1.0,2,2,2,0,0,1,2,50.0,1,1,1,0,0,2,4
2728,Enes Ünal,tr,FW,,Getafe,La Liga,24,1997,31.1,37,22,2,18,17,5,42,11.9,37,25,5,20,5,42,36
2729,Cengiz Ünder,tr,FW,MF,Marseille,Ligue 1,24,1997,24.4,18,13,5,6,7,5,18,27.8,13,13,2,11,14,32,9
2730,Dayot Upamecano,fr,DF,,Bayern Munich,Bundesliga,22,1998,24.6,66,42,42,21,3,24,36,66.7,12,20,10,10,32,98,71
2731,Benjamin Uphoff,de,GK,,Freiburg,Bundesliga,27,1993,2.0,0,0,0,0,0,0,0,,0,0,0,0,0,0,2
2732,Kacper Urbanski,pl,MF,,Bologna,Serie A,16,2004,0.5,3,2,1,2,0,2,2,100.0,0,2,0,2,0,3,0
2733,Jere Uronen,fi,DF,,Brest,Ligue 1,27,1994,9.8,28,15,15,10,3,14,24,58.3,10,12,3,9,16,44,21
2734,Mark Uth,de,MF,FW,Köln,Bundesliga,29,1991,22.5,32,20,9,14,9,15,49,30.6,34,27,1,26,14,46,13
2735,Myrto Uzuni,al,FW,MF,Granada,La Liga,26,1995,9.5,7,4,6,1,0,0,2,0.0,2,13,1,12,10,17,7
2736,Antonio Vacca,it,MF,,Venezia,Serie A,31,1990,11.8,36,20,24,10,2,14,36,38.9,22,16,8,8,20,56,16
2737,Álvaro Vadillo,es,DF,MF,Espanyol,La Liga,26,1994,0.1,1,1,1,0,0,1,2,50.0,1,0,0,0,0,1,1
2738,Óscar Valentín,es,MF,,Rayo Vallecano,La Liga,26,1994,28.5,102,53,46,51,5,44,105,41.9,61,56,10,46,39,141,43
2739,Germán Valera,es,FW,,Real Sociedad,La Liga,19,2002,0.6,3,2,3,0,0,1,1,100.0,0,0,0,0,0,3,1
2740,Yan Valery,tn,DF,,Southampton,Premier League,22,1999,4.1,8,6,4,3,1,4,9,44.4,5,6,3,3,6,14,19
2741,Martin Valjent,sk,DF,,Mallorca,La Liga,25,1995,35.3,31,19,18,12,1,13,24,54.2,11,34,26,8,31,62,173
2742,Jesús Vallejo,es,DF,,Real Madrid,La Liga,24,1997,3.8,7,5,7,0,0,5,6,83.3,1,9,8,1,6,13,16
2743,Manu Vallejo,es,MF,FW,Alavés,La Liga,24,1997,4.1,8,2,1,4,3,4,13,30.8,9,7,0,7,0,8,4
2744,Manu Vallejo,es,FW,MF,Valencia,La Liga,24,1997,1.1,2,1,1,1,0,0,1,0.0,1,0,0,0,0,2,1
2745,Federico Valverde,uy,MF,,Real Madrid,La Liga,23,1998,20.4,36,16,11,16,9,12,31,38.7,19,23,5,18,24,60,12
2746,Virgil van Dijk,nl,DF,,Liverpool,Premier League,30,1991,34.0,16,10,11,5,0,11,16,68.8,5,21,14,7,31,47,109
2747,Vanderson,br,FW,DF,Monaco,Ligue 1,20,2001,12.4,35,19,10,19,6,15,23,65.2,8,17,4,13,13,48,12
2748,Zinho Vanheusden,be,DF,,Genoa,Serie A,22,1999,11.0,18,6,12,5,1,8,14,57.1,6,19,14,5,23,41,42
2749,Jonathan Varane,mq,MF,,Lens,Ligue 1,19,2001,0.0,0,0,0,0,0,0,0,,0,0,0,0,0,0,0
2750,Raphaël Varane,fr,DF,,Manchester Utd,Premier League,28,1993,20.3,28,19,21,6,1,10,22,45.5,12,18,9,9,18,46,82
2751,Jamie Vardy,eng,FW,,Leicester City,Premier League,34,1987,20.1,6,5,0,4,2,1,7,14.3,6,9,0,9,1,7,17
2752,Ruben Vargas,ch,MF,FW,Augsburg,Bundesliga,22,1998,22.0,28,21,7,14,7,11,30,36.7,19,9,1,8,16,44,13
2753,Sebastian Vasiliadis,gr,MF,,Arminia,Bundesliga,23,1997,13.3,31,17,12,15,4,15,42,35.7,27,15,2,13,25,56,31
2754,Johan Vásquez,mx,DF,,Genoa,Serie A,22,1998,25.3,79,46,44,32,3,48,75,64.0,27,32,10,22,42,121,85
2755,Denis Vavro,sk,DF,,Lazio,Serie A,25,1996,0.1,0,0,0,0,0,0,0,,0,0,0,0,0,0,0
2756,José Luis García Vayá,es,MF,,Levante,La Liga,22,1998,22.4,46,27,10,31,5,16,41,39.0,25,24,5,19,38,84,30
2757,Jesus Vazquez,es,DF,,Valencia,La Liga,18,2003,9.0,24,13,10,8,6,10,22,45.5,12,16,3,13,9,33,19
2758,Kevin Vázquez,es,DF,,Celta Vigo,La Liga,28,1993,14.8,34,24,12,13,9,14,28,50.0,14,20,7,13,36,70,34
2759,Lucas Vázquez,es,DF,,Real Madrid,La Liga,30,1991,20.4,43,22,24,9,10,17,35,48.6,18,25,7,18,20,63,41
2760,Matías Vecino,uy,MF,,Inter,Serie A,29,1991,4.2,7,5,2,3,2,3,9,33.3,6,10,1,9,4,11,7
2761,Gabriel Veiga,es,MF,,Celta Vigo,La Liga,19,2002,1.2,5,4,0,4,1,3,12,25.0,9,2,0,2,4,9,1
2762,Miguel Veloso,pt,MF,,Hellas Verona,Serie A,35,1986,14.9,23,15,4,17,2,10,16,62.5,6,18,5,13,11,34,18
2763,Joël Veltman,nl,DF,,Brighton,Premier League,29,1992,31.9,74,48,47,21,6,21,53,39.6,32,46,16,30,45,119,89
2764,Micky van de Ven,nl,DF,,Wolfsburg,Bundesliga,20,2001,2.1,4,4,3,1,0,0,1,0.0,1,4,1,3,2,6,8
2765,Unai Vencedor Paris,es,MF,,Athletic Club,La Liga,20,2000,26.5,26,11,11,9,6,8,42,19.0,34,31,13,18,19,45,22
2766,Lorenzo Venuti,it,DF,,Fiorentina,Serie A,26,1995,17.5,25,10,13,10,2,14,24,58.3,10,13,4,9,5,30,27
2767,Daniele Verde,it,FW,MF,Spezia,Serie A,25,1996,21.7,11,4,8,2,1,9,20,45.0,11,17,2,15,18,29,8
2768,Simone Verdi,it,MF,FW,Torino,Serie A,29,1992,0.5,1,1,0,1,0,0,0,,0,0,0,0,0,1,0
2769,Simone Verdi,it,FW,MF,Salernitana,Serie A,29,1992,9.2,12,8,5,2,5,9,20,45.0,11,4,0,4,3,15,1
2770,Gonzalo Verdú,es,DF,,Elche,La Liga,32,1988,15.5,19,9,15,4,0,8,16,50.0,8,20,14,6,13,32,59
2771,Jordan Veretout,fr,MF,,Roma,Serie A,28,1993,25.8,34,25,20,12,2,15,39,38.5,24,12,1,11,27,61,22
2772,Edoardo Vergani,it,FW,MF,Salernitana,Serie A,20,2001,1.1,2,2,2,0,0,0,0,,0,2,2,0,0,2,2
2773,Vincent Vermeij,nl,MF,,Freiburg,Bundesliga,26,1994,0.0,0,0,0,0,0,0,0,,0,1,0,1,0,0,0
2774,Marco Verratti,it,MF,,Paris S-G,Ligue 1,28,1992,21.5,60,40,16,30,14,32,64,50.0,32,36,10,26,18,78,14
2775,Valerio Verre,it,MF,FW,Sampdoria,Serie A,27,1994,4.7,7,5,1,4,2,4,9,44.4,5,7,0,7,0,7,5
2776,Valerio Verre,it,MF,,Empoli,Serie A,27,1994,3.4,4,2,3,1,0,2,7,28.6,5,2,0,2,1,5,0
2777,Freddie Veseli,al,DF,,Salernitana,Serie A,28,1992,6.6,7,2,4,3,0,5,6,83.3,1,10,5,5,4,11,19
2778,Mikel Vesga,es,MF,,Athletic Club,La Liga,28,1993,15.1,27,14,7,18,2,11,31,35.5,20,16,5,11,20,47,34
2779,Jannik Vestergaard,dk,DF,,Leicester City,Premier League,28,1992,6.3,15,10,12,3,0,8,15,53.3,7,10,8,2,7,22,36
2780,Rúben Vezo,pt,DF,,Levante,La Liga,27,1994,26.9,41,29,28,12,1,26,41,63.4,15,41,25,16,36,77,105
2781,Guglielmo Vicario,it,GK,,Empoli,Serie A,24,1996,38.0,1,1,1,0,0,1,1,100.0,0,1,0,1,1,2,21
2782,Aleix Vidal,es,DF,MF,Espanyol,La Liga,31,1989,21.1,31,25,17,9,5,19,39,48.7,20,19,6,13,25,56,35
2783,Arturo Vidal,cl,MF,,Inter,Serie A,34,1987,8.2,26,10,16,9,1,9,26,34.6,17,13,5,8,7,33,7
2784,Nacho Vidal,es,DF,,Osasuna,La Liga,26,1995,32.2,83,47,49,25,9,39,77,50.6,38,32,14,18,58,141,79
2785,Gabriel Vidovic,hr,FW,MF,Bayern Munich,Bundesliga,17,2003,0.4,0,0,0,0,0,0,0,,0,0,0,0,0,0,0
2786,Ronaldo Vieira,eng,MF,,Sampdoria,Serie A,23,1998,5.5,10,6,6,4,0,5,10,50.0,5,5,2,3,6,16,5
2787,Nick Viergever,nl,DF,,Greuther Fürth,Bundesliga,31,1989,23.7,32,23,25,7,0,24,34,70.6,10,31,22,9,37,69,119
2788,Luca Vignali,it,DF,MF,Spezia,Serie A,25,1996,0.9,1,1,0,1,0,0,3,0.0,3,0,0,0,1,2,1
2789,Emanuel Vignato,it,MF,DF,Bologna,Serie A,20,2000,6.6,12,7,5,7,0,6,13,46.2,7,2,0,2,2,14,5
2790,Dídac Vilà,es,DF,MF,Espanyol,La Liga,32,1989,2.3,7,5,2,5,0,4,9,44.4,5,2,1,1,3,10,8
2791,Tonny Vilhena,nl,MF,FW,Espanyol,La Liga,26,1995,10.3,16,6,7,8,1,7,21,33.3,14,10,2,8,8,24,17
2792,Daniel Villahermosa,es,MF,,Espanyol,La Liga,20,2001,0.3,0,0,0,0,0,0,0,,0,0,0,0,0,0,1
2793,Asier Villalibre,es,FW,,Athletic Club,La Liga,23,1997,6.1,4,3,2,1,1,1,2,50.0,1,3,1,2,1,5,7
2794,Gonzalo Villar,es,MF,,Getafe,La Liga,23,1998,3.3,5,3,4,1,0,2,5,40.0,3,4,1,3,1,6,1
2795,Matías Viña,uy,DF,FW,Roma,Serie A,23,1997,17.4,46,30,27,14,5,29,59,49.2,30,26,3,23,25,71,33
2796,Nicolas Viola,it,MF,,Bologna,Serie A,31,1989,1.1,2,2,1,1,0,1,2,50.0,1,1,1,0,0,2,1
2797,Mattia Viti,it,DF,,Empoli,Serie A,19,2002,16.6,28,16,16,9,3,15,24,62.5,9,28,25,3,29,57,69
2798,Vitolo,es,MF,,Getafe,La Liga,31,1989,2.5,3,2,1,1,1,2,5,40.0,3,3,0,3,1,4,1
2799,Daniel Vivian,es,DF,,Athletic Club,La Liga,22,1999,22.1,32,21,24,7,1,17,24,70.8,7,20,15,5,26,58,107
2800,Dušan Vlahović,rs,FW,,Fiorentina,Serie A,21,2000,20.6,5,0,0,2,3,2,11,18.2,9,6,2,4,1,6,16
2801,Dušan Vlahović,rs,FW,,Juventus,Serie A,21,2000,12.0,0,0,0,0,0,0,4,0.0,4,3,0,3,0,0,7
2802,Nikola Vlašić,hr,FW,MF,West Ham,Premier League,23,1997,6.2,11,7,4,6,1,5,20,25.0,15,4,0,4,2,13,1
2803,Andreas Voglsammer,de,FW,MF,Union Berlin,Bundesliga,29,1992,9.8,14,9,8,3,3,6,14,42.9,8,9,2,7,2,16,7
2804,Kevin Vogt,de,DF,,Hoffenheim,Bundesliga,29,1991,28.5,21,12,15,6,0,11,21,52.4,10,18,7,11,13,34,101
2805,Mërgim Vojvoda,xk,DF,,Torino,Serie A,26,1995,22.0,38,23,23,11,4,20,36,55.6,16,27,8,19,20,58,51
2806,Kevin Volland,de,MF,FW,Monaco,Ligue 1,29,1992,27.1,24,10,2,18,4,6,31,19.4,25,20,0,20,3,27,9
2807,Cristian Volpato,it,FW,MF,Roma,Serie A,17,2003,0.4,1,1,0,0,1,1,1,100.0,0,0,0,0,0,1,0
2808,Aster Vranckx,be,MF,,Wolfsburg,Bundesliga,18,2002,12.7,34,13,14,16,4,14,26,53.8,12,19,7,12,13,47,16
2809,Stefan de Vrij,nl,DF,,Inter,Serie A,29,1992,26.8,38,29,22,16,0,12,17,70.6,5,17,8,9,32,70,52
2810,Šime Vrsaljko,hr,DF,,Atlético Madrid,La Liga,29,1992,10.2,27,17,14,12,1,12,20,60.0,8,10,1,9,12,39,30
2811,Nikola Vukčević,me,MF,,Levante,La Liga,29,1991,1.3,3,2,2,1,0,0,1,0.0,1,2,0,2,2,5,1
2812,Matěj Vydra,cz,FW,,Burnley,Premier League,29,1992,7.5,12,7,3,4,5,3,7,42.9,4,5,1,4,0,12,9
2813,Elye Wahi,fr,FW,,Montpellier,Ligue 1,18,2003,19.8,18,10,9,6,3,6,16,37.5,10,7,0,7,4,22,4
2814,Walace,br,MF,,Udinese,Serie A,26,1995,33.0,83,49,37,38,8,50,113,44.2,63,51,5,46,54,137,32
2815,Theo Walcott,eng,MF,FW,Southampton,Premier League,32,1989,4.2,4,2,2,0,2,1,5,20.0,4,3,0,3,5,9,2
2816,Luca Waldschmidt,de,MF,FW,Wolfsburg,Bundesliga,25,1996,8.0,9,1,3,5,1,5,13,38.5,8,5,0,5,8,17,3
2817,Kyle Walker,eng,DF,,Manchester City,Premier League,31,1990,19.5,15,6,7,7,1,8,17,47.1,9,14,4,10,14,29,16
2818,Kyle Walker-Peters,eng,DF,,Southampton,Premier League,24,1997,29.3,57,33,28,21,8,26,38,68.4,12,29,8,21,37,94,53
2819,Sebastian Walukiewicz,pl,DF,,Cagliari,Serie A,21,2000,3.4,9,5,7,2,0,3,5,60.0,2,5,2,3,7,16,14
2820,Aaron Wan-Bissaka,eng,DF,,Manchester Utd,Premier League,23,1997,19.9,49,36,25,18,6,14,20,70.0,6,24,14,10,34,83,41
2821,Paul Wanner,de,FW,MF,Bayern Munich,Bundesliga,15,2005,0.4,2,2,0,2,0,1,1,100.0,0,0,0,0,0,2,0
2822,Danny Ward,wls,GK,,Leicester City,Premier League,28,1993,1.0,0,0,0,0,0,0,0,,0,0,0,0,0,0,1
2823,Joel Ward,eng,DF,,Crystal Palace,Premier League,31,1989,27.6,44,26,30,11,3,30,57,52.6,27,24,11,13,32,76,107
2824,James Ward-Prowse,eng,MF,,Southampton,Premier League,26,1994,35.7,41,24,12,24,5,19,70,27.1,51,43,15,28,40,81,45
2825,Magnus Warming,dk,MF,FW,Torino,Serie A,21,2000,0.6,1,1,0,1,0,0,0,,0,2,0,2,0,1,0
2826,Daniel Wass,dk,DF,FW,Atlético Madrid,La Liga,32,1989,0.5,0,0,0,0,0,0,0,,0,0,0,0,0,0,3
2827,Daniel Wass,dk,MF,,Valencia,La Liga,32,1989,17.6,23,13,6,14,3,8,31,25.8,23,13,2,11,13,36,19
2828,Ollie Watkins,eng,FW,,Aston Villa,Premier League,25,1995,32.8,17,13,2,7,8,2,15,13.3,13,25,3,22,12,29,27
2829,Timothy Weah,us,MF,FW,Lille,Ligue 1,21,2000,18.0,19,7,8,8,3,10,20,50.0,10,16,1,15,10,29,7
2830,Adam Webster,eng,DF,,Brighton,Premier League,26,1995,15.9,26,8,17,7,2,13,20,65.0,7,25,17,8,17,43,66
2831,Wout Weghorst,nl,FW,,Burnley,Premier League,28,1992,16.1,17,9,3,9,5,6,19,31.6,13,16,5,11,6,23,13
2832,Wout Weghorst,nl,FW,,Wolfsburg,Bundesliga,28,1992,17.3,13,7,3,3,7,7,17,41.2,10,10,3,7,2,15,11
2833,Noah Weißhaupt,de,MF,FW,Freiburg,Bundesliga,19,2001,1.1,1,1,1,0,0,1,2,50.0,1,2,0,2,1,2,1
2834,Danny Welbeck,eng,FW,MF,Brighton,Premier League,30,1990,16.4,14,7,2,8,4,3,10,30.0,7,18,2,16,5,19,18
2835,Timo Werner,de,FW,MF,Chelsea,Premier League,25,1996,14.3,8,4,3,3,2,2,20,10.0,18,9,0,9,2,10,4
2836,Ashley Westwood,eng,MF,,Burnley,Premier League,31,1990,25.4,21,12,8,12,1,10,31,32.3,21,21,9,12,30,51,16
2837,Ben White,eng,DF,,Arsenal,Premier League,23,1997,32.0,44,23,30,8,6,28,45,62.2,17,42,24,18,42,86,102
2838,Silvan Widmer,ch,DF,,Mainz 05,Bundesliga,28,1993,32.4,60,28,32,20,8,36,61,59.0,25,44,16,28,43,103,59
2839,Georginio Wijnaldum,nl,MF,,Paris S-G,Ligue 1,30,1990,18.4,15,9,2,12,1,11,19,57.9,8,13,3,10,9,24,7
2840,Jetro Willems,nl,DF,,Greuther Fürth,Bundesliga,27,1994,17.8,30,15,18,10,2,15,26,57.7,11,15,3,12,14,44,42
2841,Brandon Williams,eng,DF,,Norwich City,Premier League,20,2000,23.6,55,37,35,18,2,36,64,56.3,28,26,6,20,44,99,50
2842,Iñaki Williams,gh,FW,,Athletic Club,La Liga,27,1994,30.9,14,5,1,6,7,5,17,29.4,12,18,3,15,3,17,20
2843,Neco Williams,wls,DF,,Liverpool,Premier League,20,2001,0.1,0,0,0,0,0,0,0,,0,0,0,0,0,0,0
2844,Nico Williams,es,MF,,Athletic Club,La Liga,19,2002,14.9,20,10,6,11,3,10,31,32.3,21,18,2,16,5,25,9
2845,Joe Willock,eng,MF,,Newcastle Utd,Premier League,21,1999,22.6,64,37,30,28,6,29,68,42.6,39,37,6,31,21,85,10
2846,Callum Wilson,eng,FW,,Newcastle Utd,Premier League,29,1992,15.4,9,8,1,5,3,1,4,25.0,3,7,2,5,3,12,10
2847,Patrick Wimmer,at,FW,MF,Arminia,Bundesliga,20,2001,22.8,53,31,13,31,9,22,61,36.1,39,30,1,29,27,80,13
2848,Jonas Wind,dk,FW,MF,Wolfsburg,Bundesliga,22,1999,13.1,10,6,1,7,2,1,4,25.0,3,8,3,5,6,16,13
2849,Marten Winkler,de,MF,,Hertha BSC,Bundesliga,18,2002,0.3,0,0,0,0,0,0,0,,0,0,0,0,0,0,0
2850,Harry Winks,eng,MF,,Tottenham,Premier League,25,1996,10.1,15,10,4,9,2,8,21,38.1,13,14,3,11,16,31,10
2851,Frederik Winther,dk,DF,,Augsburg,Bundesliga,20,2001,3.6,7,2,7,0,0,5,6,83.3,1,4,1,3,8,15,21
2852,Florian Wirtz,de,MF,FW,Leverkusen,Bundesliga,18,2003,20.6,25,10,6,16,3,10,28,35.7,18,12,1,11,13,38,4
2853,Yoane Wissa,cd,FW,,Brentford,Premier League,24,1996,14.3,12,6,5,4,3,1,16,6.3,15,12,5,7,8,20,6
2854,Axel Witsel,be,MF,DF,Dortmund,Bundesliga,32,1989,21.6,42,27,12,23,7,18,30,60.0,12,24,9,15,27,69,38
2855,Hannes Wolf,at,FW,MF,Gladbach,Bundesliga,22,1999,3.4,23,12,4,13,6,10,20,50.0,10,10,0,10,2,25,1
2856,Marius Wolf,de,DF,FW,Dortmund,Bundesliga,26,1995,14.7,26,10,13,9,4,12,24,50.0,12,14,1,13,13,39,8
2857,Luca Wollschläger,de,FW,MF,Hertha BSC,Bundesliga,18,2003,0.2,1,1,0,1,0,0,1,0.0,1,0,0,0,0,1,0
2858,Jeong Woo-yeong,kr,FW,MF,Freiburg,Bundesliga,21,1999,19.8,15,9,6,7,2,5,15,33.3,10,8,1,7,7,22,11
2859,Chris Wood,nz,FW,,Burnley,Premier League,29,1991,15.2,7,5,0,3,4,3,10,30.0,7,13,4,9,0,7,3
2860,Chris Wood,nz,FW,,Newcastle Utd,Premier League,29,1991,14.7,2,0,1,1,0,1,2,50.0,1,5,2,3,2,4,9
2861,Freddie Woodman,eng,GK,,Newcastle Utd,Premier League,24,1997,4.0,0,0,0,0,0,0,0,,0,0,0,0,0,0,0
2862,Christopher Wooh,cm,DF,,Lens,Ligue 1,19,2001,11.7,29,11,20,8,1,11,18,61.1,7,21,14,7,21,50,40
2863,Joscha Wosz,de,DF,,RB Leipzig,Bundesliga,19,2002,0.1,0,0,0,0,0,0,0,,0,0,0,0,0,0,0
2864,Xeka,pt,MF,,Lille,Ligue 1,26,1994,18.0,47,27,18,24,5,27,56,48.2,29,23,3,20,24,71,26
2865,Granit Xhaka,ch,MF,DF,Arsenal,Premier League,28,1992,25.9,32,18,16,12,4,16,41,39.0,25,21,6,15,21,53,31
2866,Sekou Yansané,gn,FW,,Paris S-G,Ligue 1,18,2003,0.2,0,0,0,0,0,0,1,0.0,1,0,0,0,0,0,1
2867,Andriy Yarmolenko,ua,FW,MF,West Ham,Premier League,31,1989,3.5,4,2,2,2,0,2,8,25.0,6,4,2,2,0,4,2
2868,Yusuf Yazıcı,tr,MF,FW,Lille,Ligue 1,24,1997,5.7,10,5,3,6,1,1,9,11.1,8,4,0,4,2,12,1
2869,Kelvin Yeboah,it,FW,MF,Genoa,Serie A,21,2000,9.4,14,7,5,7,2,9,19,47.4,10,22,1,21,1,15,7
2870,Gerard Yepes,es,MF,DF,Sampdoria,Serie A,18,2002,0.2,1,0,0,1,0,1,1,100.0,0,1,0,1,0,1,0
2871,Burak Yılmaz,tr,FW,,Lille,Ligue 1,36,1985,24.6,7,2,0,2,5,2,17,11.8,15,8,1,7,2,9,11
2872,Okay Yokuşlu,tr,DF,MF,Getafe,La Liga,27,1994,5.2,9,8,6,2,1,5,5,100.0,0,7,5,2,5,14,17
2873,Okay Yokuşlu,tr,DF,MF,Celta Vigo,La Liga,27,1994,1.6,4,1,2,1,1,2,3,66.7,1,2,1,1,2,6,6
2874,Leny Yoro,fr,MF,,Lille,Ligue 1,15,2005,0.1,1,0,0,1,0,0,0,,0,1,0,1,0,1,0
2875,Maya Yoshida,jp,DF,,Sampdoria,Serie A,32,1988,20.3,17,10,8,9,0,8,15,53.3,7,27,20,7,28,45,72
2876,Ashley Young,eng,DF,FW,Aston Villa,Premier League,36,1985,13.9,18,6,9,6,3,11,16,68.8,5,10,4,6,13,31,25
2877,Nathan Young-Coombes,eng,MF,,Brentford,Premier League,18,2003,0.0,0,0,0,0,0,0,0,,0,0,0,0,0,0,0
2878,Zaydou Youssouf,km,MF,,Saint-Étienne,Ligue 1,22,1999,17.3,48,26,21,25,2,14,34,41.2,20,11,3,8,17,65,13
2879,Mattia Zaccagni,it,MF,,Hellas Verona,Serie A,26,1995,2.0,3,1,1,0,2,1,2,50.0,1,1,0,1,4,7,0
2880,Mattia Zaccagni,it,FW,,Lazio,Serie A,26,1995,20.8,33,16,10,13,10,11,19,57.9,8,17,2,15,20,53,5
2881,Dan-Axel Zagadou,fr,DF,,Dortmund,Bundesliga,22,1999,10.6,13,7,11,1,1,7,10,70.0,3,14,4,10,15,28,38
2882,Wilfried Zaha,ci,FW,,Crystal Palace,Premier League,28,1992,30.7,40,20,14,15,11,10,31,32.3,21,28,0,28,5,45,5
2883,Denis Zakaria,ch,MF,,Juventus,Serie A,24,1996,6.6,11,7,3,6,2,3,11,27.3,8,16,3,13,11,22,7
2884,Denis Zakaria,ch,MF,DF,Gladbach,Bundesliga,24,1996,15.5,23,14,9,10,4,12,35,34.3,23,25,5,20,19,42,22
2885,Joseba Zaldúa,es,DF,,Real Sociedad,La Liga,29,1992,13.0,31,22,20,8,3,16,22,72.7,6,14,4,10,13,44,35
2886,Nicola Zalewski,pl,DF,,Roma,Serie A,19,2002,8.8,32,19,17,11,4,21,35,60.0,14,18,1,17,16,48,4
2887,Andre-Frank Zambo Anguissa,cm,MF,,Napoli,Serie A,25,1995,21.4,50,26,24,17,9,25,51,49.0,26,31,5,26,24,74,33
2888,Nicolò Zaniolo,it,FW,MF,Roma,Serie A,22,1999,21.9,24,15,0,15,9,6,28,21.4,22,19,0,19,7,31,6
2889,Alessandro Zanoli,it,DF,,Napoli,Serie A,20,2000,5.1,10,7,6,3,1,3,5,60.0,2,2,1,1,4,14,16
2890,Mattia Zanotti,it,DF,,Inter,Serie A,18,2003,0.1,1,0,1,0,0,0,1,0.0,1,0,0,0,0,1,0
2891,Duván Zapata,co,FW,,Atalanta,Serie A,30,1991,19.1,6,2,0,4,2,4,8,50.0,4,8,1,7,3,9,5
2892,Gabriele Zappa,it,DF,,Cagliari,Serie A,21,1999,12.7,21,9,12,6,3,6,24,25.0,18,15,5,10,14,35,28
2893,Davide Zappacosta,it,DF,,Atalanta,Serie A,29,1992,26.1,32,22,12,13,7,19,37,51.4,18,32,2,30,12,44,22
2894,Oier Zarraga,es,MF,,Athletic Club,La Liga,22,1999,13.0,13,5,4,7,2,3,28,10.7,25,17,10,7,19,32,10
2895,Simone Zaza,it,FW,DF,Torino,Serie A,30,1991,1.4,2,2,1,1,0,1,1,100.0,0,3,0,3,0,2,3
2896,Akim Zedadka,dz,DF,,Clermont Foot,Ligue 1,26,1995,37.1,72,44,34,29,9,37,71,52.1,34,32,8,24,58,130,48
2897,Deyovaisio Zeefuik,nl,DF,,Hertha BSC,Bundesliga,23,1998,6.3,11,10,6,4,1,6,12,50.0,6,12,4,8,11,22,21
2898,Marvin Zeegelaar,nl,DF,,Udinese,Serie A,30,1990,7.1,15,11,6,8,1,5,14,35.7,9,12,4,8,12,27,22
2899,Arber Zeneli,xk,FW,,Reims,Ligue 1,26,1995,4.5,1,0,0,0,1,1,5,20.0,4,0,0,0,1,2,1
2900,Robin Zentner,de,GK,,Mainz 05,Bundesliga,26,1994,32.0,2,2,2,0,0,2,2,100.0,0,0,0,0,2,4,21
2901,Andi Zeqiri,ch,FW,MF,Augsburg,Bundesliga,22,1999,11.3,14,7,3,5,6,3,12,25.0,9,10,1,9,2,16,12
2902,Mehdi Zerkane,dz,MF,DF,Bordeaux,Ligue 1,22,1999,0.9,0,0,0,0,0,0,1,0.0,1,1,1,0,2,2,0
2903,Edon Zhegrova,xk,MF,FW,Lille,Ligue 1,22,1999,5.3,14,5,2,8,4,5,6,83.3,1,4,1,3,2,16,2
2904,Luca Zidane,fr,GK,,Rayo Vallecano,La Liga,23,1998,7.2,0,0,0,0,0,0,1,0.0,1,0,0,0,0,0,1
2905,Piotr Zieliński,pl,MF,,Napoli,Serie A,27,1994,23.2,19,12,5,9,5,6,21,28.6,15,13,2,11,8,27,4
2906,David Zima,cz,DF,,Torino,Serie A,20,2000,14.6,20,12,8,11,1,9,20,45.0,11,15,13,2,23,43,42
2907,Christoph Zimmermann,de,DF,,Norwich City,Premier League,28,1993,1.7,6,3,5,1,0,3,4,75.0,1,0,0,0,1,7,4
2908,Oleksandr Zinchenko,ua,DF,,Manchester City,Premier League,24,1996,11.6,20,14,7,10,3,11,20,55.0,9,11,3,8,14,34,15
2909,Hakim Ziyech,ma,MF,FW,Chelsea,Premier League,28,1993,14.7,19,10,5,12,2,10,36,27.8,26,11,1,10,10,29,10
2910,Jeroen Zoet,nl,GK,,Spezia,Serie A,30,1991,7.0,1,0,1,0,0,1,1,100.0,0,0,0,0,0,1,4
2911,Simon Zoller,de,FW,,Bochum,Bundesliga,30,1991,6.6,4,2,2,1,1,1,3,33.3,2,3,0,3,4,8,2
2912,Nadir Zortea,it,DF,MF,Salernitana,Serie A,22,1999,15.7,21,15,9,7,5,11,19,57.9,8,14,2,12,7,28,33
2913,Tanguy Zoukrou,fr,DF,,Troyes,Ligue 1,18,2003,0.9,1,0,1,0,0,1,2,50.0,1,0,0,0,0,1,2
2914,Kurt Zouma,fr,DF,,West Ham,Premier League,26,1994,23.1,11,6,8,3,0,4,7,57.1,3,31,26,5,34,45,132
2915,Petar Zovko,ba,GK,,Spezia,Serie A,19,2002,0.3,0,0,0,0,0,0,0,,0,0,0,0,0,0,1
2916,Igor Zubeldia,es,DF,,Real Sociedad,La Liga,24,1997,18.3,20,10,12,8,0,12,18,66.7,6,16,6,10,27,47,53
2917,Martín Zubimendi,es,MF,,Real Sociedad,La Liga,22,1999,28.8,52,25,19,30,3,22,44,50.0,22,30,13,17,49,101,48
2918,Szymon Żurkowski,pl,MF,,Empoli,Serie A,23,1997,25.6,58,33,24,21,13,29,68,42.6,39,43,10,33,35,93,32
2919,Martin Ødegaard,no,MF,FW,Arsenal,Premier League,22,1998,30.9,49,21,6,24,19,22,61,36.1,39,18,1,17,11,60,11
2920,Milan Đurić,ba,FW,,Salernitana,Serie A,31,1990,24.1,1,1,0,1,0,1,3,33.3,2,6,1,5,2,3,32
2921,Filip Đuričić,rs,MF,FW,Sassuolo,Serie A,29,1992,7.5,13,10,7,1,5,5,13,38.5,8,7,1,6,4,17,1
